data_somministrazione;area;totale;sesso_maschile;sesso_femminile;prima_dose;seconda_dose;pregressa_infezione;dose_aggiuntiva;codice_NUTS1;codice_NUTS2;codice_regione_ISTAT;nome_area;Latitudine;Longitudine;ricoverati_con_sintomi;terapia_intensiva;totale_ospedalizzati;isolamento_domiciliare;totale_positivi;variazione_totale_positivi;nuovi_positivi;dimessi_guariti;deceduti;totale_casi;tamponi;casi_testati
2020-12-27;ABR;47;24;23;47;0;0;0;ITF;ITF1;13;Abruzzo;42.35122196;13.39843823;443;36;479;11337;11816;-69;25;21507;1173;34496;506082;266774
2020-12-27;BAS;107;41;66;107;0;0;0;ITF;ITF5;17;Basilicata;40.63947052;15.80514834;98;5;103;5856;5959;-1;9;4280;242;10481;180690;116318
2020-12-27;VDA;20;9;11;20;0;0;0;ITC;ITC2;2;Valle d'Aosta / Vallée d'Aoste;45.73750286;7.320149366;83;2;85;347;432;14;27;6375;374;7181;61613;37039
2020-12-27;PIE;915;370;545;915;0;0;0;ITC;ITC1;1;Piemonte;45.0732745;7.680687483;3039;211;3250;27812;31062;-495;470;155416;7784;194262;1654351;974905
2020-12-27;EMR;973;374;599;973;0;0;0;ITH;ITH5;8;Emilia-Romagna;44.49436681;11.341720800000001;2609;210;2819;55356;58175;888;1283;100659;7493;166327;2508298;1210120
2020-12-27;SAR;68;37;31;68;0;0;0;ITG;ITG2;20;Sardegna;39.21531192;9.110616306;483;43;526;15889;16415;15;96;13020;710;30145;470328;394659
2020-12-27;CAM;721;423;298;717;0;4;0;ITF;ITF3;15;Campania;40.83956555;14.25084984;1440;95;1535;78540;80075;-488;310;103370;2686;186131;1992877;1332853
2020-12-27;UMB;90;49;41;90;0;0;0;ITI;ITI2;10;Umbria;43.10675841;12.38824698;260;36;296;3257;3553;4;36;23907;604;28064;492558;249041
2020-12-27;LAZ;277;133;144;277;0;0;0;ITI;ITI4;12;Lazio;41.89277044;12.48366722;2802;301;3103;73335;76438;144;977;77800;3529;157767;2656014;2023876
2020-12-27;LOM;718;414;304;718;0;0;0;ITC;ITC4;3;Lombardia;45.46679409;9.190347404;3801;508;4309;55018;59327;-295;466;387761;24867;471955;4785738;2585071
2020-12-27;FVG;262;149;113;261;0;1;0;ITH;ITH4;6;Friuli-Venezia Giulia;45.6494354;13.76813649;626;58;684;11506;12190;65;144;33913;1564;47667;907700;335221
2020-12-27;SIC;148;95;53;147;0;1;0;ITG;ITG1;19;Sicilia;38.11569725;13.362356699999998;1027;174;1201;31966;33167;-123;682;54151;2298;89616;1188827;793985
2020-12-27;PAT;107;43;64;107;0;0;0;ITH;ITH2;4;Provincia Autonoma Trento;46.06893511;11.12123097;356;45;401;1374;1775;49;86;18372;902;21049;442600;150012
2020-12-27;TOS;629;275;354;624;0;5;0;ITI;ITI1;9;Toscana;43.76923077;11.25588885;847;165;1012;9788;10800;-78;227;104396;3588;118784;1849528;1050691
2020-12-27;PAB;144;65;79;144;0;0;0;ITH;ITH1;4;Provincia Autonoma Bolzano / Bozen;46.49933453;11.35662422;154;20;174;10406;10580;14;57;17503;720;28803;355149;160905
2020-12-27;VEN;880;395;485;880;0;0;0;ITH;ITH3;5;Veneto;45.43490485;12.33845213;2626;360;2986;87035;90021;1179;3337;144593;6038;240652;3232475;1196750
2020-12-27;PUG;510;252;258;510;0;0;0;ITF;ITF4;16;Puglia;41.12559576;16.86736689;1444;154;1598;52040;53638;-152;221;30454;2347;86439;1008542;638210
2020-12-27;MOL;50;20;30;50;0;0;0;ITF;ITF2;14;Molise;41.55774754;14.65916051;55;8;63;2256;2319;-4;1;3881;182;6382;113233;104010
2020-12-27;CAL;318;170;148;318;0;0;0;ITF;ITF6;18;Calabria;38.90597598;16.59440194;255;18;273;8305;8578;17;179;13665;451;22694;429979;411970
2020-12-27;LIG;135;56;79;134;0;1;0;ITC;ITC3;7;Liguria;44.41149315;8.9326992;695;66;761;5008;5769;97;99;50489;2846;59104;695223;318446
2020-12-27;MAR;210;100;110;208;0;2;0;ITI;ITI3;11;Marche;43.61675973;13.5188753;428;65;493;9178;9671;36;181;28499;1527;39697;514332;305197
2020-12-28;SIC;270;166;104;269;0;1;0;ITG;ITG1;19;Sicilia;38.11569725;13.362356699999998;1064;175;1239;32007;33246;79;650;54694;2326;90266;1194520;797698
2020-12-28;LOM;108;47;61;108;0;0;0;ITC;ITC4;3;Lombardia;45.46679409;9.190347404;3791;512;4303;50462;54765;-4562;573;392854;24909;472528;4791224;2587261
2020-12-28;FVG;1;0;1;1;0;0;0;ITH;ITH4;6;Friuli-Venezia Giulia;45.6494354;13.76813649;645;56;701;11411;12112;-78;187;34151;1591;47854;909588;335797
2020-12-28;PIE;1;1;0;1;0;0;0;ITC;ITC1;1;Piemonte;45.0732745;7.680687483;3042;205;3247;27056;30303;-759;313;156468;7804;194575;1657292;976214
2020-12-28;LIG;80;30;50;80;0;0;0;ITC;ITC3;7;Liguria;44.41149315;8.9326992;718;61;779;4909;5688;-81;173;50737;2852;59277;696992;319115
2020-12-28;SAR;69;27;42;69;0;0;0;ITG;ITG2;20;Sardegna;39.21531192;9.110616306;497;44;541;15803;16344;-71;156;13226;731;30301;471896;395755
2020-12-28;CAL;6;2;4;6;0;0;0;ITF;ITF6;18;Calabria;38.90597598;16.59440194;260;14;274;8427;8701;123;212;13749;456;22906;431495;413426
2020-12-28;LAZ;961;414;547;956;0;5;0;ITI;ITI4;12;Lazio;41.89277044;12.48366722;2820;307;3127;72943;76070;-368;966;79087;3576;158733;2665428;2028405
2020-12-29;SIC;299;185;114;298;0;1;0;ITG;ITG1;19;Sicilia;38.11569725;13.362356699999998;1093;169;1262;32147;33409;163;995;55500;2352;91261;1203327;802862
2020-12-29;LAZ;500;183;317;496;0;4;0;ITI;ITI4;12;Lazio;41.89277044;12.48366722;2854;305;3159;71526;74685;-1385;1218;81636;3630;159951;2676624;2034049
2020-12-29;LOM;107;45;62;107;0;0;0;ITC;ITC4;3;Lombardia;45.46679409;9.190347404;3634;498;4132;50286;54418;-347;843;393995;24958;473371;4802831;2591103
2020-12-29;SAR;57;32;25;57;0;0;0;ITG;ITG2;20;Sardegna;39.21531192;9.110616306;498;45;543;15715;16258;-86;116;13421;738;30417;474385;397965
2020-12-29;LIG;125;33;92;125;0;0;0;ITC;ITC3;7;Liguria;44.41149315;8.9326992;711;63;774;4985;5759;71;305;50956;2867;59582;701035;320126
2020-12-30;SIC;231;140;91;230;0;1;0;ITG;ITG1;19;Sicilia;38.11569725;13.362356699999998;1085;166;1251;32136;33387;-22;1084;56577;2381;92345;1211824;808160
2020-12-30;PIE;743;327;416;743;0;0;0;ITC;ITC1;1;Piemonte;45.0732745;7.680687483;2957;192;3149;25810;28959;-424;1046;159609;7893;196461;1673896;981588
2020-12-30;PAT;7;3;4;7;0;0;0;ITH;ITH2;4;Provincia Autonoma Trento;46.06893511;11.12123097;380;45;425;1288;1713;-47;197;18874;933;21520;447759;151147
2020-12-30;LAZ;1661;641;1020;1650;0;11;0;ITI;ITI4;12;Lazio;41.89277044;12.48366722;2808;303;3111;71352;74463;-222;1333;83125;3696;161284;2690302;2039177
2020-12-30;EMR;1;0;1;1;0;0;0;ITH;ITH5;8;Emilia-Romagna;44.49436681;11.341720800000001;2641;230;2871;53186;56057;-755;1427;105656;7683;169396;2556405;1221526
2020-12-30;LIG;12;5;7;12;0;0;0;ITC;ITC3;7;Liguria;44.41149315;8.9326992;712;63;775;4853;5628;-131;415;51489;2880;59997;706883;322079
2020-12-30;TOS;327;104;223;326;0;1;0;ITI;ITI1;9;Toscana;43.76923077;11.25588885;869;160;1029;8708;9737;-278;460;106304;3655;119696;1872240;1057968
2020-12-30;VEN;699;245;454;699;0;0;0;ITH;ITH3;5;Veneto;45.43490485;12.33845213;2711;358;3069;86954;90023;-342;2986;152642;6410;249075;3276810;1208044
2020-12-30;LOM;115;42;73;115;0;0;0;ITC;ITC4;3;Lombardia;45.46679409;9.190347404;3617;481;4098;48898;52996;-1422;1673;397010;25038;475044;4826709;2597894
2020-12-30;MAR;17;5;12;17;0;0;0;ITI;ITI3;11;Marche;43.61675973;13.5188753;468;62;530;10042;10572;443;585;28792;1557;40921;526915;311670
2020-12-30;PAB;389;183;206;389;0;0;0;ITH;ITH1;4;Provincia Autonoma Bolzano / Bozen;46.49933453;11.35662422;168;22;190;10412;10602;-76;220;17901;731;29234;359695;162050
2020-12-30;PUG;1;0;1;1;0;0;0;ITF;ITF4;16;Puglia;41.12559576;16.86736689;1497;128;1625;51115;52740;-93;1470;34112;2451;89303;1033478;649695
2020-12-30;FVG;629;245;384;629;0;0;0;ITH;ITH4;6;Friuli-Venezia Giulia;45.6494354;13.76813649;641;59;700;10947;11647;-130;803;35876;1627;49150;924819;338891
2020-12-31;PUG;1638;785;853;1638;0;0;0;ITF;ITF4;16;Puglia;41.12559576;16.86736689;1490;129;1619;51383;53002;262;1661;35490;2472;90964;1044314;653907
2020-12-31;PAB;929;528;401;929;0;0;0;ITH;ITH1;4;Provincia Autonoma Bolzano / Bozen;46.49933453;11.35662422;159;26;185;10484;10669;67;260;18086;739;29494;361459;162616
2020-12-31;MAR;392;184;208;390;0;2;0;ITI;ITI3;11;Marche;43.61675973;13.5188753;470;62;532;10646;11178;606;703;28875;1571;41624;532497;315319
2020-12-31;VDA;18;4;14;18;0;0;0;ITC;ITC2;2;Valle d'Aosta / Vallée d'Aoste;45.73750286;7.320149366;75;2;77;334;411;5;29;6483;379;7273;62687;37432
2020-12-31;UMB;322;127;195;322;0;0;0;ITI;ITI2;10;Umbria;43.10675841;12.38824698;259;44;303;3474;3777;71;300;24559;624;28960;503641;252395
2020-12-31;VEN;3221;1042;2179;3221;0;0;0;ITH;ITH3;5;Veneto;45.43490485;12.33845213;2698;361;3059;88014;91073;1050;4800;156263;6539;253875;3300987;1214443
2020-12-31;LIG;991;352;639;991;0;0;0;ITC;ITC3;7;Liguria;44.41149315;8.9326992;694;65;759;4861;5620;-8;472;51958;2891;60469;711036;323257
2020-12-31;PAT;1701;480;1221;1701;0;0;0;ITH;ITH2;4;Provincia Autonoma Trento;46.06893511;11.12123097;380;42;422;1440;1862;149;320;19036;942;21840;450593;151538
2020-12-31;SIC;968;511;457;960;0;8;0;ITG;ITG1;19;Sicilia;38.11569725;13.362356699999998;1069;171;1240;32628;33868;481;1299;57364;2412;93644;1219132;812545
2020-12-31;FVG;1048;381;667;1047;0;1;0;ITH;ITH4;6;Friuli-Venezia Giulia;45.6494354;13.76813649;645;62;707;11091;11798;151;877;36587;1642;50027;933082;341139
2020-12-31;PIE;3896;1329;2567;3896;0;0;0;ITC;ITC1;1;Piemonte;45.0732745;7.680687483;2895;190;3085;25172;28257;-702;1367;161649;7922;197828;1682529;984809
2020-12-31;TOS;802;201;601;798;0;4;0;ITI;ITI1;9;Toscana;43.76923077;11.25588885;838;150;988;8690;9678;-59;632;106977;3673;120328;1883593;1061504
2020-12-31;EMR;2217;781;1436;2216;0;1;0;ITH;ITH5;8;Emilia-Romagna;44.49436681;11.341720800000001;2629;233;2862;54484;57346;1289;2116;106428;7738;171512;2572140;1227556
2020-12-31;LAZ;5390;2160;3230;5330;0;60;0;ITI;ITI4;12;Lazio;41.89277044;12.48366722;2789;303;3092;72081;75173;710;1767;84109;3769;163051;2706603;2045449
2020-12-31;CAM;1490;811;679;1470;0;20;0;ITF;ITF3;15;Campania;40.83956555;14.25084984;1325;113;1438;75817;77255;-356;1554;109574;2844;189673;2035364;1359098
2020-12-31;SAR;41;22;19;41;0;0;0;ITG;ITG2;20;Sardegna;39.21531192;9.110616306;486;46;532;15921;16453;128;368;13913;747;31113;482520;404939
2020-12-31;LOM;715;302;413;715;0;0;0;ITC;ITC4;3;Lombardia;45.46679409;9.190347404;3437;489;3926;50697;54623;1627;3859;399157;25123;478903;4859567;2608285
2021-01-01;UMB;273;104;169;273;0;0;0;ITI;ITI2;10;Umbria;43.10675841;12.38824698;254;46;300;3504;3804;27;228;24759;625;29188;506256;253369
2021-01-01;CAM;919;506;413;899;0;20;0;ITF;ITF3;15;Campania;40.83956555;14.25084984;1359;104;1463;76865;78328;1073;1734;110215;2864;191407;2055822;1375469
2021-01-01;VEN;1527;471;1056;1526;0;1;0;ITH;ITH3;5;Veneto;45.43490485;12.33845213;2657;372;3029;89553;92582;1509;4805;159469;6629;258680;3322582;1220624
2021-01-01;SIC;855;454;401;851;0;4;0;ITG;ITG1;19;Sicilia;38.11569725;13.362356699999998;1073;176;1249;33098;34347;479;1122;57979;2440;94766;1226629;817045
2021-01-01;LOM;24;7;17;24;0;0;0;ITC;ITC4;3;Lombardia;45.46679409;9.190347404;3352;487;3839;51473;55312;689;3056;401444;25203;481959;4885034;2617001
2021-01-01;FVG;2;2;0;2;0;0;0;ITH;ITH4;6;Friuli-Venezia Giulia;45.6494354;13.76813649;647;63;710;11043;11753;-45;715;37320;1669;50742;940153;342937
2021-01-01;TOS;2410;814;1596;2364;0;46;0;ITI;ITI1;9;Toscana;43.76923077;11.25588885;810;143;953;8883;9836;158;589;107381;3700;120917;1893356;1064848
2021-01-01;SAR;34;17;17;34;0;0;0;ITG;ITG2;20;Sardegna;39.21531192;9.110616306;479;42;521;16158;16679;226;365;14048;751;31478;485824;407806
2021-01-01;PIE;1042;397;645;1041;0;1;0;ITC;ITC1;1;Piemonte;45.0732745;7.680687483;2784;184;2968;23561;26529;-1728;1058;164397;7960;198886;1688316;987563
2021-01-01;LAZ;3612;1402;2210;3572;0;40;0;ITI;ITI4;12;Lazio;41.89277044;12.48366722;2752;305;3057;73304;76361;1188;1913;84811;3792;164964;2721083;2052446
2021-01-01;LIG;146;56;90;146;0;0;0;ITC;ITC3;7;Liguria;44.41149315;8.9326992;664;63;727;4870;5597;-23;412;52386;2898;60881;714541;324246
2021-01-01;PAT;222;51;171;222;0;0;0;ITH;ITH2;4;Provincia Autonoma Trento;46.06893511;11.12123097;362;39;401;1498;1899;37;193;19182;952;22033;453381;151838
2021-01-01;PUG;150;61;89;150;0;0;0;ITF;ITF4;16;Puglia;41.12559576;16.86736689;1476;137;1613;52300;53913;911;1395;35965;2481;92359;1051359;655493
2021-01-01;PAB;6;5;1;6;0;0;0;ITH;ITH1;4;Provincia Autonoma Bolzano / Bozen;46.49933453;11.35662422;159;27;186;10607;10793;124;270;18229;742;29764;363649;163276
2021-01-02;LIG;693;247;446;693;0;0;0;ITC;ITC3;7;Liguria;44.41149315;8.9326992;674;66;740;4962;5702;105;203;52475;2907;61084;715806;324658
2021-01-02;TOS;3548;1127;2421;3504;0;44;0;ITI;ITI1;9;Toscana;43.76923077;11.25588885;825;139;964;9057;10021;185;498;107674;3720;121415;1898439;1066811
2021-01-02;PUG;2958;1306;1652;2958;0;0;0;ITF;ITF4;16;Puglia;41.12559576;16.86736689;1503;139;1642;52170;53812;-101;344;36400;2491;92703;1053380;657470
2021-01-02;MAR;458;143;315;456;0;2;0;ITI;ITI3;11;Marche;43.61675973;13.5188753;479;65;544;11243;11787;48;285;29221;1594;42602;539624;319908
2021-01-02;ABR;559;226;333;558;0;1;0;ITF;ITF1;13;Abruzzo;42.35122196;13.39843823;443;37;480;10771;11251;-122;23;23266;1229;35746;520091;271089
2021-01-02;VDA;6;5;1;6;0;0;0;ITC;ITC2;2;Valle d'Aosta / Vallée d'Aoste;45.73750286;7.320149366;76;2;78;335;413;5;7;6501;383;7297;63032;37893
2021-01-02;PIE;3553;1134;2419;3552;0;1;0;ITC;ITC1;1;Piemonte;45.0732745;7.680687483;2777;182;2959;21238;24197;-2332;433;167151;7971;199319;1690587;988567
2021-01-02;PAT;522;149;373;522;0;0;0;ITH;ITH2;4;Provincia Autonoma Trento;46.06893511;11.12123097;369;41;410;1572;1982;83;116;19209;958;22149;453960;151962
2021-01-02;PAB;91;48;43;91;0;0;0;ITH;ITH1;4;Provincia Autonoma Bolzano / Bozen;46.49933453;11.35662422;176;24;200;10638;10838;45;86;18266;746;29850;364372;163511
2021-01-02;EMR;2379;917;1462;2379;0;0;0;ITH;ITH5;8;Emilia-Romagna;44.49436681;11.341720800000001;2649;229;2878;55628;58506;1719;2035;109818;7846;176170;2588793;1234681
2021-01-02;FVG;1219;471;748;1219;0;0;0;ITH;ITH4;6;Friuli-Venezia Giulia;45.6494354;13.76813649;652;63;715;11132;11847;94;359;37567;1687;51101;942810;343713
2021-01-02;VEN;5742;1767;3975;5741;0;1;0;ITH;ITH3;5;Veneto;45.43490485;12.33845213;2668;372;3040;91081;94121;1539;3165;161049;6675;261845;3334350;1224449
2021-01-02;UMB;304;111;193;304;0;0;0;ITI;ITI2;10;Umbria;43.10675841;12.38824698;270;47;317;3476;3793;-11;50;24817;628;29238;506539;253466
2021-01-02;CAM;3672;1963;1709;3614;0;58;0;ITF;ITF3;15;Campania;40.83956555;14.25084984;1355;99;1454;76561;78015;-313;392;110891;2893;191799;2059031;1377433
2021-01-02;CAL;166;94;72;166;0;0;0;ITF;ITF6;18;Calabria;38.90597598;16.59440194;234;19;253;8563;8816;-47;175;15142;482;24440;443632;424698
2021-01-02;BAS;958;383;575;957;0;1;0;ITF;ITF5;17;Basilicata;40.63947052;15.80514834;93;3;96;6046;6142;1;39;4618;261;11021;185449;118458
2021-01-02;SAR;61;22;39;61;0;0;0;ITG;ITG2;20;Sardegna;39.21531192;9.110616306;479;41;520;16152;16672;-7;189;14240;755;31667;487320;409015
2021-01-02;LOM;202;74;128;202;0;0;0;ITC;ITC4;3;Lombardia;45.46679409;9.190347404;3293;491;3784;52226;56010;698;1402;402070;25281;483361;4896792;2621183
2021-01-02;SIC;4892;2548;2344;4856;0;36;0;ITG;ITG1;19;Sicilia;38.11569725;13.362356699999998;1090;186;1276;33674;34950;603;734;58082;2468;95500;1231722;820100
2021-01-02;LAZ;6854;2687;4167;6774;0;80;0;ITI;ITI4;12;Lazio;41.89277044;12.48366722;2792;315;3107;73341;76448;87;1275;85975;3816;166239;2730769;2056450
2021-01-03;ABR;501;212;289;499;0;2;0;ITF;ITF1;13;Abruzzo;42.35122196;13.39843823;445;41;486;10937;11423;172;207;23299;1231;35953;522168;271920
2021-01-03;BAS;910;347;563;910;0;0;0;ITF;ITF5;17;Basilicata;40.63947052;15.80514834;97;3;100;6091;6191;49;81;4649;262;11102;186177;118776
2021-01-03;LAZ;5362;2019;3343;5303;0;59;0;ITI;ITI4;12;Lazio;41.89277044;12.48366722;2824;309;3133;74020;77153;705;1681;86927;3840;167920;2742661;2062465
2021-01-03;FVG;314;124;190;314;0;0;0;ITH;ITH4;6;Friuli-Venezia Giulia;45.6494354;13.76813649;658;61;719;10930;11649;-198;200;37945;1707;51301;945021;344372
2021-01-03;CAL;6;3;3;6;0;0;0;ITF;ITF6;18;Calabria;38.90597598;16.59440194;242;19;261;8396;8657;-159;150;15445;488;24590;445178;426109
2021-01-03;PAT;503;166;337;503;0;0;0;ITH;ITH2;4;Provincia Autonoma Trento;46.06893511;11.12123097;382;44;426;1555;1981;-1;130;19337;961;22279;456111;152347
2021-01-03;EMR;2764;945;1819;2764;0;0;0;ITH;ITH5;8;Emilia-Romagna;44.49436681;11.341720800000001;2657;234;2891;53737;56628;-1878;1818;113473;7887;177988;2603180;1239887
2021-01-03;UMB;270;112;158;270;0;0;0;ITI;ITI2;10;Umbria;43.10675841;12.38824698;268;48;316;3588;3904;111;202;24905;631;29440;509101;254304
2021-01-03;VEN;5158;1562;3596;5158;0;0;0;ITH;ITH3;5;Veneto;45.43490485;12.33845213;2688;365;3053;92106;95159;1038;3419;163342;6763;265264;3348514;1228798
2021-01-03;PIE;3071;973;2098;3070;0;1;0;ITC;ITC1;1;Piemonte;45.0732745;7.680687483;2786;188;2974;18489;21463;-2734;741;170618;7979;200060;1694353;990328
2021-01-03;MAR;912;358;554;902;0;10;0;ITI;ITI3;11;Marche;43.61675973;13.5188753;479;67;546;11520;12066;279;372;29301;1607;42974;542199;321308
2021-01-03;SIC;4819;2519;2300;4785;0;34;0;ITG;ITG1;19;Sicilia;38.11569725;13.362356699999998;1137;184;1321;34270;35591;641;1047;58462;2494;96547;1238041;823898
2021-01-03;SAR;90;36;54;90;0;0;0;ITG;ITG2;20;Sardegna;39.21531192;9.110616306;473;43;516;16238;16754;82;194;14343;764;31861;488894;410264
2021-01-03;CAM;3836;2009;1827;3787;0;49;0;ITF;ITF3;15;Campania;40.83956555;14.25084984;1362;98;1460;76365;77825;-190;619;111682;2911;192418;2065442;1381652
2021-01-03;LOM;857;316;541;856;0;1;0;ITC;ITC4;3;Lombardia;45.46679409;9.190347404;3267;489;3756;53199;56955;945;1709;402798;25317;485070;4910001;2626398
2021-01-03;PUG;2010;944;1066;2009;0;1;0;ITF;ITF4;16;Puglia;41.12559576;16.86736689;1476;136;1612;52466;54078;266;950;37059;2516;93653;1060971;659907
2021-01-03;PAB;42;17;25;42;0;0;0;ITH;ITH1;4;Provincia Autonoma Bolzano / Bozen;46.49933453;11.35662422;186;24;210;10640;10850;12;96;18345;751;29946;365076;163696
2021-01-03;TOS;3364;1070;2294;3317;0;47;0;ITI;ITI1;9;Toscana;43.76923077;11.25588885;834;147;981;8967;9948;-73;355;108092;3730;121770;1904826;1069499
2021-01-03;LIG;738;233;505;736;0;2;0;ITC;ITC3;7;Liguria;44.41149315;8.9326992;696;71;767;5020;5787;85;221;52606;2912;61305;717946;325350
2021-01-04;LOM;6140;2121;4019;6133;0;7;0;ITC;ITC4;3;Lombardia;45.46679409;9.190347404;3227;484;3711;48976;52687;-4268;863;407902;25344;485933;4918162;2629427
2021-01-04;CAM;5828;2962;2866;5727;0;101;0;ITF;ITF3;15;Campania;40.83956555;14.25084984;1377;96;1473;76024;77497;-328;747;112726;2942;193165;2072185;1385616
2021-01-04;FVG;1515;564;951;1515;0;0;0;ITH;ITH4;6;Friuli-Venezia Giulia;45.6494354;13.76813649;663;63;726;10967;11693;44;281;38158;1731;51582;947459;345095
2021-01-04;SIC;8687;4330;4357;8637;0;50;0;ITG;ITG1;19;Sicilia;38.11569725;13.362356699999998;1181;186;1367;35211;36578;987;1391;58832;2528;97938;1245638;828750
2021-01-04;SAR;609;230;379;609;0;0;0;ITG;ITG2;20;Sardegna;39.21531192;9.110616306;489;43;532;16194;16726;-28;177;14544;768;32038;490740;411817
2021-01-04;VEN;6741;2037;4704;6739;0;2;0;ITH;ITH3;5;Veneto;45.43490485;12.33845213;2706;368;3074;91882;94956;-203;1682;165177;6813;266946;3356648;1230879
2021-01-04;CAL;1076;533;543;1073;0;3;0;ITF;ITF6;18;Calabria;38.90597598;16.59440194;248;19;267;8296;8563;-94;221;15757;491;24811;446732;427556
2021-01-04;LAZ;7602;2953;4649;7496;0;106;0;ITI;ITI4;12;Lazio;41.89277044;12.48366722;2852;318;3170;73907;77077;-76;1334;88314;3863;169254;2752420;2066588
2021-01-04;EMR;7314;2527;4787;7311;0;3;0;ITH;ITH5;8;Emilia-Romagna;44.49436681;11.341720800000001;2684;235;2919;53466;56385;-243;1600;115260;7941;179586;2612313;1242760
2021-01-04;PIE;5586;1690;3896;5585;0;1;0;ITC;ITC1;1;Piemonte;45.0732745;7.680687483;2819;183;3002;17511;20513;-950;446;172005;7988;200506;1697788;991545
2021-01-04;PAT;905;250;655;903;0;2;0;ITH;ITH2;4;Provincia Autonoma Trento;46.06893511;11.12123097;379;43;422;1643;2065;84;193;19431;976;22472;456758;152678
2021-01-04;PUG;4514;2017;2497;4512;0;2;0;ITF;ITF4;16;Puglia;41.12559576;16.86736689;1464;137;1601;51938;53539;-539;631;38209;2536;94284;1065109;662401
2021-01-04;TOS;5240;1998;3242;5173;0;67;0;ITI;ITI1;9;Toscana;43.76923077;11.25588885;877;141;1018;8961;9979;31;313;108360;3744;122083;1910036;1071154
2021-01-04;MOL;315;132;183;315;0;0;0;ITF;ITF2;14;Molise;41.55774754;14.65916051;54;10;64;1604;1668;-70;82;4890;197;6755;117666;107613
2021-01-04;PAB;510;201;309;510;0;0;0;ITH;ITH1;4;Provincia Autonoma Bolzano / Bozen;46.49933453;11.35662422;197;25;222;10602;10824;-26;37;18403;756;29983;366281;164012
2021-01-04;LIG;2625;857;1768;2624;0;1;0;ITC;ITC3;7;Liguria;44.41149315;8.9326992;716;75;791;4957;5748;-39;204;52844;2917;61509;719953;326003
2021-01-04;MAR;1529;574;955;1516;0;13;0;ITI;ITI3;11;Marche;43.61675973;13.5188753;487;65;552;11765;12317;251;355;29397;1615;43329;545237;323629
2021-01-04;VDA;144;61;83;144;0;0;0;ITC;ITC2;2;Valle d'Aosta / Vallée d'Aoste;45.73750286;7.320149366;63;1;64;346;410;-4;27;6562;387;7359;63531;38800
2021-01-04;BAS;614;275;339;614;0;0;0;ITF;ITF5;17;Basilicata;40.63947052;15.80514834;94;4;98;6052;6150;-41;41;4726;267;11143;186740;118966
2021-01-04;ABR;1515;685;830;1509;0;6;0;ITF;ITF1;13;Abruzzo;42.35122196;13.39843823;466;39;505;10700;11205;-218;121;23629;1240;36074;523233;272345
2021-01-04;UMB;810;397;413;810;0;0;0;ITI;ITI2;10;Umbria;43.10675841;12.38824698;274;44;318;3560;3878;-26;54;24980;636;29494;509643;254520
2021-01-05;ABR;1735;721;1014;1730;0;5;0;ITF;ITF1;13;Abruzzo;42.35122196;13.39843823;471;39;510;10584;11094;-111;213;23941;1252;36287;525626;273182
2021-01-05;BAS;953;410;543;953;0;0;0;ITF;ITF5;17;Basilicata;40.63947052;15.80514834;93;4;97;6073;6170;20;56;4761;268;11199;187668;119357
2021-01-05;PAB;830;286;544;829;0;1;0;ITH;ITH1;4;Provincia Autonoma Bolzano / Bozen;46.49933453;11.35662422;203;27;230;10683;10913;89;148;18460;758;30131;367689;164243
2021-01-05;EMR;9374;3174;6200;9370;0;4;0;ITH;ITH5;8;Emilia-Romagna;44.49436681;11.341720800000001;2696;232;2928;54249;57177;792;1506;115907;8005;181089;2628108;1246273
2021-01-05;SAR;1358;458;900;1358;0;0;0;ITG;ITG2;20;Sardegna;39.21531192;9.110616306;488;45;533;16237;16770;44;232;14723;777;32270;493754;414250
2021-01-05;VDA;151;55;96;151;0;0;0;ITC;ITC2;2;Valle d'Aosta / Vallée d'Aoste;45.73750286;7.320149366;54;1;55;353;408;-2;21;6585;387;7380;63793;39235
2021-01-05;SIC;10637;5231;5406;10554;0;83;0;ITG;ITG1;19;Sicilia;38.11569725;13.362356699999998;1198;190;1388;36038;37426;848;1576;59524;2564;99514;1255175;835040
2021-01-05;UMB;855;430;425;855;0;0;0;ITI;ITI2;10;Umbria;43.10675841;12.38824698;275;43;318;3615;3933;55;234;25155;640;29728;513892;255640
2021-01-05;CAL;1557;734;823;1555;0;2;0;ITF;ITF6;18;Calabria;38.90597598;16.59440194;242;19;261;8237;8498;-65;177;15992;498;24988;449285;429907
2021-01-05;PIE;5406;1617;3789;5399;0;7;0;ITC;ITC1;1;Piemonte;45.0732745;7.680687483;2847;187;3034;16608;19642;-871;1109;173930;8043;201615;1704739;994333
2021-01-05;LOM;7881;2586;5295;7875;0;6;0;ITC;ITC4;3;Lombardia;45.46679409;9.190347404;3344;475;3819;48498;52317;-370;1338;409548;25406;487271;4930952;2634038
2021-01-05;PAT;759;262;497;759;0;0;0;ITH;ITH2;4;Provincia Autonoma Trento;46.06893511;11.12123097;371;45;416;1660;2076;11;228;19640;984;22700;458550;153111
2021-01-05;LAZ;7469;2838;4631;7366;0;103;0;ITI;ITI4;12;Lazio;41.89277044;12.48366722;2869;308;3177;74131;77308;231;1719;89730;3935;170973;2765552;2073377
2021-01-05;FVG;1679;552;1127;1677;0;2;0;ITH;ITH4;6;Friuli-Venezia Giulia;45.6494354;13.76813649;657;59;716;11078;11794;101;688;38704;1772;52270;954564;346775
2021-01-05;PUG;5120;2257;2863;5117;0;3;0;ITF;ITF4;16;Puglia;41.12559576;16.86736689;1401;152;1553;52027;53580;41;1081;39235;2550;95365;1075382;666941
2021-01-05;CAM;7238;3637;3601;7075;0;163;0;ITF;ITF3;15;Campania;40.83956555;14.25084984;1372;97;1469;74891;76360;-1137;688;114518;2975;193853;2079610;1389809
2021-01-05;LIG;2880;896;1984;2880;0;0;0;ITC;ITC3;7;Liguria;44.41149315;8.9326992;708;73;781;4791;5572;-176;404;53412;2929;61913;724539;327367
2021-01-05;MAR;1589;594;995;1570;0;19;0;ITI;ITI3;11;Marche;43.61675973;13.5188753;495;65;560;12146;12706;389;458;29447;1634;43787;550075;326877
2021-01-05;MOL;451;180;271;451;0;0;0;ITF;ITF2;14;Molise;41.55774754;14.65916051;57;8;65;1487;1552;-116;14;5015;202;6769;118084;107955
2021-01-05;VEN;7335;2186;5149;7333;0;2;0;ITH;ITH3;5;Veneto;45.43490485;12.33845213;2694;361;3055;91173;94228;-728;3151;168881;6988;270097;3374382;1235218
2021-01-05;TOS;5386;1835;3551;5326;0;60;0;ITI;ITI1;9;Toscana;43.76923077;11.25588885;860;139;999;8638;9637;-342;337;109021;3762;122420;1917959;1073738
2021-01-06;CAL;957;520;437;957;0;0;0;ITF;ITF6;18;Calabria;38.90597598;16.59440194;244;20;264;8427;8691;193;398;16196;499;25386;452241;432831
2021-01-06;EMR;8296;2958;5338;8295;0;1;0;ITH;ITH5;8;Emilia-Romagna;44.49436681;11.341720800000001;2665;236;2901;55168;58069;892;1576;116526;8066;182661;2644635;1252185
2021-01-06;LAZ;5217;1997;3220;5097;0;120;0;ITI;ITI4;12;Lazio;41.89277044;12.48366722;2843;306;3149;74617;77766;458;2007;91242;3972;172980;2780969;2079718
2021-01-06;CAM;7652;3751;3901;7507;0;145;0;ITF;ITF3;15;Campania;40.83956555;14.25084984;1362;99;1461;74882;76343;-17;1366;115882;2994;195219;2096822;1404484
2021-01-06;UMB;847;326;521;847;0;0;0;ITI;ITI2;10;Umbria;43.10675841;12.38824698;277;45;322;3752;4074;141;347;25358;643;30075;518260;257069
2021-01-06;FVG;717;266;451;717;0;0;0;ITH;ITH4;6;Friuli-Venezia Giulia;45.6494354;13.76813649;649;62;711;11119;11830;36;606;39241;1805;52876;960944;348178
2021-01-06;SIC;6270;3301;2969;6206;0;64;0;ITG;ITG1;19;Sicilia;38.11569725;13.362356699999998;1190;194;1384;36355;37739;313;1692;60874;2593;101206;1264942;840900
2021-01-06;TOS;4613;1503;3110;4561;0;52;0;ITI;ITI1;9;Toscana;43.76923077;11.25588885;815;146;961;8488;9449;-188;411;109593;3789;122831;1929121;1077856
2021-01-06;LOM;7170;2532;4638;7164;0;6;0;ITC;ITC4;3;Lombardia;45.46679409;9.190347404;3424;471;3895;48796;52691;374;2952;412034;25498;490223;4959414;2642871
2021-01-06;VEN;8143;2392;5751;8140;0;3;0;ITH;ITH3;5;Veneto;45.43490485;12.33845213;2612;343;2955;88344;91299;-2929;3638;175322;7114;273735;3395768;1240441
2021-01-06;MAR;2216;804;1412;2197;0;19;0;ITI;ITI3;11;Marche;43.61675973;13.5188753;512;67;579;12719;13298;592;743;29585;1647;44530;556983;331242
2021-01-06;LIG;1666;618;1048;1663;0;3;0;ITC;ITC3;7;Liguria;44.41149315;8.9326992;703;65;768;4656;5424;-148;365;53907;2947;62278;729125;328647
2021-01-06;MOL;695;263;432;695;0;0;0;ITF;ITF2;14;Molise;41.55774754;14.65916051;57;9;66;1405;1471;-81;27;5123;202;6796;118577;108364
2021-01-06;SAR;1639;556;1083;1639;0;0;0;ITG;ITG2;20;Sardegna;39.21531192;9.110616306;494;47;541;16372;16913;143;335;14906;786;32605;496887;416745
2021-01-06;PAB;59;18;41;59;0;0;0;ITH;ITH1;4;Provincia Autonoma Bolzano / Bozen;46.49933453;11.35662422;203;27;230;10875;11105;192;320;18584;762;30451;370250;164792
2021-01-06;ABR;1991;819;1172;1981;0;10;0;ITF;ITF1;13;Abruzzo;42.35122196;13.39843823;463;39;502;10829;11331;237;365;24066;1254;36651;529798;274632
2021-01-06;PUG;3968;1680;2288;3967;0;1;0;ITF;ITF4;16;Puglia;41.12559576;16.86736689;1383;153;1536;52492;54028;448;1581;40345;2573;96946;1085419;670558
2021-01-06;BAS;296;130;166;296;0;0;0;ITF;ITF5;17;Basilicata;40.63947052;15.80514834;92;4;96;6249;6345;175;210;4796;268;11409;189314;120208
2021-01-06;VDA;66;34;32;66;0;0;0;ITC;ITC2;2;Valle d'Aosta / Vallée d'Aoste;45.73750286;7.320149366;54;1;55;352;407;-1;26;6611;388;7406;63993;39413
2021-01-06;PAT;43;13;30;43;0;0;0;ITH;ITH2;4;Provincia Autonoma Trento;46.06893511;11.12123097;359;45;404;1620;2024;-52;203;19890;989;22903;461438;153546
2021-01-06;PIE;3121;1106;2015;3120;0;1;0;ITC;ITC1;1;Piemonte;45.0732745;7.680687483;2773;192;2965;15450;18415;-1227;1163;176275;8088;202778;1713074;997705
2021-01-07;MOL;602;210;392;602;0;0;0;ITF;ITF2;14;Molise;41.55774754;14.65916051;55;8;63;1472;1535;64;68;5124;205;6864;119457;109151
2021-01-07;PAB;921;329;592;921;0;0;0;ITH;ITH1;4;Provincia Autonoma Bolzano / Bozen;46.49933453;11.35662422;205;25;230;11021;11251;146;263;18700;763;30714;372082;165367
2021-01-07;PUG;5738;2470;3268;5738;0;0;0;ITF;ITF4;16;Puglia;41.12559576;16.86736689;1390;154;1544;51997;53541;-487;657;41468;2594;97603;1088595;673205
2021-01-07;MAR;1821;642;1179;1804;0;17;0;ITI;ITI3;11;Marche;43.61675973;13.5188753;521;69;590;12992;13582;284;346;29633;1661;44876;559992;333430
2021-01-07;VDA;280;113;167;280;0;0;0;ITC;ITC2;2;Valle d'Aosta / Vallée d'Aoste;45.73750286;7.320149366;57;1;58;376;434;27;33;6617;388;7439;64223;39503
2021-01-07;UMB;1301;388;913;1301;0;0;0;ITI;ITI2;10;Umbria;43.10675841;12.38824698;277;44;321;3740;4061;-13;64;25432;646;30139;518690;257216
2021-01-07;SIC;9077;4213;4864;8993;0;84;0;ITG;ITG1;19;Sicilia;38.11569725;13.362356699999998;1228;196;1424;37281;38705;966;1435;61307;2629;102641;1273514;845898
2021-01-07;FVG;2110;727;1383;2110;0;0;0;ITH;ITH4;6;Friuli-Venezia Giulia;45.6494354;13.76813649;661;64;725;11640;12365;535;671;39744;1834;53943;967089;349970
2021-01-07;PIE;5406;1743;3663;5404;0;2;0;ITC;ITC1;1;Piemonte;45.0732745;7.680687483;2760;184;2944;14755;17699;-716;1004;177977;8106;203782;1718642;1000112
2021-01-07;LAZ;7970;2991;4979;7813;0;157;0;ITI;ITI4;12;Lazio;41.89277044;12.48366722;2882;310;3192;74731;77923;157;1779;92821;4015;174759;2793308;2085688
2021-01-07;PAT;1302;329;973;1299;0;3;0;ITH;ITH2;4;Provincia Autonoma Trento;46.06893511;11.12123097;361;47;408;1538;1946;-78;170;20133;994;23073;463967;153931
2021-01-07;EMR;10298;3413;6885;10294;0;4;0;ITH;ITH5;8;Emilia-Romagna;44.49436681;11.341720800000001;2701;240;2941;53944;56885;-1184;2228;119874;8130;184889;2654264;1256332
2021-01-07;TOS;6181;1840;4341;6093;0;88;0;ITI;ITI1;9;Toscana;43.76923077;11.25588885;827;146;973;8527;9500;51;667;110191;3807;123498;1937498;1080858
2021-01-07;VEN;8363;2318;6045;8362;0;1;0;ITH;ITH3;5;Veneto;45.43490485;12.33845213;2594;359;2953;89223;92176;877;3596;177998;7157;277331;3413011;1245604
2021-01-07;BAS;645;322;323;645;0;0;0;ITF;ITF5;17;Basilicata;40.63947052;15.80514834;94;4;98;6272;6370;25;62;4832;269;11471;190075;120538
2021-01-07;ABR;1712;657;1055;1705;0;7;0;ITF;ITF1;13;Abruzzo;42.35122196;13.39843823;478;36;514;10803;11317;-14;229;24298;1265;36880;532082;275385
2021-01-07;CAL;2226;1091;1135;2222;0;4;0;ITF;ITF6;18;Calabria;38.90597598;16.59440194;249;21;270;8534;8804;113;361;16438;505;25747;454151;434578
2021-01-07;LOM;11817;3660;8157;11775;0;42;0;ITC;ITC4;3;Lombardia;45.46679409;9.190347404;3363;473;3836;50406;54242;1551;2799;413248;25532;493022;4979745;2650393
2021-01-07;CAM;8909;4167;4742;8734;0;175;0;ITF;ITF3;15;Campania;40.83956555;14.25084984;1385;96;1481;74878;76359;16;1052;116879;3033;196271;2108752;1410977
2021-01-07;LIG;3226;1096;2130;3223;0;3;0;ITC;ITC3;7;Liguria;44.41149315;8.9326992;711;62;773;4528;5301;-123;196;54210;2963;62474;730767;329176
2021-01-07;SAR;3173;1111;2062;3169;0;4;0;ITG;ITG2;20;Sardegna;39.21531192;9.110616306;492;48;540;16519;17059;146;340;15091;795;32945;499345;418496
2021-01-08;VDA;301;131;170;301;0;0;0;ITC;ITC2;2;Valle d'Aosta / Vallée d'Aoste;45.73750286;7.320149366;54;1;55;370;425;-9;25;6651;388;7464;64477;39592
2021-01-08;BAS;556;220;336;556;0;0;0;ITF;ITF5;17;Basilicata;40.63947052;15.80514834;95;4;99;6387;6486;116;157;4873;269;11628;191560;121207
2021-01-08;UMB;1193;344;849;1193;0;0;0;ITI;ITI2;10;Umbria;43.10675841;12.38824698;280;43;323;3785;4108;47;215;25598;648;30354;522585;258421
2021-01-08;SIC;8163;3800;4363;8070;0;93;0;ITG;ITG1;19;Sicilia;38.11569725;13.362356699999998;1246;200;1446;38226;39672;967;1842;62147;2664;104483;1284101;852250
2021-01-08;SAR;3356;1240;2116;3354;0;2;0;ITG;ITG2;20;Sardegna;39.21531192;9.110616306;504;50;554;16511;17065;6;243;15313;810;33188;502097;420910
2021-01-08;CAL;2202;1049;1153;2195;0;7;0;ITF;ITF6;18;Calabria;38.90597598;16.59440194;250;21;271;8689;8960;156;355;16634;508;26102;456555;436896
2021-01-08;LAZ;7997;3002;4995;7799;0;198;0;ITI;ITI4;12;Lazio;41.89277044;12.48366722;2871;309;3180;74675;77855;-68;1613;94457;4060;176372;2805922;2090439
2021-01-08;CAM;10459;4970;5489;10192;0;267;0;ITF;ITF3;15;Campania;40.83956555;14.25084984;1395;100;1495;73651;75146;-1213;984;119030;3079;197255;2117641;1415674
2021-01-08;TOS;6063;1695;4368;5970;0;93;0;ITI;ITI1;9;Toscana;43.76923077;11.25588885;807;139;946;8289;9235;-265;452;110885;3830;123950;1945061;1083608
2021-01-08;VEN;9417;2837;6580;9403;0;14;0;ITH;ITH3;5;Veneto;45.43490485;12.33845213;2549;357;2906;88044;90950;-1226;3388;182506;7263;280719;3430733;1250287
2021-01-08;PAT;1539;342;1197;1538;0;1;0;ITH;ITH2;4;Provincia Autonoma Trento;46.06893511;11.12123097;355;46;401;1529;1930;-16;80;20225;998;23153;465019;154092
2021-01-08;FVG;2346;752;1594;2346;0;0;0;ITH;ITH4;6;Friuli-Venezia Giulia;45.6494354;13.76813649;671;64;735;11841;12576;211;633;40138;1862;54576;973526;351423
2021-01-08;EMR;10882;3587;7295;10879;0;3;0;ITH;ITH5;8;Emilia-Romagna;44.49436681;11.341720800000001;2691;245;2936;53912;56848;-37;2026;121855;8210;186913;2669612;1260158
2021-01-08;LOM;12760;3941;8819;12749;0;11;0;ITC;ITC4;3;Lombardia;45.46679409;9.190347404;3436;466;3902;50775;54677;435;1963;414643;25665;494985;4998160;2656804
2021-01-08;PIE;5551;1767;3784;5549;0;2;0;ITC;ITC1;1;Piemonte;45.0732745;7.680687483;2757;176;2933;14612;17545;-154;845;178949;8133;204627;1723609;1003245
2021-01-08;LIG;2941;1002;1939;2939;0;2;0;ITC;ITC3;7;Liguria;44.41149315;8.9326992;717;67;784;4421;5205;-96;400;54689;2980;62874;735330;330608
2021-01-08;MOL;433;142;291;433;0;0;0;ITF;ITF2;14;Molise;41.55774754;14.65916051;53;8;61;1263;1324;-211;76;5407;209;6940;120247;109821
2021-01-08;MAR;1583;592;991;1568;0;15;0;ITI;ITI3;11;Marche;43.61675973;13.5188753;532;68;600;13412;14012;430;564;29752;1676;45440;565788;337261
2021-01-08;ABR;1660;638;1022;1651;0;9;0;ITF;ITF1;13;Abruzzo;42.35122196;13.39843823;480;36;516;10581;11097;-220;160;24672;1269;37038;534132;276020
2021-01-08;PUG;5701;2400;3301;5699;0;2;0;ITF;ITF4;16;Puglia;41.12559576;16.86736689;1362;163;1525;52397;53922;381;1349;42409;2621;98952;1099615;678168
2021-01-08;PAB;1537;484;1053;1537;0;0;0;ITH;ITH1;4;Provincia Autonoma Bolzano / Bozen;46.49933453;11.35662422;208;24;232;11119;11351;100;163;18757;769;30877;373746;165782
2021-01-09;TOS;4542;1622;2920;4475;0;67;0;ITI;ITI1;9;Toscana;43.76923077;11.25588885;792;139;931;8174;9105;-130;529;111534;3840;124479;1956024;1087156
2021-01-09;PAT;195;42;153;195;0;0;0;ITH;ITH2;4;Provincia Autonoma Trento;46.06893511;11.12123097;333;48;381;1457;1838;-92;142;20451;1006;23295;467966;154496
2021-01-09;LOM;12514;4615;7899;12506;0;8;0;ITC;ITC4;3;Lombardia;45.46679409;9.190347404;3577;456;4033;51404;55437;760;2506;416326;25728;497491;5023007;2664865
2021-01-09;LIG;1338;484;854;1337;0;1;0;ITC;ITC3;7;Liguria;44.41149315;8.9326992;702;65;767;4377;5144;-61;526;55257;2999;63400;739849;332011
2021-01-09;MAR;1722;608;1114;1702;0;20;0;ITI;ITI3;11;Marche;43.61675973;13.5188753;529;71;600;14006;14606;594;688;29837;1685;46128;571099;341285
2021-01-09;VEN;7937;2539;5398;7932;0;5;0;ITH;ITH3;5;Veneto;45.43490485;12.33845213;2540;349;2889;86562;89451;-1499;3100;187023;7345;283819;3451512;1255475
2021-01-09;MOL;457;154;303;457;0;0;0;ITF;ITF2;14;Molise;41.55774754;14.65916051;53;9;62;1103;1165;-159;38;5603;210;6978;120826;110373
2021-01-09;PAB;612;326;286;612;0;0;0;ITH;ITH1;4;Provincia Autonoma Bolzano / Bozen;46.49933453;11.35662422;208;24;232;11291;11523;172;380;18956;778;31257;376673;166561
2021-01-09;PUG;4900;2252;2648;4896;0;4;0;ITF;ITF4;16;Puglia;41.12559576;16.86736689;1376;175;1551;53184;54735;813;1499;43068;2648;100451;1110495;682485
2021-01-09;VDA;445;200;245;445;0;0;0;ITC;ITC2;2;Valle d'Aosta / Vallée d'Aoste;45.73750286;7.320149366;50;1;51;386;437;12;22;6661;388;7486;64752;39706
2021-01-09;PIE;6206;2197;4009;6204;0;2;0;ITC;ITC1;1;Piemonte;45.0732745;7.680687483;2689;172;2861;12968;15829;-1716;1532;182165;8165;206159;1734982;1006938
2021-01-09;FVG;2538;848;1690;2537;0;1;0;ITH;ITH4;6;Friuli-Venezia Giulia;45.6494354;13.76813649;690;62;752;12138;12890;314;1015;40825;1876;55591;981950;353683
2021-01-09;CAL;2107;1132;975;2099;0;8;0;ITF;ITF6;18;Calabria;38.90597598;16.59440194;262;22;284;8986;9270;310;423;16746;509;26525;459663;439871
2021-01-09;SIC;7262;3427;3835;7200;0;62;0;ITG;ITG1;19;Sicilia;38.11569725;13.362356699999998;1256;205;1461;38937;40398;726;1839;63229;2695;106322;1294528;858606
2021-01-09;ABR;1615;694;921;1603;0;12;0;ITF;ITF1;13;Abruzzo;42.35122196;13.39843823;463;40;503;10760;11263;166;400;24901;1274;37438;538731;277443
2021-01-09;BAS;560;161;399;560;0;0;0;ITF;ITF5;17;Basilicata;40.63947052;15.80514834;86;4;90;6469;6559;73;143;4941;271;11771;192881;121984
2021-01-09;LAZ;6458;2635;3823;6345;0;113;0;ITI;ITI4;12;Lazio;41.89277044;12.48366722;2824;310;3134;75035;78169;314;1543;95632;4114;177915;2817904;2096127
2021-01-09;UMB;1718;495;1223;1718;0;0;0;ITI;ITI2;10;Umbria;43.10675841;12.38824698;279;47;326;3911;4237;129;295;25760;652;30649;526153;259676
2021-01-09;CAM;10564;5022;5542;10301;0;263;0;ITF;ITF3;15;Campania;40.83956555;14.25084984;1376;107;1483;73793;75276;130;1263;120127;3115;198518;2132355;1422156
2021-01-09;SAR;4089;1444;2645;4089;0;0;0;ITG;ITG2;20;Sardegna;39.21531192;9.110616306;496;47;543;16599;17142;77;305;15534;817;33493;505206;423581
2021-01-09;EMR;10001;3458;6543;9997;0;4;0;ITH;ITH5;8;Emilia-Romagna;44.49436681;11.341720800000001;2679;240;2919;55449;58368;1520;1790;122054;8279;188701;2685079;1264605
2021-01-10;ABR;1272;540;732;1268;0;4;0;ITF;ITF1;13;Abruzzo;42.35122196;13.39843823;465;41;506;11035;11541;278;315;24935;1277;37753;542413;278572
2021-01-10;BAS;77;24;53;77;0;0;0;ITF;ITF5;17;Basilicata;40.63947052;15.80514834;81;4;85;6552;6637;78;108;4967;275;11879;193834;122458
2021-01-10;VDA;220;71;149;212;0;8;0;ITC;ITC2;2;Valle d'Aosta / Vallée d'Aoste;45.73750286;7.320149366;53;1;54;376;430;-7;19;6686;389;7505;64906;39760
2021-01-10;CAL;959;540;419;959;0;0;0;ITF;ITF6;18;Calabria;38.90597598;16.59440194;256;25;281;9331;9612;342;409;16808;514;26934;462587;442621
2021-01-10;CAM;8165;3736;4429;7962;0;203;0;ITF;ITF3;15;Campania;40.83956555;14.25084984;1377;106;1483;73905;75388;112;1253;121255;3128;199771;2147766;1432377
2021-01-10;LIG;651;264;387;647;0;4;0;ITC;ITC3;7;Liguria;44.41149315;8.9326992;709;64;773;4453;5226;82;374;55538;3010;63774;742726;333083
2021-01-10;UMB;1067;274;793;1067;0;0;0;ITI;ITI2;10;Umbria;43.10675841;12.38824698;265;50;315;3989;4304;67;257;25942;660;30906;528657;260437
2021-01-10;EMR;7175;2687;4488;7174;0;1;0;ITH;ITH5;8;Emilia-Romagna;44.49436681;11.341720800000001;2705;237;2942;56966;59908;1540;2193;122647;8337;190892;2695285;1269123
2021-01-10;LAZ;4150;1745;2405;4083;0;67;0;ITI;ITI4;12;Lazio;41.89277044;12.48366722;2850;323;3173;75612;78785;616;1746;96745;4131;179661;2829610;2101259
2021-01-10;SIC;3567;1598;1969;3545;0;22;0;ITG;ITG1;19;Sicilia;38.11569725;13.362356699999998;1265;208;1473;40033;41506;1108;1733;63821;2728;108055;1303264;863763
2021-01-10;TOS;3036;1123;1913;2982;0;54;0;ITI;ITI1;9;Toscana;43.76923077;11.25588885;769;140;909;8192;9101;-4;472;111995;3855;124951;1965493;1091275
2021-01-10;FVG;2943;919;2024;2943;0;0;0;ITH;ITH4;6;Friuli-Venezia Giulia;45.6494354;13.76813649;703;64;767;12118;12885;-5;642;41450;1898;56233;986523;355337
2021-01-10;PIE;5249;2290;2959;5246;0;3;0;ITC;ITC1;1;Piemonte;45.0732745;7.680687483;2703;176;2879;12463;15342;-487;803;183444;8176;206962;1739805;1009307
2021-01-10;SAR;2221;763;1458;2220;0;1;0;ITG;ITG2;20;Sardegna;39.21531192;9.110616306;507;47;554;16673;17227;85;301;15739;828;33794;507930;425815
2021-01-10;LOM;10557;3984;6573;10549;0;8;0;ITC;ITC4;3;Lombardia;45.46679409;9.190347404;3598;459;4057;53741;57798;2361;3267;417173;25787;500758;5048018;2674656
2021-01-10;PAT;87;20;67;87;0;0;0;ITH;ITH2;4;Provincia Autonoma Trento;46.06893511;11.12123097;343;46;389;1609;1998;160;345;20629;1013;23640;470118;155040
2021-01-10;VEN;5036;1673;3363;5035;0;1;0;ITH;ITH3;5;Veneto;45.43490485;12.33845213;2585;355;2940;85873;88813;-638;2167;189784;7389;285986;3466098;1259295
2021-01-10;MAR;1746;702;1044;1732;0;14;0;ITI;ITI3;11;Marche;43.61675973;13.5188753;541;73;614;14632;15246;640;687;29871;1698;46815;576643;345005
2021-01-10;MOL;270;72;198;270;0;0;0;ITF;ITF2;14;Molise;41.55774754;14.65916051;56;7;63;1183;1246;81;112;5632;212;7090;121872;111292
2021-01-10;PUG;2351;1062;1289;2351;0;0;0;ITF;ITF4;16;Puglia;41.12559576;16.86736689;1375;165;1540;53739;55279;544;1162;43662;2672;101613;1119005;684680
2021-01-10;PAB;2;2;0;2;0;0;0;ITH;ITH1;4;Provincia Autonoma Bolzano / Bozen;46.49933453;11.35662422;221;24;245;11415;11660;137;262;19081;778;31519;378840;167033
2021-01-11;PAT;765;235;530;765;0;0;0;ITH;ITH2;4;Provincia Autonoma Trento;46.06893511;11.12123097;350;45;395;1599;1994;-4;69;20696;1019;23709;470470;155196
2021-01-11;CAL;2195;1064;1131;2193;0;2;0;ITF;ITF6;18;Calabria;38.90597598;16.59440194;273;24;297;9332;9629;17;270;17056;519;27204;464378;444139
2021-01-11;UMB;1338;365;973;1338;0;0;0;ITI;ITI2;10;Umbria;43.10675841;12.38824698;272;51;323;3949;4272;-32;49;26019;664;30955;529153;260622
2021-01-11;TOS;5185;1719;3466;5084;0;101;0;ITI;ITI1;9;Toscana;43.76923077;11.25588885;789;144;933;8087;9020;-81;379;112426;3884;125330;1971143;1093335
2021-01-11;VEN;7244;2102;5142;7243;0;1;0;ITH;ITH3;5;Veneto;45.43490485;12.33845213;2582;358;2940;84600;87540;-1273;1715;192734;7427;287701;3477099;1262079
2021-01-11;LAZ;5766;2206;3560;5621;0;145;0;ITI;ITI4;12;Lazio;41.89277044;12.48366722;2887;321;3208;75673;78881;96;1254;97858;4176;180915;2840111;2106088
2021-01-11;FVG;1907;621;1286;1906;0;1;0;ITH;ITH4;6;Friuli-Venezia Giulia;45.6494354;13.76813649;688;67;755;12164;12919;34;361;41747;1928;56594;989014;356255
2021-01-11;PIE;8791;3001;5790;8785;0;6;0;ITC;ITC1;1;Piemonte;45.0732745;7.680687483;2705;177;2882;12103;14985;-357;609;184391;8195;207571;1744499;1011196
2021-01-11;CAM;4082;1879;2203;3967;0;115;0;ITF;ITF3;15;Campania;40.83956555;14.25084984;1400;109;1509;73208;74717;-671;1021;122910;3165;200792;2157456;1438729
2021-01-11;LOM;16321;5399;10922;16312;0;9;0;ITC;ITC4;3;Lombardia;45.46679409;9.190347404;3522;462;3984;50523;54507;-3291;1488;421890;25849;502246;5061374;2679880
2021-01-11;SIC;5937;2621;3316;5876;0;61;0;ITG;ITG1;19;Sicilia;38.11569725;13.362356699999998;1298;208;1506;41313;42819;1313;1587;64058;2765;109642;1311962;868928
2021-01-11;EMR;9359;3278;6081;9350;0;9;0;ITH;ITH5;8;Emilia-Romagna;44.49436681;11.341720800000001;2741;238;2979;58487;61466;1558;1942;122963;8403;192832;2704917;1272633
2021-01-11;MAR;1183;413;770;1165;0;18;0;ITI;ITI3;11;Marche;43.61675973;13.5188753;548;81;629;13940;14569;-677;333;30868;1711;47148;578570;346156
2021-01-11;PUG;3762;1594;2168;3761;0;1;0;ITF;ITF4;16;Puglia;41.12559576;16.86736689;1388;169;1557;53376;54933;-346;622;44604;2698;102235;1122582;687450
2021-01-11;LIG;2659;994;1665;2657;0;2;0;ITC;ITC3;7;Liguria;44.41149315;8.9326992;737;64;801;4281;5082;-144;226;55900;3018;64000;744811;333981
2021-01-11;ABR;1691;690;1001;1687;0;4;0;ITF;ITF1;13;Abruzzo;42.35122196;13.39843823;471;38;509;10871;11380;-161;120;25208;1285;37873;543730;278967
2021-01-11;VDA;328;113;215;328;0;0;0;ITC;ITC2;2;Valle d'Aosta / Vallée d'Aoste;45.73750286;7.320149366;52;1;53;389;442;12;27;6699;391;7532;65162;39852
2021-01-11;PAB;1594;522;1072;1594;0;0;0;ITH;ITH1;4;Provincia Autonoma Bolzano / Bozen;46.49933453;11.35662422;233;24;257;11453;11710;50;125;19155;779;31644;379596;167387
2021-01-11;MOL;562;194;368;562;0;0;0;ITF;ITF2;14;Molise;41.55774754;14.65916051;58;7;65;1145;1210;-36;25;5692;213;7115;122216;111540
2021-01-11;SAR;1219;522;697;1218;0;1;0;ITG;ITG2;20;Sardegna;39.21531192;9.110616306;517;48;565;16692;17257;30;231;15932;836;34025;510361;427715
2021-01-11;BAS;186;67;119;186;0;0;0;ITF;ITF5;17;Basilicata;40.63947052;15.80514834;92;6;98;6549;6647;10;79;5033;278;11958;194445;122613
2021-01-12;PUG;4227;1777;2450;4226;0;1;0;ITF;ITF4;16;Puglia;41.12559576;16.86736689;1392;170;1562;53688;55250;317;1261;45506;2740;103496;1133040;691753
2021-01-12;MAR;1237;418;819;1224;0;13;0;ITI;ITI3;11;Marche;43.61675973;13.5188753;588;79;667;13523;14190;-379;499;31734;1723;47647;584185;349670
2021-01-12;PAB;1712;461;1251;1712;0;0;0;ITH;ITH1;4;Provincia Autonoma Bolzano / Bozen;46.49933453;11.35662422;222;25;247;11449;11696;-14;99;19264;783;31743;381119;167793
2021-01-12;MOL;337;114;223;337;0;0;0;ITF;ITF2;14;Molise;41.55774754;14.65916051;59;6;65;1087;1152;-58;24;5769;218;7139;122584;111830
2021-01-12;VDA;303;73;230;303;0;0;0;ITC;ITC2;2;Valle d'Aosta / Vallée d'Aoste;45.73750286;7.320149366;49;1;50;382;432;-10;14;6722;392;7546;65492;40025
2021-01-12;ABR;1901;761;1140;1887;0;14;0;ITF;ITF1;13;Abruzzo;42.35122196;13.39843823;478;38;516;10621;11137;-243;152;25597;1291;38025;546247;279653
2021-01-12;LAZ;5597;2080;3517;5452;0;145;0;ITI;ITI4;12;Lazio;41.89277044;12.48366722;2871;326;3197;75390;78587;-294;1381;99491;4218;182296;2853312;2110984
2021-01-12;EMR;9484;3127;6357;9475;0;9;0;ITH;ITH5;8;Emilia-Romagna;44.49436681;11.341720800000001;2730;237;2967;57225;60192;-1274;1563;125749;8454;194395;2721570;1276221
2021-01-12;FVG;2291;735;1556;2291;0;0;0;ITH;ITH4;6;Friuli-Venezia Giulia;45.6494354;13.76813649;671;68;739;12179;12918;-1;647;42373;1950;57241;996728;358306
2021-01-12;PIE;10111;3423;6688;10105;0;6;0;ITC;ITC1;1;Piemonte;45.0732745;7.680687483;2653;171;2824;11946;14770;-215;901;185465;8237;208472;1751940;1014200
2021-01-12;BAS;217;88;129;217;0;0;0;ITF;ITF5;17;Basilicata;40.63947052;15.80514834;94;4;98;6622;6720;73;168;5125;281;12126;195667;123222
2021-01-12;VEN;5231;1517;3714;5223;0;8;0;ITH;ITH3;5;Veneto;45.43490485;12.33845213;2596;359;2955;81770;84725;-2815;2134;197517;7593;289835;3492966;1266111
2021-01-12;UMB;838;247;591;838;0;0;0;ITI;ITI2;10;Umbria;43.10675841;12.38824698;268;56;324;4024;4348;76;205;26140;672;31160;533099;261945
2021-01-12;SIC;4378;2143;2235;4332;0;46;0;ITG;ITG1;19;Sicilia;38.11569725;13.362356699999998;1342;209;1551;42487;44038;1219;1913;64712;2805;111555;1322705;875373
2021-01-12;SAR;891;417;474;891;0;0;0;ITG;ITG2;20;Sardegna;39.21531192;9.110616306;522;45;567;16846;17413;156;411;16173;850;34436;512981;429051
2021-01-12;CAM;5221;2569;2652;5082;0;139;0;ITF;ITF3;15;Campania;40.83956555;14.25084984;1414;109;1523;71066;72589;-2128;662;125656;3209;201454;2166203;1443145
2021-01-12;LOM;20346;6747;13599;20315;0;31;0;ITC;ITC4;3;Lombardia;45.46679409;9.190347404;3641;466;4107;50308;54415;-92;1146;423074;25903;503392;5077338;2685264
2021-01-12;CAL;2094;1035;1059;2085;0;9;0;ITF;ITF6;18;Calabria;38.90597598;16.59440194;275;22;297;9447;9744;115;249;17189;520;27453;466895;446647
2021-01-12;PAT;542;174;368;541;0;1;0;ITH;ITH2;4;Provincia Autonoma Trento;46.06893511;11.12123097;343;43;386;1587;1973;-21;234;20941;1029;23943;472036;155681
2021-01-12;LIG;2476;890;1586;2475;0;1;0;ITC;ITC3;7;Liguria;44.41149315;8.9326992;731;65;796;4232;5028;-54;276;56202;3046;64276;749871;335502
2021-01-12;TOS;3631;1417;2214;3558;0;73;0;ITI;ITI1;9;Toscana;43.76923077;11.25588885;773;137;910;7813;8723;-297;303;113005;3905;125633;1978712;1095969
2021-01-13;UMB;452;140;312;452;0;0;0;ITI;ITI2;10;Umbria;43.10675841;12.38824698;275;50;325;4145;4470;122;307;26321;676;31467;536852;263178
2021-01-13;LAZ;5901;2257;3644;5735;0;166;0;ITI;ITI4;12;Lazio;41.89277044;12.48366722;2892;313;3205;75018;78223;-364;1612;101426;4259;183908;2866990;2117488
2021-01-13;CAL;2112;1068;1044;2100;0;12;0;ITF;ITF6;18;Calabria;38.90597598;16.59440194;284;25;309;9302;9611;-133;283;17604;521;27736;470340;449634
2021-01-13;EMR;9082;2944;6138;9077;0;5;0;ITH;ITH5;8;Emilia-Romagna;44.49436681;11.341720800000001;2679;229;2908;55072;57980;-2212;1178;129073;8520;195573;2737403;1280780
2021-01-13;PAT;444;131;313;444;0;0;0;ITH;ITH2;4;Provincia Autonoma Trento;46.06893511;11.12123097;320;44;364;1624;1988;15;175;21093;1037;24118;474659;155952
2021-01-13;LIG;2761;1016;1745;2760;0;1;0;ITC;ITC3;7;Liguria;44.41149315;8.9326992;689;62;751;4251;5002;-26;395;56605;3064;64671;754313;336922
2021-01-13;SIC;5194;2448;2746;5160;0;34;0;ITG;ITG1;19;Sicilia;38.11569725;13.362356699999998;1371;208;1579;43098;44677;639;1969;66006;2841;113524;1333247;881698
2021-01-13;CAM;8031;3676;4355;7785;0;246;0;ITF;ITF3;15;Campania;40.83956555;14.25084984;1405;106;1511;70749;72260;-329;1098;127035;3257;202552;2180945;1452804
2021-01-13;FVG;2661;839;1822;2660;0;1;0;ITH;ITH4;6;Friuli-Venezia Giulia;45.6494354;13.76813649;665;69;734;12064;12798;-120;546;43008;1981;57787;1004009;359710
2021-01-13;VEN;5989;1606;4383;5986;0;3;0;ITH;ITH3;5;Veneto;45.43490485;12.33845213;2551;336;2887;79083;81970;-2755;1884;202065;7684;291719;3512029;1269858
2021-01-13;TOS;4126;1423;2703;4061;0;65;0;ITI;ITI1;9;Toscana;43.76923077;11.25588885;738;140;878;7948;8826;103;507;113398;3916;126140;1988970;1099685
2021-01-13;SAR;579;182;397;579;0;0;0;ITG;ITG2;20;Sardegna;39.21531192;9.110616306;532;47;579;16868;17447;34;233;16357;865;34669;516015;431661
2021-01-13;LOM;26497;8105;18392;26472;0;25;0;ITC;ITC4;3;Lombardia;45.46679409;9.190347404;3651;462;4113;50850;54963;548;2245;424720;25954;505637;5109218;2694848
2021-01-13;PAB;1727;569;1158;1727;0;0;0;ITH;ITH1;4;Provincia Autonoma Bolzano / Bozen;46.49933453;11.35662422;212;23;235;11440;11675;-21;269;19549;788;32012;383859;168457
2021-01-13;MAR;2114;747;1367;2073;0;41;0;ITI;ITI3;11;Marche;43.61675973;13.5188753;594;73;667;12491;13158;-1032;480;33234;1735;48127;591216;354258
2021-01-13;MOL;482;163;319;482;0;0;0;ITF;ITF2;14;Molise;41.55774754;14.65916051;55;9;64;1052;1116;-36;97;5901;219;7236;123555;112680
2021-01-13;PUG;4559;1736;2823;4558;0;1;0;ITF;ITF4;16;Puglia;41.12559576;16.86736689;1406;165;1571;53907;55478;228;1082;46345;2755;104578;1143261;695988
2021-01-13;ABR;1305;483;822;1297;0;8;0;ITF;ITF1;13;Abruzzo;42.35122196;13.39843823;468;40;508;10708;11216;79;314;25823;1300;38339;550152;280892
2021-01-13;VDA;338;110;228;338;0;0;0;ITC;ITC2;2;Valle d'Aosta / Vallée d'Aoste;45.73750286;7.320149366;43;2;45;375;420;-12;19;6753;392;7565;65735;40123
2021-01-13;BAS;917;387;530;917;0;0;0;ITF;ITF5;17;Basilicata;40.63947052;15.80514834;90;4;94;6642;6736;16;72;5177;284;12197;196701;123720
2021-01-13;PIE;10119;3241;6878;10110;0;9;0;ITC;ITC1;1;Piemonte;45.0732745;7.680687483;2605;172;2777;11983;14760;-10;1009;186443;8278;209481;1760650;1017635
2021-01-14;PUG;4088;1598;2490;4087;0;1;0;ITF;ITF4;16;Puglia;41.12559576;16.86736689;1387;162;1549;53986;55535;57;1524;47788;2779;106102;1152452;700132
2021-01-14;PAB;1953;578;1375;1953;0;0;0;ITH;ITH1;4;Provincia Autonoma Bolzano / Bozen;46.49933453;11.35662422;212;23;235;11370;11605;-70;174;19785;796;32186;386047;168946
2021-01-14;ABR;568;227;341;566;0;2;0;ITF;ITF1;13;Abruzzo;42.35122196;13.39843823;453;40;493;10687;11180;-36;256;26105;1309;38594;554396;282109
2021-01-14;BAS;973;413;560;973;0;0;0;ITF;ITF5;17;Basilicata;40.63947052;15.80514834;80;4;84;6721;6805;69;90;5196;286;12287;197440;124057
2021-01-14;VDA;237;69;168;237;0;0;0;ITC;ITC2;2;Valle d'Aosta / Vallée d'Aoste;45.73750286;7.320149366;43;2;45;367;412;-8;16;6777;392;7581;65958;40219
2021-01-14;MOL;653;240;413;653;0;0;0;ITF;ITF2;14;Molise;41.55774754;14.65916051;57;8;65;1082;1147;31;107;5974;222;7343;124521;113523
2021-01-14;LOM;26988;7827;19161;26936;0;52;0;ITC;ITC4;3;Lombardia;45.46679409;9.190347404;3614;468;4082;52018;56100;1137;2587;426098;26026;508224;5137863;2704477
2021-01-14;PAT;731;218;513;729;0;2;0;ITH;ITH2;4;Provincia Autonoma Trento;46.06893511;11.12123097;316;42;358;1720;2078;90;272;21271;1041;24390;477138;156362
2021-01-14;LAZ;5691;2247;3444;5514;0;177;0;ITI;ITI4;12;Lazio;41.89277044;12.48366722;2814;295;3109;74871;77980;-243;1816;103438;4306;185724;2880995;2124460
2021-01-14;SIC;5269;2495;2774;5207;0;62;0;ITG;ITG1;19;Sicilia;38.11569725;13.362356699999998;1397;205;1602;43263;44865;188;1867;67649;2877;115391;1343984;888140
2021-01-14;FVG;2601;799;1802;2598;0;3;0;ITH;ITH4;6;Friuli-Venezia Giulia;45.6494354;13.76813649;668;68;736;12127;12863;65;805;43723;2006;58592;1011978;361869
2021-01-14;PIE;9804;3161;6643;9798;0;6;0;ITC;ITC1;1;Piemonte;45.0732745;7.680687483;2575;172;2747;11976;14723;-37;857;187316;8299;210338;1767779;1020572
2021-01-14;SAR;1130;434;696;1130;0;0;0;ITG;ITG2;20;Sardegna;39.21531192;9.110616306;527;50;577;16876;17453;6;275;16616;875;34944;518905;434185
2021-01-14;UMB;725;192;533;725;0;0;0;ITI;ITI2;10;Umbria;43.10675841;12.38824698;277;51;328;4161;4489;19;210;26510;678;31677;539805;264287
2021-01-14;EMR;8136;2598;5538;8127;0;9;0;ITH;ITH5;8;Emilia-Romagna;44.49436681;11.341720800000001;2610;233;2843;53105;55948;-2032;1515;132548;8590;197086;2752436;1285504
2021-01-14;VEN;7066;1927;5139;7049;0;17;0;ITH;ITH3;5;Veneto;45.43490485;12.33845213;2447;328;2775;77050;79825;-2145;2076;206185;7785;293795;3526933;1274187
2021-01-14;TOS;3285;1186;2099;3249;0;36;0;ITI;ITI1;9;Toscana;43.76923077;11.25588885;723;132;855;7830;8685;-141;424;113949;3930;126564;1998217;1103382
2021-01-14;MAR;2019;696;1323;1995;0;24;0;ITI;ITI3;11;Marche;43.61675973;13.5188753;583;76;659;11534;12193;-965;506;34687;1753;48633;597883;358740
2021-01-14;LIG;2983;1056;1927;2982;0;1;0;ITC;ITC3;7;Liguria;44.41149315;8.9326992;678;65;743;4331;5074;72;289;56812;3074;64960;758219;338106
2021-01-14;CAL;2679;1272;1407;2673;0;6;0;ITF;ITF6;18;Calabria;38.90597598;16.59440194;284;29;313;9354;9667;56;286;17829;526;28022;473082;451787
2021-01-14;CAM;7082;2983;4099;6815;0;267;0;ITF;ITF3;15;Campania;40.83956555;14.25084984;1365;104;1469;71284;72753;493;1294;127795;3298;203846;2194673;1461530
2021-01-15;BAS;819;353;466;819;0;0;0;ITF;ITF5;17;Basilicata;40.63947052;15.80514834;80;4;84;6748;6832;27;78;5244;289;12365;199103;124461
2021-01-15;ABR;385;155;230;371;0;14;0;ITF;ITF1;13;Abruzzo;42.35122196;13.39843823;443;41;484;10763;11247;67;240;26276;1311;38834;558267;283574
2021-01-15;LAZ;6754;2785;3969;6581;0;173;0;ITI;ITI4;12;Lazio;41.89277044;12.48366722;2780;299;3079;74676;77755;-225;1394;105021;4342;187118;2909237;2140660
2021-01-15;EMR;7760;2409;5351;7752;0;8;0;ITH;ITH5;8;Emilia-Romagna;44.49436681;11.341720800000001;2511;231;2742;52768;55510;-438;1794;134711;8657;198878;2774816;1289999
2021-01-15;SAR;1576;575;1001;1574;0;2;0;ITG;ITG2;20;Sardegna;39.21531192;9.110616306;510;50;560;16891;17451;-2;260;16865;888;35204;521163;435962
2021-01-15;FVG;2021;605;1416;2020;0;1;0;ITH;ITH4;6;Friuli-Venezia Giulia;45.6494354;13.76813649;688;68;756;12123;12879;16;919;44597;2035;59511;1022612;365548
2021-01-15;TOS;3916;1362;2554;3856;0;60;0;ITI;ITI1;9;Toscana;43.76923077;11.25588885;715;129;844;7754;8598;-87;446;114472;3940;127010;2012434;1106215
2021-01-15;CAL;2820;1267;1553;2814;0;6;0;ITF;ITF6;18;Calabria;38.90597598;16.59440194;285;27;312;9498;9810;143;405;18087;530;28427;476032;454070
2021-01-15;PIE;9133;3015;6118;9127;0;6;0;ITC;ITC1;1;Piemonte;45.0732745;7.680687483;2522;163;2685;12121;14806;83;871;188084;8319;211209;1785825;1025418
2021-01-15;CAM;5000;2394;2606;4839;0;161;0;ITF;ITF3;15;Campania;40.83956555;14.25084984;1401;93;1494;71439;72933;180;1150;128728;3335;204996;2208602;1470534
2021-01-15;MAR;1775;501;1274;1757;0;18;0;ITI;ITI3;11;Marche;43.61675973;13.5188753;587;82;669;11020;11689;-504;629;35810;1763;49262;606048;362659
2021-01-15;LOM;25306;7463;17843;25254;0;52;0;ITC;ITC4;3;Lombardia;45.46679409;9.190347404;3601;466;4067;53087;57154;1054;2205;427181;26094;510429;5171810;2713639
2021-01-15;SIC;5326;2336;2990;5259;0;67;0;ITG;ITG1;19;Sicilia;38.11569725;13.362356699999998;1403;210;1613;43432;45045;180;1945;69375;2916;117336;1367989;894456
2021-01-15;VEN;5880;1819;4061;5874;0;6;0;ITH;ITH3;5;Veneto;45.43490485;12.33845213;2386;327;2713;72640;75353;-4472;1079;211662;7859;294874;3584775;1278230
2021-01-15;LIG;2264;756;1508;2259;0;5;0;ITC;ITC3;7;Liguria;44.41149315;8.9326992;668;59;727;4307;5034;-40;254;57096;3084;65214;764447;340315
2021-01-15;MOL;548;245;303;548;0;0;0;ITF;ITF2;14;Molise;41.55774754;14.65916051;56;7;63;1067;1130;-17;39;6026;226;7382;125405;114123
2021-01-15;PAT;628;149;479;627;0;1;0;ITH;ITH2;4;Provincia Autonoma Trento;46.06893511;11.12123097;304;42;346;1962;2308;230;362;21393;1051;24752;480620;156662
2021-01-15;VDA;220;83;137;220;0;0;0;ITC;ITC2;2;Valle d'Aosta / Vallée d'Aoste;45.73750286;7.320149366;40;3;43;373;416;4;20;6793;392;7601;66212;40288
2021-01-15;UMB;698;213;485;698;0;0;0;ITI;ITI2;10;Umbria;43.10675841;12.38824698;278;50;328;4161;4489;0;232;26738;682;31909;543318;265261
2021-01-15;PUG;4559;1866;2693;4554;0;5;0;ITF;ITF4;16;Puglia;41.12559576;16.86736689;1374;148;1522;54300;55822;287;1295;48765;2810;107397;1162264;705746
2021-01-15;PAB;3293;1234;2059;3292;0;1;0;ITH;ITH1;4;Provincia Autonoma Bolzano / Bozen;46.49933453;11.35662422;209;23;232;11575;11807;202;529;20106;802;32715;393231;169639
2021-01-16;LIG;1279;558;721;1274;0;5;0;ITC;ITC3;7;Liguria;44.41149315;8.9326992;653;63;716;4138;4854;-180;321;57577;3104;65535;770531;342608
2021-01-16;SIC;2737;1221;1516;2716;0;21;0;ITG;ITG1;19;Sicilia;38.11569725;13.362356699999998;1406;212;1618;43834;45452;407;1954;70884;2954;119290;1393086;900666
2021-01-16;TOS;3298;1059;2239;3240;0;58;0;ITI;ITI1;9;Toscana;43.76923077;11.25588885;706;125;831;7808;8639;41;436;114850;3957;127446;2026960;1111228
2021-01-16;SAR;1498;530;968;1498;0;0;0;ITG;ITG2;20;Sardegna;39.21531192;9.110616306;500;49;549;17126;17675;224;368;16999;898;35572;524445;439060
2021-01-16;CAM;3372;1677;1695;3261;0;111;0;ITF;ITF3;15;Campania;40.83956555;14.25084984;1432;97;1529;72537;74066;1133;1132;128727;3335;206128;2223213;1482060
2021-01-16;LOM;15668;5792;9876;15657;0;11;0;ITC;ITC4;3;Lombardia;45.46679409;9.190347404;3664;454;4118;53880;57998;844;2134;428393;26172;512563;5207127;2722288
2021-01-16;PIE;7789;2632;5157;7782;0;7;0;ITC;ITC1;1;Piemonte;45.0732745;7.680687483;2464;162;2626;12488;15114;308;1056;188770;8381;212265;1810200;1032298
2021-01-16;PAT;322;148;174;322;0;0;0;ITH;ITH2;4;Provincia Autonoma Trento;46.06893511;11.12123097;287;46;333;2053;2386;78;186;21494;1058;24938;484054;156935
2021-01-16;VEN;4612;1542;3070;4612;0;0;0;ITH;ITH3;5;Veneto;45.43490485;12.33845213;2317;338;2655;69716;72371;-2982;1929;216500;7932;296803;3621037;1281448
2021-01-16;FVG;1234;364;870;1234;0;0;0;ITH;ITH4;6;Friuli-Venezia Giulia;45.6494354;13.76813649;682;66;748;12235;12983;104;870;45328;2070;60381;1031793;368762
2021-01-16;PAB;2842;1266;1576;2842;0;0;0;ITH;ITH1;4;Provincia Autonoma Bolzano / Bozen;46.49933453;11.35662422;202;26;228;11857;12085;278;496;20319;807;33211;400728;170250
2021-01-16;PUG;2511;1036;1475;2510;0;1;0;ITF;ITF4;16;Puglia;41.12559576;16.86736689;1381;148;1529;54474;56003;181;1123;49692;2825;108520;1174161;709646
2021-01-16;MAR;2042;735;1307;1991;0;51;0;ITI;ITI3;11;Marche;43.61675973;13.5188753;591;85;676;10418;11094;-595;409;36805;1772;49671;611861;366327
2021-01-16;MOL;427;169;258;427;0;0;0;ITF;ITF2;14;Molise;41.55774754;14.65916051;56;8;64;1104;1168;38;101;6085;230;7483;126476;115076
2021-01-16;ABR;939;431;508;931;0;8;0;ITF;ITF1;13;Abruzzo;42.35122196;13.39843823;443;41;484;10802;11286;39;196;26427;1317;39030;562518;285216
2021-01-16;VDA;239;80;159;239;0;0;0;ITC;ITC2;2;Valle d'Aosta / Vallée d'Aoste;45.73750286;7.320149366;44;4;48;365;413;-3;20;6815;393;7621;66406;40331
2021-01-16;UMB;204;61;143;203;0;1;0;ITI;ITI2;10;Umbria;43.10675841;12.38824698;278;49;327;4276;4603;114;241;26858;689;32150;547494;266388
2021-01-16;LAZ;5821;2360;3461;5673;0;148;0;ITI;ITI4;12;Lazio;41.89277044;12.48366722;2792;286;3078;74298;77376;-379;1282;106646;4378;188400;2939085;2155766
2021-01-16;BAS;726;305;421;726;0;0;0;ITF;ITF5;17;Basilicata;40.63947052;15.80514834;87;3;90;6791;6881;49;87;5280;291;12452;199893;124764
2021-01-16;CAL;2429;1140;1289;2426;0;3;0;ITF;ITF6;18;Calabria;38.90597598;16.59440194;291;27;318;9672;9990;180;295;18200;532;28722;478918;456760
2021-01-16;EMR;5633;1720;3913;5632;0;1;0;ITH;ITH5;8;Emilia-Romagna;44.49436681;11.341720800000001;2508;231;2739;52541;55280;-230;1674;136567;8705;200552;2795628;1294547
2021-01-17;MOL;78;38;40;48;30;0;0;ITF;ITF2;14;Molise;41.55774754;14.65916051;59;9;68;1076;1144;-24;70;6178;231;7553;127202;115685
2021-01-17;VDA;131;56;75;131;0;0;0;ITC;ITC2;2;Valle d'Aosta / Vallée d'Aoste;45.73750286;7.320149366;41;3;44;371;415;2;18;6830;394;7639;66544;40383
2021-01-17;BAS;332;133;199;331;1;0;0;ITF;ITF5;17;Basilicata;40.63947052;15.80514834;85;4;89;6829;6918;37;49;5290;293;12501;200849;125030
2021-01-17;ABR;193;64;129;185;7;1;0;ITF;ITF1;13;Abruzzo;42.35122196;13.39843823;443;38;481;11071;11552;266;285;26438;1325;39315;566681;286824
2021-01-17;CAL;915;441;474;809;100;6;0;ITF;ITF6;18;Calabria;38.90597598;16.59440194;290;25;315;9918;10233;243;351;18305;535;29073;481467;458733
2021-01-17;VEN;1933;781;1152;1584;349;0;0;ITH;ITH3;5;Veneto;45.43490485;12.33845213;2293;338;2631;68009;70640;-1731;1369;219554;7978;298172;3643743;1283820
2021-01-17;LAZ;4970;2055;2915;4692;213;65;0;ITI;ITI4;12;Lazio;41.89277044;12.48366722;2766;296;3062;74448;77510;134;1243;107734;4399;189643;2962528;2165251
2021-01-17;SAR;867;278;589;866;1;0;0;ITG;ITG2;20;Sardegna;39.21531192;9.110616306;507;48;555;17193;17748;73;202;17123;903;35774;527564;441973
2021-01-17;LOM;8363;3353;5010;8156;201;6;0;ITC;ITC4;3;Lombardia;45.46679409;9.190347404;3610;452;4062;52080;56142;-1856;1603;431787;26237;514166;5232178;2729492
2021-01-17;CAM;1154;551;603;681;453;20;0;ITF;ITF3;15;Campania;40.83956555;14.25084984;1460;94;1554;71557;73111;-955;1021;130668;3370;207149;2237801;1493903
2021-01-17;EMR;2898;890;2008;2648;249;1;0;ITH;ITH5;8;Emilia-Romagna;44.49436681;11.341720800000001;2529;234;2763;52068;54831;-449;1437;138411;8746;201988;2810351;1299105
2021-01-17;UMB;55;17;38;55;0;0;0;ITI;ITI2;10;Umbria;43.10675841;12.38824698;280;49;329;4277;4606;3;153;27004;693;32303;550730;267377
2021-01-17;SIC;1315;599;716;1240;66;9;0;ITG;ITG1;19;Sicilia;38.11569725;13.362356699999998;1422;208;1630;44795;46425;973;1439;71315;2989;120729;1437613;906120
2021-01-17;LIG;866;301;565;865;0;1;0;ITC;ITC3;7;Liguria;44.41149315;8.9326992;657;62;719;4247;4966;112;228;57681;3116;65763;774653;344159
2021-01-17;TOS;2543;871;1672;1994;514;35;0;ITI;ITI1;9;Toscana;43.76923077;11.25588885;698;118;816;7388;8204;-435;406;115676;3972;127852;2039503;1116053
2021-01-17;MAR;1626;696;930;1555;65;6;0;ITI;ITI3;11;Marche;43.61675973;13.5188753;590;83;673;9869;10542;-552;440;37786;1783;50111;618418;370474
2021-01-17;PAB;2329;1044;1285;2318;11;0;0;ITH;ITH1;4;Provincia Autonoma Bolzano / Bozen;46.49933453;11.35662422;202;26;228;11871;12099;14;308;20611;809;33519;404920;171063
2021-01-17;PUG;1312;593;719;1242;70;0;0;ITF;ITF4;16;Puglia;41.12559576;16.86736689;1403;142;1545;54575;56120;117;908;50458;2850;109428;1181733;711017
2021-01-17;PAT;255;199;56;255;0;0;0;ITH;ITH2;4;Provincia Autonoma Trento;46.06893511;11.12123097;285;47;332;2098;2430;44;135;21581;1062;25073;486687;157231
2021-01-17;FVG;1716;522;1194;1714;0;2;0;ITH;ITH4;6;Friuli-Venezia Giulia;45.6494354;13.76813649;677;63;740;11998;12738;-245;385;45936;2092;60766;1036684;370840
2021-01-17;PIE;3532;1169;2363;2879;650;3;0;ITC;ITC1;1;Piemonte;45.0732745;7.680687483;2460;164;2624;12376;15000;-114;495;189360;8400;212760;1818843;1034494
2021-01-18;CAM;959;399;560;683;244;32;0;ITF;ITF3;15;Campania;40.83956555;14.25084984;1448;94;1542;71120;72662;-449;714;131806;3395;207863;2245559;1498475
2021-01-18;EMR;3133;881;2252;2449;681;3;0;ITH;ITH5;8;Emilia-Romagna;44.49436681;11.341720800000001;2564;238;2802;51428;54230;-601;1153;140114;8797;203141;2820331;1301697
2021-01-18;FVG;1964;608;1356;1870;94;0;0;ITH;ITH4;6;Friuli-Venezia Giulia;45.6494354;13.76813649;680;63;743;11942;12685;-53;153;46121;2113;60919;1038677;371716
2021-01-18;SIC;1627;676;951;1456;160;11;0;ITG;ITG1;19;Sicilia;38.11569725;13.362356699999998;1444;205;1649;45236;46885;460;1278;72095;3027;122007;1477389;911144
2021-01-18;CAL;1312;595;717;1058;250;4;0;ITF;ITF6;18;Calabria;38.90597598;16.59440194;312;24;336;9878;10214;-19;256;18576;539;29329;483031;460266
2021-01-18;VEN;2766;778;1988;2562;199;5;0;ITH;ITH3;5;Veneto;45.43490485;12.33845213;2233;336;2569;66514;69083;-1557;998;222062;8025;299170;3663538;1285644
2021-01-18;UMB;622;224;398;532;90;0;0;ITI;ITI2;10;Umbria;43.10675841;12.38824698;284;49;333;4247;4580;-26;94;27116;701;32397;551381;267595
2021-01-18;PIE;6181;2051;4130;5926;251;4;0;ITC;ITC1;1;Piemonte;45.0732745;7.680687483;2470;166;2636;12153;14789;-211;435;189987;8419;213195;1829660;1036864
2021-01-18;SAR;912;329;583;783;129;0;0;ITG;ITG2;20;Sardegna;39.21531192;9.110616306;506;51;557;17059;17616;-132;136;17387;907;35910;530803;443327
2021-01-18;MAR;696;237;459;536;149;11;0;ITI;ITI3;11;Marche;43.61675973;13.5188753;591;85;676;9575;10251;-291;157;38223;1794;50268;621742;371928
2021-01-18;LIG;2146;749;1397;1987;157;2;0;ITC;ITC3;7;Liguria;44.41149315;8.9326992;654;64;718;4331;5049;83;263;57849;3128;66026;777459;345256
2021-01-18;PAT;690;168;522;631;59;0;0;ITH;ITH2;4;Provincia Autonoma Trento;46.06893511;11.12123097;287;46;333;2030;2363;-67;56;21690;1076;25129;487395;157426
2021-01-18;TOS;1127;639;488;979;98;50;0;ITI;ITI1;9;Toscana;43.76923077;11.25588885;720;125;845;7488;8333;129;345;115870;3994;128197;2046397;1118704
2021-01-18;PAB;1777;689;1088;1772;5;0;0;ITH;ITH1;4;Provincia Autonoma Bolzano / Bozen;46.49933453;11.35662422;214;30;244;11869;12113;14;165;20760;811;33684;406945;171473
2021-01-18;MOL;117;48;69;117;0;0;0;ITF;ITF2;14;Molise;41.55774754;14.65916051;60;10;70;1015;1085;-59;33;6268;233;7586;127577;115984
2021-01-18;PUG;1849;772;1077;1497;351;1;0;ITF;ITF4;16;Puglia;41.12559576;16.86736689;1398;143;1541;53971;55512;-608;403;51443;2876;109831;1184798;713076
2021-01-18;VDA;214;74;140;214;0;0;0;ITC;ITC2;2;Valle d'Aosta / Vallée d'Aoste;45.73750286;7.320149366;45;2;47;368;415;0;11;6840;395;7650;66690;40452
2021-01-18;LAZ;6408;2613;3795;5301;981;126;0;ITI;ITI4;12;Lazio;41.89277044;12.48366722;2885;315;3200;74145;77345;-165;872;108755;4415;190515;2977732;2172390
2021-01-18;LOM;9271;2994;6277;8281;975;15;0;ITC;ITC4;3;Lombardia;45.46679409;9.190347404;3553;449;4002;49562;53564;-2578;1189;435509;26282;515355;5248516;2734701
2021-01-18;ABR;155;71;84;53;102;0;0;ITF;ITF1;13;Abruzzo;42.35122196;13.39843823;454;43;497;10885;11382;-170;107;26707;1333;39422;578709;294728
2021-01-18;BAS;465;158;307;366;99;0;0;ITF;ITF5;17;Basilicata;40.63947052;15.80514834;82;6;88;6815;6903;-15;7;5311;294;12508;201037;125063
2021-01-19;MOL;174;63;111;163;11;0;0;ITF;ITF2;14;Molise;41.55774754;14.65916051;62;9;71;1025;1096;11;18;6270;238;7604;127978;116346
2021-01-19;MAR;233;87;146;140;90;3;0;ITI;ITI3;11;Marche;43.61675973;13.5188753;587;85;672;8868;9540;-711;359;39277;1810;50627;627246;374409
2021-01-19;ABR;112;56;56;90;21;1;0;ITF;ITF1;13;Abruzzo;42.35122196;13.39843823;443;44;487;10559;11046;-336;113;27147;1342;39535;582757;296475
2021-01-19;PUG;1221;452;769;1210;10;1;0;ITF;ITF4;16;Puglia;41.12559576;16.86736689;1354;142;1496;53695;55191;-321;850;52598;2892;110681;1197220;718201
2021-01-19;VDA;256;77;179;256;0;0;0;ITC;ITC2;2;Valle d'Aosta / Vallée d'Aoste;45.73750286;7.320149366;46;2;48;350;398;-17;34;6888;398;7684;67065;40546
2021-01-19;CAM;1110;485;625;1055;5;50;0;ITF;ITF3;15;Campania;40.83956555;14.25084984;1468;97;1565;70315;71880;-782;651;133205;3429;208514;2255000;1503706
2021-01-19;EMR;2051;508;1543;2033;17;1;0;ITH;ITH5;8;Emilia-Romagna;44.49436681;11.341720800000001;2520;232;2752;50489;53241;-989;1034;142061;8872;204174;2843983;1305531
2021-01-19;BAS;199;84;115;199;0;0;0;ITF;ITF5;17;Basilicata;40.63947052;15.80514834;77;5;82;6859;6941;38;60;5325;302;12568;201803;125394
2021-01-19;CAL;1133;500;633;1118;13;2;0;ITF;ITF6;18;Calabria;38.90597598;16.59440194;305;24;329;9766;10095;-119;191;18886;539;29520;485497;462406
2021-01-19;UMB;102;23;79;102;0;0;0;ITI;ITI2;10;Umbria;43.10675841;12.38824698;292;47;339;4297;4636;56;225;27280;706;32622;556351;268826
2021-01-19;SIC;1527;677;850;1271;241;15;0;ITG;ITG1;19;Sicilia;38.11569725;13.362356699999998;1456;211;1667;45860;47527;642;1641;73057;3064;123648;1498556;917147
2021-01-19;LAZ;4809;1975;2834;4352;454;3;0;ITI;ITI4;12;Lazio;41.89277044;12.48366722;2768;305;3073;72163;75236;-2109;1100;111905;4474;191615;3014033;2187526
2021-01-19;SAR;752;271;481;696;55;1;0;ITG;ITG2;20;Sardegna;39.21531192;9.110616306;506;53;559;16863;17422;-194;109;17682;915;36019;533721;445558
2021-01-19;LIG;1375;441;934;1281;90;4;0;ITC;ITC3;7;Liguria;44.41149315;8.9326992;643;60;703;4108;4811;-238;235;58305;3145;66261;785085;348468
2021-01-19;LOM;8068;2333;5735;7583;471;14;0;ITC;ITC4;3;Lombardia;45.46679409;9.190347404;3619;425;4044;49417;53461;-103;930;436485;26339;516285;5272645;2739301
2021-01-19;VEN;1313;475;838;1163;149;1;0;ITH;ITH3;5;Veneto;45.43490485;12.33845213;2164;318;2482;60689;63171;-5912;957;228769;8187;300127;3707016;1288715
2021-01-19;PIE;6482;2111;4371;6464;9;9;0;ITC;ITC1;1;Piemonte;45.0732745;7.680687483;2500;168;2668;11770;14438;-351;716;191020;8453;213911;1849979;1042663
2021-01-19;PAT;434;89;345;434;0;0;0;ITH;ITH2;4;Provincia Autonoma Trento;46.06893511;11.12123097;271;46;317;1771;2088;-275;143;22103;1081;25272;490433;158063
2021-01-19;FVG;10;4;6;10;0;0;0;ITH;ITH4;6;Friuli-Venezia Giulia;45.6494354;13.76813649;691;63;754;11831;12585;-100;454;46657;2131;61373;1049086;375814
2021-01-19;PAB;853;371;482;723;130;0;0;ITH;ITH1;4;Provincia Autonoma Bolzano / Bozen;46.49933453;11.35662422;212;30;242;12224;12466;353;436;20834;820;34120;414343;171790
2021-01-19;TOS;1116;535;581;1074;0;42;0;ITI;ITI1;9;Toscana;43.76923077;11.25588885;715;121;836;7419;8255;-78;241;116163;4020;128438;2059639;1122905
2021-01-20;UMB;603;221;382;603;0;0;0;ITI;ITI2;10;Umbria;43.10675841;12.38824698;283;46;329;4276;4605;-31;277;27580;714;32899;560860;270098
2021-01-20;CAL;1410;630;780;1406;1;3;0;ITF;ITF6;18;Calabria;38.90597598;16.59440194;303;27;330;9775;10105;10;313;19185;543;29833;488659;464842
2021-01-20;VEN;1039;368;671;387;652;0;0;ITH;ITH3;5;Veneto;45.43490485;12.33845213;2096;315;2411;55058;57469;-5702;1359;235761;8256;301486;3751330;1292317
2021-01-20;PAT;308;77;231;296;12;0;0;ITH;ITH2;4;Provincia Autonoma Trento;46.06893511;11.12123097;255;42;297;1789;2086;-2;278;22379;1085;25550;494383;158387
2021-01-20;FVG;759;325;434;22;737;0;0;ITH;ITH4;6;Friuli-Venezia Giulia;45.6494354;13.76813649;693;58;751;11580;12331;-254;672;47557;2157;62045;1059906;382543
2021-01-20;CAM;1264;654;610;1233;0;31;0;ITF;ITF3;15;Campania;40.83956555;14.25084984;1448;100;1548;69318;70866;-1014;968;135145;3471;209482;2270343;1513174
2021-01-20;PIE;6644;2098;4546;5913;724;7;0;ITC;ITC1;1;Piemonte;45.0732745;7.680687483;2466;165;2631;11274;13905;-533;606;192116;8496;214517;1868847;1046508
2021-01-20;EMR;1331;269;1062;1329;1;1;0;ITH;ITH5;8;Emilia-Romagna;44.49436681;11.341720800000001;2490;230;2720;49859;52579;-662;1090;143747;8935;205261;2864629;1310129
2021-01-20;SAR;215;78;137;213;2;0;0;ITG;ITG2;20;Sardegna;39.21531192;9.110616306;488;53;541;16735;17276;-146;216;18039;920;36235;537922;448796
2021-01-20;TOS;1346;644;702;1034;249;63;0;ITI;ITI1;9;Toscana;43.76923077;11.25588885;696;113;809;7473;8282;27;443;116561;4038;128881;2079166;1128285
2021-01-20;LAZ;4843;1963;2880;3290;1547;6;0;ITI;ITI4;12;Lazio;41.89277044;12.48366722;2735;288;3023;70166;73189;-2047;1281;115172;4535;192896;3043028;2203834
2021-01-20;SIC;969;513;456;691;275;3;0;ITG;ITG1;19;Sicilia;38.11569725;13.362356699999998;1459;215;1674;45033;46707;-820;1486;75326;3101;125134;1518559;923280
2021-01-20;LOM;5720;1395;4325;5600;115;5;0;ITC;ITC4;3;Lombardia;45.46679409;9.190347404;3650;428;4078;49620;53698;237;1876;438058;26405;518161;5311238;2748344
2021-01-20;PUG;1547;541;1006;1537;8;2;0;ITF;ITF4;16;Puglia;41.12559576;16.86736689;1350;148;1498;53603;55101;-90;1159;53822;2917;111840;1208705;722341
2021-01-20;MOL;18;8;10;18;0;0;0;ITF;ITF2;14;Molise;41.55774754;14.65916051;57;9;66;1069;1135;39;54;6283;240;7658;128930;117197
2021-01-20;LIG;1560;557;1003;1547;12;1;0;ITC;ITC3;7;Liguria;44.41149315;8.9326992;643;59;702;4056;4758;-53;285;58619;3169;66546;791742;351024
2021-01-20;PAB;619;254;365;410;209;0;0;ITH;ITH1;4;Provincia Autonoma Bolzano / Bozen;46.49933453;11.35662422;218;30;248;12284;12532;66;441;21205;824;34561;422197;172405
2021-01-20;ABR;449;157;292;427;2;20;0;ITF;ITF1;13;Abruzzo;42.35122196;13.39843823;443;45;488;10499;10987;-59;279;27478;1349;39814;594245;302829
2021-01-20;BAS;85;22;63;84;1;0;0;ITF;ITF5;17;Basilicata;40.63947052;15.80514834;77;4;81;6868;6949;8;57;5374;302;12625;202706;125769
2021-01-20;VDA;64;15;49;64;0;0;0;ITC;ITC2;2;Valle d'Aosta / Vallée d'Aoste;45.73750286;7.320149366;46;2;48;330;378;-20;14;6921;399;7698;67435;40647
2021-01-20;MAR;407;100;307;385;20;2;0;ITI;ITI3;11;Marche;43.61675973;13.5188753;573;84;657;7958;8615;-925;417;40604;1825;51044;634368;379285
2021-01-21;PUG;2133;905;1228;1268;863;2;0;ITF;ITF4;16;Puglia;41.12559576;16.86736689;1346;151;1497;53287;54784;-317;1275;55388;2943;113115;1220229;725978
2021-01-21;MAR;922;262;660;577;328;17;0;ITI;ITI3;11;Marche;43.61675973;13.5188753;555;83;638;7436;8074;-541;500;41629;1841;51544;644321;383793
2021-01-21;LIG;1109;385;724;677;431;1;0;ITC;ITC3;7;Liguria;44.41149315;8.9326992;635;62;697;3906;4603;-155;243;59003;3183;66789;798715;353662
2021-01-21;ABR;157;47;110;157;0;0;0;ITF;ITF1;13;Abruzzo;42.35122196;13.39843823;442;43;485;10175;10660;-327;212;28007;1358;40025;605038;309374
2021-01-21;TOS;1593;687;906;862;722;9;0;ITI;ITI1;9;Toscana;43.76923077;11.25588885;659;116;775;7528;8303;21;503;117029;4052;129384;2093934;1133867
2021-01-21;MOL;6;2;4;6;0;0;0;ITF;ITF2;14;Molise;41.55774754;14.65916051;56;8;64;981;1045;-90;34;6404;243;7692;129540;117712
2021-01-21;FVG;901;347;554;5;896;0;0;ITH;ITH4;6;Friuli-Venezia Giulia;45.6494354;13.76813649;680;59;739;11441;12180;-151;657;48339;2183;62702;1069891;388963
2021-01-21;PIE;6890;2318;4572;3378;3506;6;0;ITC;ITC1;1;Piemonte;45.0732745;7.680687483;2419;159;2578;11015;13593;-312;761;193160;8525;215278;1886295;1051394
2021-01-21;PAB;969;452;517;140;829;0;0;ITH;ITH1;4;Provincia Autonoma Bolzano / Bozen;46.49933453;11.35662422;226;28;254;12569;12823;291;566;21473;831;35127;429833;173213
2021-01-21;VDA;33;12;21;33;0;0;0;ITC;ITC2;2;Valle d'Aosta / Vallée d'Aoste;45.73750286;7.320149366;42;2;44;297;341;-37;17;6955;400;7696;67714;40709
2021-01-21;CAM;2106;1125;981;678;1421;7;0;ITF;ITF3;15;Campania;40.83956555;14.25084984;1440;100;1540;69638;71178;312;1215;136008;3511;210697;2285816;1525098
2021-01-21;BAS;31;10;21;30;1;0;0;ITF;ITF5;17;Basilicata;40.63947052;15.80514834;80;6;86;6855;6941;-8;59;5437;306;12684;203479;126040
2021-01-21;SIC;1459;716;743;490;958;11;0;ITG;ITG1;19;Sicilia;38.11569725;13.362356699999998;1436;221;1657;45241;46898;191;1230;76337;3129;126364;1540168;929118
2021-01-21;PAT;376;104;272;247;129;0;0;ITH;ITH2;4;Provincia Autonoma Trento;46.06893511;11.12123097;236;43;279;1727;2006;-80;164;22616;1092;25714;498378;158775
2021-01-21;LAZ;5761;2428;3333;647;5114;0;0;ITI;ITI4;12;Lazio;41.89277044;12.48366722;2653;280;2933;69752;72685;-504;1303;116943;4571;194199;3069436;2220150
2021-01-21;LOM;5534;1612;3922;4824;695;15;0;ITC;ITC4;3;Lombardia;45.46679409;9.190347404;3644;411;4055;49000;53055;-643;2234;440880;26460;520395;5348951;2757927
2021-01-21;UMB;609;203;406;339;269;1;0;ITI;ITI2;10;Umbria;43.10675841;12.38824698;286;46;332;4389;4721;116;286;27741;723;33185;565609;271405
2021-01-21;SAR;140;69;71;98;42;0;0;ITG;ITG2;20;Sardegna;39.21531192;9.110616306;466;51;517;16599;17116;-160;238;18430;927;36473;543913;452782
2021-01-21;EMR;2170;732;1438;821;1349;0;0;ITH;ITH5;8;Emilia-Romagna;44.49436681;11.341720800000001;2456;218;2674;49363;52037;-542;1320;145533;9008;206578;2886578;1314707
2021-01-21;VEN;2294;719;1575;19;2275;0;0;ITH;ITH3;5;Veneto;45.43490485;12.33845213;1991;305;2296;51261;53557;-3912;1003;240568;8364;302489;3787282;1295531
2021-01-21;CAL;989;462;527;951;35;3;0;ITF;ITF6;18;Calabria;38.90597598;16.59440194;297;26;323;9645;9968;-137;258;19571;552;30091;491645;467196
2021-01-22;ABR;118;57;61;118;0;0;0;ITF;ITF1;13;Abruzzo;42.35122196;13.39843823;441;40;481;10018;10499;-161;318;28469;1375;40343;614350;314649
2021-01-22;BAS;67;24;43;67;0;0;0;ITF;ITF5;17;Basilicata;40.63947052;15.80514834;83;5;88;6881;6969;28;51;5460;306;12735;204406;126376
2021-01-22;VDA;58;22;36;22;36;0;0;ITC;ITC2;2;Valle d'Aosta / Vallée d'Aoste;45.73750286;7.320149366;40;2;42;289;331;-10;19;6984;400;7715;67890;40791
2021-01-22;SIC;1294;641;653;260;1032;2;0;ITG;ITG1;19;Sicilia;38.11569725;13.362356699999998;1441;222;1663;45626;47289;391;1355;77269;3161;127719;1560423;935211
2021-01-22;LAZ;4042;1657;2385;524;3518;0;0;ITI;ITI4;12;Lazio;41.89277044;12.48366722;2673;289;2962;68484;71446;-1239;1141;119270;4624;195340;3096428;2236554
2021-01-22;SAR;84;47;37;56;28;0;0;ITG;ITG2;20;Sardegna;39.21531192;9.110616306;449;52;501;16502;17003;-113;212;18746;936;36685;547436;455697
2021-01-22;CAM;1534;783;751;666;854;14;0;ITF;ITF3;15;Campania;40.83956555;14.25084984;1438;104;1542;60591;62133;-9045;1106;146113;3557;211803;2299650;1529694
2021-01-22;CAL;662;276;386;660;2;0;0;ITF;ITF6;18;Calabria;38.90597598;16.59440194;278;24;302;9804;10106;138;368;19795;558;30459;494764;469935
2021-01-22;LIG;1828;605;1223;1336;490;2;0;ITC;ITC3;7;Liguria;44.41149315;8.9326992;615;61;676;3842;4518;-85;313;59381;3203;67102;805701;356370
2021-01-22;EMR;1836;480;1356;1088;746;2;0;ITH;ITH5;8;Emilia-Romagna;44.49436681;11.341720800000001;2402;220;2622;48589;51211;-826;1347;147663;9051;207925;2908287;1318796
2021-01-22;VEN;1080;332;748;25;1055;0;0;ITH;ITH3;5;Veneto;45.43490485;12.33845213;1935;291;2226;47624;49850;-3707;1198;245398;8439;303687;3830872;1298664
2021-01-22;LOM;3199;885;2314;3125;69;5;0;ITC;ITC4;3;Lombardia;45.46679409;9.190347404;3579;408;3987;49228;53215;160;1969;442631;26518;522364;5383007;2766601
2021-01-22;FVG;182;113;69;91;91;0;0;ITH;ITH4;6;Friuli-Venezia Giulia;45.6494354;13.76813649;669;61;730;11360;12090;-90;452;48858;2206;63154;1077328;393779
2021-01-22;PIE;3890;1257;2633;2543;1346;1;0;ITC;ITC1;1;Piemonte;45.0732745;7.680687483;2342;152;2494;10862;13356;-237;849;194223;8548;216127;1907355;1055264
2021-01-22;TOS;2867;1064;1803;526;2338;3;0;ITI;ITI1;9;Toscana;43.76923077;11.25588885;642;110;752;7450;8202;-101;429;117543;4068;129813;2108893;1139530
2021-01-22;PAT;1748;459;1289;350;1396;2;0;ITH;ITH2;4;Provincia Autonoma Trento;46.06893511;11.12123097;219;41;260;1785;2045;39;179;22755;1093;25893;502258;159147
2021-01-22;PAB;248;143;105;124;124;0;0;ITH;ITH1;4;Provincia Autonoma Bolzano / Bozen;46.49933453;11.35662422;227;24;251;12790;13041;218;510;21762;834;35637;436669;173733
2021-01-22;MOL;128;36;92;128;0;0;0;ITF;ITF2;14;Molise;41.55774754;14.65916051;53;8;61;990;1051;6;57;6454;244;7749;130245;118317
2021-01-22;MAR;489;168;321;193;294;2;0;ITI;ITI3;11;Marche;43.61675973;13.5188753;555;79;634;7637;8271;197;437;41858;1852;51981;653333;388208
2021-01-22;UMB;276;105;171;32;244;0;0;ITI;ITI2;10;Umbria;43.10675841;12.38824698;283;44;327;4553;4880;159;305;27884;726;33490;572082;272550
2021-01-22;PUG;1414;579;835;992;421;1;0;ITF;ITF4;16;Puglia;41.12559576;16.86736689;1327;153;1480;53067;54547;-237;1018;56611;2975;114133;1230116;729722
2021-01-23;CAL;403;188;215;360;43;0;0;ITF;ITF6;18;Calabria;38.90597598;16.59440194;275;24;299;10041;10340;234;402;19960;561;30861;497688;472687
2021-01-23;PAT;584;338;246;389;194;1;0;ITH;ITH2;4;Provincia Autonoma Trento;46.06893511;11.12123097;203;43;246;1801;2047;2;193;22940;1099;26086;506297;159454
2021-01-23;FVG;816;323;493;5;811;0;0;ITH;ITH4;6;Friuli-Venezia Giulia;45.6494354;13.76813649;672;63;735;11163;11898;-192;679;49705;2230;63833;1087567;397725
2021-01-23;LAZ;7221;2872;4349;590;6631;0;0;ITI;ITI4;12;Lazio;41.89277044;12.48366722;2576;283;2859;67407;70266;-1180;1297;121705;4666;196637;3127016;2252794
2021-01-23;VEN;4057;1250;2807;31;4026;0;0;ITH;ITH3;5;Veneto;45.43490485;12.33845213;1843;286;2129;45412;47541;-2309;1030;248645;8531;304717;3880349;1301596
2021-01-23;EMR;2448;871;1577;439;2009;0;0;ITH;ITH5;8;Emilia-Romagna;44.49436681;11.341720800000001;2390;217;2607;48125;50732;-479;1310;149419;9084;209235;2932963;1322682
2021-01-23;TOS;3982;1361;2621;641;3335;6;0;ITI;ITI1;9;Toscana;43.76923077;11.25588885;629;107;736;7525;8261;59;520;117983;4089;130333;2123933;1145629
2021-01-23;SAR;61;23;38;0;61;0;0;ITG;ITG2;20;Sardegna;39.21531192;9.110616306;457;46;503;16520;17023;20;191;18907;946;36876;550085;457957
2021-01-23;LIG;813;297;516;156;657;0;0;ITC;ITC3;7;Liguria;44.41149315;8.9326992;591;65;656;3914;4570;52;298;59610;3220;67400;812181;358768
2021-01-23;CAM;3843;2032;1811;267;3570;6;0;ITF;ITF3;15;Campania;40.83956555;14.25084984;1437;114;1551;60902;62453;320;1150;146914;3586;212953;2315313;1541151
2021-01-23;PIE;4265;1328;2937;878;3385;2;0;ITC;ITC1;1;Piemonte;45.0732745;7.680687483;2337;156;2493;10962;13455;99;931;195029;8574;217058;1931124;1061000
2021-01-23;LOM;1128;362;766;925;200;3;0;ITC;ITC4;3;Lombardia;45.46679409;9.190347404;3499;398;3897;48571;52468;-747;1535;444809;26622;523899;5414816;2773895
2021-01-23;PAB;197;117;80;0;197;0;0;ITH;ITH1;4;Provincia Autonoma Bolzano / Bozen;46.49933453;11.35662422;219;24;243;13143;13386;345;552;21966;837;36189;444641;174483
2021-01-23;MAR;557;190;367;118;436;3;0;ITI;ITI3;11;Marche;43.61675973;13.5188753;549;77;626;7785;8411;140;397;42103;1864;52378;662555;392606
2021-01-23;SIC;4493;2311;2182;207;4276;10;0;ITG;ITG1;19;Sicilia;38.11569725;13.362356699999998;1444;223;1667;45960;47627;338;1158;78056;3194;128877;1583888;940932
2021-01-23;PUG;3044;1295;1749;880;2162;2;0;ITF;ITF4;16;Puglia;41.12559576;16.86736689;1381;159;1540;53075;54615;68;1023;57555;2986;115156;1240449;733323
2021-01-23;ABR;265;116;149;51;208;6;0;ITF;ITF1;13;Abruzzo;42.35122196;13.39843823;427;41;468;9943;10411;-88;221;28768;1385;40564;623624;319988
2021-01-23;BAS;764;326;438;33;731;0;0;ITF;ITF5;17;Basilicata;40.63947052;15.80514834;89;4;93;6833;6926;-43;59;5560;308;12794;205632;126867
2021-01-23;UMB;280;100;180;2;278;0;0;ITI;ITI2;10;Umbria;43.10675841;12.38824698;292;46;338;4691;5029;149;332;28061;732;33822;578498;273719
2021-01-24;ABR;50;22;28;6;44;0;0;ITF;ITF1;13;Abruzzo;42.35122196;13.39843823;430;44;474;10180;10654;243;325;28842;1393;40889;636872;327969
2021-01-24;PAB;12;10;2;0;12;0;0;ITH;ITH1;4;Provincia Autonoma Bolzano / Bozen;46.49933453;11.35662422;226;25;251;13248;13499;113;412;22261;841;36601;450531;175268
2021-01-24;BAS;869;317;552;58;810;1;0;ITF;ITF5;17;Basilicata;40.63947052;15.80514834;81;4;85;6815;6900;-26;48;5631;311;12842;206206;127137
2021-01-24;LIG;762;242;520;116;646;0;0;ITC;ITC3;7;Liguria;44.41149315;8.9326992;603;64;667;3945;4612;42;293;59846;3235;67693;816993;360670
2021-01-24;LOM;1202;458;744;538;664;0;0;ITC;ITC4;3;Lombardia;45.46679409;9.190347404;3428;405;3833;49171;53004;536;1375;445604;26666;525274;5437998;2780425
2021-01-24;EMR;2446;887;1559;298;2148;0;0;ITH;ITH5;8;Emilia-Romagna;44.49436681;11.341720800000001;2383;219;2602;48755;51357;625;1208;149966;9119;210442;2954788;1327963
2021-01-24;SAR;91;35;56;5;86;0;0;ITG;ITG2;20;Sardegna;39.21531192;9.110616306;464;45;509;16589;17098;75;175;19004;949;37051;552759;460190
2021-01-24;CAM;4123;2120;2003;361;3745;17;0;ITF;ITF3;15;Campania;40.83956555;14.25084984;1448;112;1560;61425;62985;532;1069;147439;3598;214022;2331532;1552374
2021-01-24;CAL;47;20;27;41;6;0;0;ITF;ITF6;18;Calabria;38.90597598;16.59440194;279;21;300;10105;10405;65;211;20101;566;31072;499701;474508
2021-01-24;SIC;4340;2270;2070;121;4217;2;0;ITG;ITG1;19;Sicilia;38.11569725;13.362356699999998;1431;227;1658;45996;47654;27;875;78872;3226;129752;1604479;945261
2021-01-24;VEN;4117;1219;2898;28;4089;0;0;ITH;ITH3;5;Veneto;45.43490485;12.33845213;1796;286;2082;43624;45706;-1835;956;251408;8559;305673;3902742;1303992
2021-01-24;MAR;881;339;542;3;878;0;0;ITI;ITI3;11;Marche;43.61675973;13.5188753;546;74;620;8205;8825;414;525;42204;1874;52903;671124;395675
2021-01-24;UMB;258;106;152;1;257;0;0;ITI;ITI2;10;Umbria;43.10675841;12.38824698;291;47;338;4774;5112;83;247;28217;740;34069;585272;274887
2021-01-24;LAZ;5706;2233;3473;620;5086;0;0;ITI;ITI4;12;Lazio;41.89277044;12.48366722;2544;286;2830;66555;69385;-881;1056;123626;4682;197693;3151772;2265463
2021-01-24;TOS;3349;1072;2277;196;3150;3;0;ITI;ITI1;9;Toscana;43.76923077;11.25588885;636;106;742;7675;8417;156;526;118347;4095;130859;2136472;1151428
2021-01-24;PUG;1674;754;920;151;1523;0;0;ITF;ITF4;16;Puglia;41.12559576;16.86736689;1391;164;1555;53515;55070;455;954;58040;3000;116110;1249072;734710
2021-01-24;FVG;307;121;186;2;305;0;0;ITH;ITH4;6;Friuli-Venezia Giulia;45.6494354;13.76813649;685;61;746;11010;11756;-142;505;50339;2243;64338;1093381;400117
2021-01-24;PIE;3161;964;2197;435;2724;2;0;ITC;ITC1;1;Piemonte;45.0732745;7.680687483;2345;156;2501;10845;13346;-109;619;195748;8583;217677;1943147;1064696
2021-01-24;PAT;562;285;277;226;336;0;0;ITH;ITH2;4;Provincia Autonoma Trento;46.06893511;11.12123097;207;43;250;1858;2108;61;131;22978;1131;26217;508616;159760
2021-01-25;CAL;1090;522;568;150;940;0;0;ITF;ITF6;18;Calabria;38.90597598;16.59440194;278;22;300;9803;10103;-302;207;20604;572;31279;501278;475339
2021-01-25;SIC;7460;3693;3767;265;7188;7;0;ITG;ITG1;19;Sicilia;38.11569725;13.362356699999998;1439;227;1666;46335;48001;347;885;79376;3260;130637;1625287;950469
2021-01-25;CAM;5760;2929;2831;174;5586;0;0;ITF;ITF3;15;Campania;40.83956555;14.25084984;1455;105;1560;61513;63073;88;754;148085;3618;214776;2339916;1555995
2021-01-25;UMB;649;322;327;5;644;0;0;ITI;ITI2;10;Umbria;43.10675841;12.38824698;300;47;347;4685;5032;-80;66;28357;746;34135;586990;275060
2021-01-25;EMR;6467;2149;4318;205;6261;1;0;ITH;ITH5;8;Emilia-Romagna;44.49436681;11.341720800000001;2422;222;2644;48645;51289;-68;1164;151122;9195;211606;2965224;1331075
2021-01-25;FVG;1595;571;1024;200;1395;0;0;ITH;ITH4;6;Friuli-Venezia Giulia;45.6494354;13.76813649;686;62;748;10825;11573;-183;181;50680;2266;64519;1095819;401023
2021-01-25;LAZ;8179;3291;4888;834;7345;0;0;ITI;ITI4;12;Lazio;41.89277044;12.48366722;2560;287;2847;64814;67661;-1724;874;126184;4722;198567;3172399;2276268
2021-01-25;TOS;5135;1895;3240;242;4889;4;0;ITI;ITI1;9;Toscana;43.76923077;11.25588885;661;109;770;7690;8460;43;422;118712;4109;131281;2143394;1154572
2021-01-25;LIG;2735;894;1841;474;2260;1;0;ITC;ITC3;7;Liguria;44.41149315;8.9326992;622;67;689;3849;4538;-74;164;60078;3241;67857;819985;361787
2021-01-25;PAT;849;231;618;25;824;0;0;ITH;ITH2;4;Provincia Autonoma Trento;46.06893511;11.12123097;215;41;256;1812;2068;-40;32;23047;1134;26249;509231;159870
2021-01-25;PIE;6233;1947;4286;977;5254;2;0;ITC;ITC1;1;Piemonte;45.0732745;7.680687483;2364;163;2527;10691;13218;-128;600;196455;8604;218277;1953460;1067631
2021-01-25;VEN;6471;2077;4394;156;6315;0;0;ITH;ITH3;5;Veneto;45.43490485;12.33845213;1761;284;2045;42474;44519;-1187;533;253085;8602;306206;3918296;1305406
2021-01-25;PUG;3838;1685;2153;425;3412;1;0;ITF;ITF4;16;Puglia;41.12559576;16.86736689;1380;169;1549;52833;54382;-688;401;59097;3032;116511;1253021;736815
2021-01-25;PAB;494;188;306;3;491;0;0;ITH;ITH1;4;Provincia Autonoma Bolzano / Bozen;46.49933453;11.35662422;239;28;267;13308;13575;76;200;22381;845;36801;453200;175619
2021-01-25;MAR;1597;559;1038;90;1507;0;0;ITI;ITI3;11;Marche;43.61675973;13.5188753;549;73;622;8042;8664;-161;200;42556;1883;53103;659081;397537
2021-01-25;VDA;150;67;83;1;149;0;0;ITC;ITC2;2;Valle d'Aosta / Vallée d'Aoste;45.73750286;7.320149366;43;2;45;282;327;-4;5;6993;400;7720;68148;40839
2021-01-25;MOL;319;130;189;3;316;0;0;ITF;ITF2;14;Molise;41.55774754;14.65916051;50;8;58;990;1048;-3;48;6501;248;7797;131057;119012
2021-01-25;SAR;612;228;384;23;589;0;0;ITG;ITG2;20;Sardegna;39.21531192;9.110616306;472;48;520;16483;17003;-95;207;19303;952;37258;555999;461960
2021-01-25;LOM;7132;2401;4731;515;6614;3;0;ITC;ITC4;3;Lombardia;45.46679409;9.190347404;3412;407;3819;46158;49977;-3027;1484;450069;26712;526758;5456775;2786712
2021-01-25;BAS;1054;441;613;74;979;1;0;ITF;ITF5;17;Basilicata;40.63947052;15.80514834;86;6;92;6836;6928;28;71;5670;315;12913;206761;127375
2021-01-25;ABR;1605;633;972;10;1593;2;0;ITF;ITF1;13;Abruzzo;42.35122196;13.39843823;426;44;470;9726;10196;-458;69;29341;1418;40955;643557;332337
2021-01-26;MAR;2021;747;1274;69;1943;9;0;ITI;ITI3;11;Marche;43.61675973;13.5188753;545;73;618;8130;8748;84;291;42752;1894;53394;663699;400077
2021-01-26;MOL;450;184;266;8;442;0;0;ITF;ITF2;14;Molise;41.55774754;14.65916051;50;9;59;1023;1082;34;102;6568;249;7899;132219;119999
2021-01-26;PAB;810;291;519;1;809;0;0;ITH;ITH1;4;Provincia Autonoma Bolzano / Bozen;46.49933453;11.35662422;225;30;255;13751;14006;431;559;22501;853;37360;461251;175974
2021-01-26;PUG;5383;2410;2973;563;4819;1;0;ITF;ITF4;16;Puglia;41.12559576;16.86736689;1403;180;1583;52132;53715;-667;995;60729;3062;117506;1264811;742039
2021-01-26;VDA;149;52;97;2;147;0;0;ITC;ITC2;2;Valle d'Aosta / Vallée d'Aoste;45.73750286;7.320149366;45;2;47;256;303;-24;17;7033;401;7737;68359;40912
2021-01-26;UMB;816;390;426;17;799;0;0;ITI;ITI2;10;Umbria;43.10675841;12.38824698;334;50;384;4785;5169;137;275;28490;751;34410;594911;276525
2021-01-26;ABR;1550;568;982;31;1519;0;0;ITF;ITF1;13;Abruzzo;42.35122196;13.39843823;415;42;457;9590;10047;-149;152;29625;1435;41107;650534;336264
2021-01-26;BAS;813;358;455;101;712;0;0;ITF;ITF5;17;Basilicata;40.63947052;15.80514834;83;2;85;6875;6960;32;58;5692;319;12971;207487;127698
2021-01-26;EMR;8339;3001;5338;209;8129;1;0;ITH;ITH5;8;Emilia-Romagna;44.49436681;11.341720800000001;2293;220;2513;46629;49142;-2147;993;154178;9270;212590;2989865;1334176
2021-01-26;LAZ;7995;3138;4857;746;7249;0;0;ITI;ITI4;12;Lazio;41.89277044;12.48366722;2544;283;2827;63305;66132;-1529;1039;128709;4765;199606;3201852;2293073
2021-01-26;PIE;6363;1897;4466;737;5625;1;0;ITC;ITC1;1;Piemonte;45.0732745;7.680687483;2307;163;2470;10264;12734;-484;728;197629;8642;219005;1974824;1073376
2021-01-26;SIC;9583;4745;4838;211;9371;1;0;ITG;ITG1;19;Sicilia;38.11569725;13.362356699999998;1435;229;1664;45815;47479;-522;970;80832;3296;131607;1648866;956437
2021-01-26;LOM;8403;2723;5680;348;8054;1;0;ITC;ITC4;3;Lombardia;45.46679409;9.190347404;3530;392;3922;45046;48968;-1009;1230;452231;26789;527988;5480815;2791088
2021-01-26;CAL;1900;914;986;272;1627;1;0;ITF;ITF6;18;Calabria;38.90597598;16.59440194;283;19;302;9544;9846;-257;232;21088;577;31511;503800;477154
2021-01-26;VEN;6927;2093;4834;149;6778;0;0;ITH;ITH3;5;Veneto;45.43490485;12.33845213;1742;265;2007;39780;41787;-2732;746;256470;8695;306952;3959153;1308166
2021-01-26;TOS;5400;1795;3605;218;5178;4;0;ITI;ITI1;9;Toscana;43.76923077;11.25588885;682;103;785;7641;8426;-34;346;119083;4118;131627;2157178;1159951
2021-01-26;SAR;1381;474;907;27;1354;0;0;ITG;ITG2;20;Sardegna;39.21531192;9.110616306;468;44;512;16286;16798;-205;138;19643;955;37396;560342;464673
2021-01-26;LIG;2490;809;1681;16;2474;0;0;ITC;ITC3;7;Liguria;44.41149315;8.9326992;617;65;682;3735;4417;-121;271;60453;3258;68128;827341;364783
2021-01-26;CAM;7351;3733;3618;335;6995;21;0;ITF;ITF3;15;Campania;40.83956555;14.25084984;1470;101;1571;61662;63233;160;976;148876;3643;215752;2351357;1560414
2021-01-26;FVG;1980;650;1330;217;1762;1;0;ITH;ITH4;6;Friuli-Venezia Giulia;45.6494354;13.76813649;668;64;732;10758;11490;-83;421;51151;2299;64940;1104766;403830
2021-01-26;PAT;577;173;404;28;549;0;0;ITH;ITH2;4;Provincia Autonoma Trento;46.06893511;11.12123097;216;36;252;1767;2019;-49;157;23246;1141;26406;512273;160263
2021-01-27;BAS;422;179;243;113;309;0;0;ITF;ITF5;17;Basilicata;40.63947052;15.80514834;81;2;83;6867;6950;-10;74;5776;319;13045;208294;128038
2021-01-27;VDA;156;75;81;80;76;0;0;ITC;ITC2;2;Valle d'Aosta / Vallée d'Aoste;45.73750286;7.320149366;45;3;48;259;307;4;8;7037;401;7745;68511;40983
2021-01-27;FVG;1273;427;846;450;821;2;0;ITH;ITH4;6;Friuli-Venezia Giulia;45.6494354;13.76813649;646;61;707;10685;11392;-98;584;51807;2325;65524;1115834;407208
2021-01-27;EMR;8372;2951;5421;461;7911;0;0;ITH;ITH5;8;Emilia-Romagna;44.49436681;11.341720800000001;2281;210;2491;45615;48106;-1036;923;156088;9307;213501;3013616;1338043
2021-01-27;PIE;4209;1456;2753;995;3212;2;0;ITC;ITC1;1;Piemonte;45.0732745;7.680687483;2280;163;2443;9958;12401;-333;821;198732;8693;219826;1995478;1078695
2021-01-27;VEN;7150;2069;5081;240;6909;1;0;ITH;ITH3;5;Veneto;45.43490485;12.33845213;1700;258;1958;39387;41345;-442;2385;259235;8757;309337;4002008;1312345
2021-01-27;PAT;873;310;563;115;756;2;0;ITH;ITH2;4;Provincia Autonoma Trento;46.06893511;11.12123097;201;35;236;1832;2068;49;242;23437;1143;26648;515843;160542
2021-01-27;LOM;8074;2689;5385;806;7266;2;0;ITC;ITC4;3;Lombardia;45.46679409;9.190347404;3573;377;3950;45088;49038;70;2293;454392;26851;530281;5525624;2800749
2021-01-27;SIC;7297;3714;3583;164;7132;1;0;ITG;ITG1;19;Sicilia;38.11569725;13.362356699999998;1421;232;1653;45377;47030;-449;996;82239;3334;132603;1678136;962946
2021-01-27;UMB;842;330;512;13;829;0;0;ITI;ITI2;10;Umbria;43.10675841;12.38824698;334;50;384;4745;5129;-40;415;28940;756;34825;602935;278327
2021-01-27;CAM;7755;3824;3931;168;7582;5;0;ITF;ITF3;15;Campania;40.83956555;14.25084984;1447;107;1554;61441;62995;-238;1178;150266;3669;216930;2367290;1570291
2021-01-27;MOL;676;251;425;8;668;0;0;ITF;ITF2;14;Molise;41.55774754;14.65916051;52;7;59;1004;1063;-19;40;6622;254;7939;132782;120496
2021-01-27;SAR;1436;506;930;78;1358;0;0;ITG;ITG2;20;Sardegna;39.21531192;9.110616306;471;43;514;16034;16548;-250;251;20137;962;37647;564745;467775
2021-01-27;CAL;1491;757;734;383;1107;1;0;ITF;ITF6;18;Calabria;38.90597598;16.59440194;274;22;296;9077;9373;-473;263;21823;578;31774;506929;479987
2021-01-27;TOS;4836;1574;3262;199;4632;5;0;ITI;ITI1;9;Toscana;43.76923077;11.25588885;676;103;779;7626;8405;-21;502;119594;4130;132129;2174158;1166853
2021-01-27;MAR;2119;778;1341;113;2004;2;0;ITI;ITI3;11;Marche;43.61675973;13.5188753;554;72;626;8360;8986;238;466;42965;1909;53860;669151;403378
2021-01-27;LAZ;6203;2422;3781;1074;5129;0;0;ITI;ITI4;12;Lazio;41.89277044;12.48366722;2508;283;2791;62112;64903;-1229;1338;131214;4827;200944;3230142;2308819
2021-01-27;LIG;1750;604;1146;140;1609;1;0;ITC;ITC3;7;Liguria;44.41149315;8.9326992;591;68;659;3586;4245;-172;268;60873;3278;68396;834479;367463
2021-01-27;PUG;4608;1946;2662;617;3991;0;0;ITF;ITF4;16;Puglia;41.12559576;16.86736689;1410;182;1592;51851;53443;-272;1233;62204;3092;118739;1276613;746197
2021-01-27;PAB;85;29;56;2;83;0;0;ITH;ITH1;4;Provincia Autonoma Bolzano / Bozen;46.49933453;11.35662422;217;32;249;13995;14244;238;548;22809;855;37908;469487;176748
2021-01-27;ABR;1367;515;852;32;1335;0;0;ITF;ITF1;13;Abruzzo;42.35122196;13.39843823;402;40;442;9634;10076;29;344;29933;1441;41450;656886;338909
2021-01-28;PAT;554;156;398;51;503;0;0;ITH;ITH2;4;Provincia Autonoma Trento;46.06893511;11.12123097;191;34;225;1938;2163;95;207;23549;1143;26855;519585;160847
2021-01-28;TOS;6290;1885;4405;350;5933;7;0;ITI;ITI1;9;Toscana;43.76923077;11.25588885;672;100;772;7902;8674;269;620;119929;4146;132749;2190275;1173906
2021-01-28;VEN;9217;2667;6550;169;9046;2;0;ITH;ITH3;5;Veneto;45.43490485;12.33845213;1599;249;1848;37116;38964;-2381;572;262136;8809;309909;4034670;1315090
2021-01-28;LIG;2851;972;1879;37;2814;0;0;ITC;ITC3;7;Liguria;44.41149315;8.9326992;588;67;655;3591;4246;1;372;61222;3300;68768;841787;370398
2021-01-28;LOM;12287;3725;8562;797;11484;6;0;ITC;ITC4;3;Lombardia;45.46679409;9.190347404;3537;371;3908;45931;49839;801;2603;456106;26939;532884;5567301;2811665
2021-01-28;BAS;922;409;513;119;803;0;0;ITF;ITF5;17;Basilicata;40.63947052;15.80514834;74;2;76;6851;6927;-23;42;5840;320;13087;208991;128348
2021-01-28;MAR;2091;726;1365;158;1932;1;0;ITI;ITI3;11;Marche;43.61675973;13.5188753;551;70;621;8406;9027;41;429;43336;1926;54289;674037;406210
2021-01-28;ABR;1435;495;940;11;1424;0;0;ITF;ITF1;13;Abruzzo;42.35122196;13.39843823;399;40;439;9627;10066;-10;268;30206;1446;41718;663071;341654
2021-01-28;CAL;2301;1145;1156;78;2223;0;0;ITF;ITF6;18;Calabria;38.90597598;16.59440194;273;21;294;8784;9078;-295;302;22416;582;32076;509764;482810
2021-01-28;SAR;3039;1084;1955;68;2971;0;0;ITG;ITG2;20;Sardegna;39.21531192;9.110616306;465;43;508;15845;16353;-195;237;20562;969;37884;569235;470492
2021-01-28;MOL;617;218;399;19;598;0;0;ITF;ITF2;14;Molise;41.55774754;14.65916051;51;7;58;961;1019;-44;14;6675;259;7953;133300;120908
2021-01-28;PUG;5491;2286;3205;441;5050;0;0;ITF;ITF4;16;Puglia;41.12559576;16.86736689;1394;173;1567;50781;52348;-1095;1159;64424;3126;119898;1286025;749986
2021-01-28;PAB;872;309;563;9;863;0;0;ITH;ITH1;4;Provincia Autonoma Bolzano / Bozen;46.49933453;11.35662422;216;30;246;14294;14540;296;562;23071;859;38470;477254;177465
2021-01-28;CAM;8851;4130;4721;140;8703;8;0;ITF;ITF3;15;Campania;40.83956555;14.25084984;1474;98;1572;62017;63589;594;1313;150950;3704;218243;2383402;1582293
2021-01-28;LAZ;8349;3193;5156;842;7506;1;0;ITI;ITI4;12;Lazio;41.89277044;12.48366722;2458;289;2747;61895;64642;-261;1263;132695;4870;202207;3261068;2328322
2021-01-28;UMB;1248;394;854;18;1230;0;0;ITI;ITI2;10;Umbria;43.10675841;12.38824698;338;54;392;4911;5303;174;369;29131;760;35194;609165;279578
2021-01-28;FVG;2252;799;1453;356;1896;0;0;ITH;ITH4;6;Friuli-Venezia Giulia;45.6494354;13.76813649;619;59;678;10682;11360;-32;642;52460;2346;66166;1124994;409877
2021-01-28;PIE;5616;1818;3798;380;5236;0;0;ITC;ITC1;1;Piemonte;45.0732745;7.680687483;2194;151;2345;10139;12484;83;1062;199668;8736;220888;2017653;1085343
2021-01-28;EMR;10264;3344;6920;348;9916;0;0;ITH;ITH5;8;Emilia-Romagna;44.49436681;11.341720800000001;2242;209;2451;45088;47539;-567;1265;157852;9363;214754;3042797;1345403
2021-01-28;SIC;9037;4277;4760;360;8676;1;0;ITG;ITG1;19;Sicilia;38.11569725;13.362356699999998;1405;215;1620;44556;46176;-854;994;84050;3371;133597;1700897;969503
2021-01-28;VDA;294;124;170;55;239;0;0;ITC;ITC2;2;Valle d'Aosta / Vallée d'Aoste;45.73750286;7.320149366;44;4;48;234;282;-25;2;7064;401;7747;68828;41086
2021-01-29;VDA;321;139;182;2;319;0;0;ITC;ITC2;2;Valle d'Aosta / Vallée d'Aoste;45.73750286;7.320149366;43;4;47;223;270;-12;17;7092;402;7764;69112;41176
2021-01-29;ABR;1387;449;938;71;1315;1;0;ITF;ITF1;13;Abruzzo;42.35122196;13.39843823;389;40;429;9639;10068;2;343;30538;1453;42059;668154;343754
2021-01-29;EMR;10428;3501;6927;290;10138;0;0;ITH;ITH5;8;Emilia-Romagna;44.49436681;11.341720800000001;2172;209;2381;44964;47345;-194;1320;159293;9427;216065;3066158;1349723
2021-01-29;LAZ;8464;3224;5240;973;7489;2;0;ITI;ITI4;12;Lazio;41.89277044;12.48366722;2438;289;2727;61510;64237;-405;1160;134212;4918;203367;3288432;2345323
2021-01-29;BAS;619;233;386;63;556;0;0;ITF;ITF5;17;Basilicata;40.63947052;15.80514834;71;4;75;6061;6136;-791;45;6673;323;13132;210043;128896
2021-01-29;SAR;3046;1119;1927;45;2999;2;0;ITG;ITG2;20;Sardegna;39.21531192;9.110616306;453;40;493;15594;16087;-266;257;21078;976;38141;574708;473288
2021-01-29;LOM;13556;4151;9405;687;12866;3;0;ITC;ITC4;3;Lombardia;45.46679409;9.190347404;3490;379;3869;45645;49514;-325;1900;458254;27016;534784;5601457;2820413
2021-01-29;CAM;10086;4822;5264;67;10015;4;0;ITF;ITF3;15;Campania;40.83956555;14.25084984;1425;95;1520;60122;61642;-1947;1175;154051;3725;219418;2397782;1588421
2021-01-29;CAL;2083;1007;1076;226;1856;1;0;ITF;ITF6;18;Calabria;38.90597598;16.59440194;274;20;294;8735;9029;-49;253;22715;585;32329;512266;484853
2021-01-29;FVG;2425;817;1608;269;2156;0;0;ITH;ITH4;6;Friuli-Venezia Giulia;45.6494354;13.76813649;605;59;664;10707;11371;11;557;52988;2364;66723;1134427;412664
2021-01-29;PIE;5963;1894;4069;454;5509;0;0;ITC;ITC1;1;Piemonte;45.0732745;7.680687483;2163;150;2313;10224;12537;53;944;200521;8774;221832;2040494;1090338
2021-01-29;LIG;3102;1071;2031;64;3038;0;0;ITC;ITC3;7;Liguria;44.41149315;8.9326992;591;64;655;3650;4305;59;338;61476;3325;69106;849066;373287
2021-01-29;PUG;6219;2674;3545;219;6000;0;0;ITF;ITF4;16;Puglia;41.12559576;16.86736689;1401;168;1569;50709;52278;-70;1069;65539;3150;120967;1294800;754947
2021-01-29;TOS;6150;1702;4448;290;5848;12;0;ITI;ITI1;9;Toscana;43.76923077;11.25588885;659;100;759;8243;9002;328;594;120169;4172;133343;2207275;1181251
2021-01-29;MAR;1994;731;1263;154;1835;5;0;ITI;ITI3;11;Marche;43.61675973;13.5188753;540;73;613;8394;9007;-20;371;43714;1939;54660;678817;409342
2021-01-29;MOL;425;137;288;6;419;0;0;ITF;ITF2;14;Molise;41.55774754;14.65916051;51;8;59;963;1022;3;63;6733;261;8016;134263;121741
2021-01-29;PAT;1428;365;1063;56;1372;0;0;ITH;ITH2;4;Provincia Autonoma Trento;46.06893511;11.12123097;187;34;221;2150;2371;208;307;23647;1144;27162;523153;161081
2021-01-29;PAB;1515;518;997;24;1491;0;0;ITH;ITH1;4;Provincia Autonoma Bolzano / Bozen;46.49933453;11.35662422;219;30;249;14613;14862;322;590;23336;862;39060;484791;178089
2021-01-29;VEN;9030;2790;6240;365;8665;0;0;ITH;ITH3;5;Veneto;45.43490485;12.33845213;1509;240;1749;35216;36965;-1999;985;265067;8862;310894;4075490;1317694
2021-01-29;UMB;1240;350;890;79;1161;0;0;ITI;ITI2;10;Umbria;43.10675841;12.38824698;349;53;402;5075;5477;174;335;29285;767;35529;616083;280987
2021-01-29;SIC;9186;4257;4929;403;8771;12;0;ITG;ITG1;19;Sicilia;38.11569725;13.362356699999998;1373;211;1584;42683;44267;-1909;944;86866;3408;134541;1726358;975217
2021-01-30;PIE;6009;2149;3860;218;5790;1;0;ITC;ITC1;1;Piemonte;45.0732745;7.680687483;2127;150;2277;10105;12382;-155;727;201344;8833;222559;2063546;1095712
2021-01-30;FVG;2286;746;1540;271;2015;0;0;ITH;ITH4;6;Friuli-Venezia Giulia;45.6494354;13.76813649;596;57;653;10641;11294;-77;415;53466;2378;67138;1142473;415009
2021-01-30;EMR;10097;3528;6569;137;9959;1;0;ITH;ITH5;8;Emilia-Romagna;44.49436681;11.341720800000001;2124;203;2327;44032;46359;-986;1314;161564;9454;217377;3090178;1354289
2021-01-30;CAM;10733;5083;5650;43;10688;2;0;ITF;ITF3;15;Campania;40.83956555;14.25084984;1435;92;1527;60129;61656;14;1366;155381;3747;220784;2415127;1598390
2021-01-30;SIC;7735;3557;4178;139;7593;3;0;ITG;ITG1;19;Sicilia;38.11569725;13.362356699999998;1345;208;1553;41315;42868;-1399;846;89076;3443;135387;1751609;980665
2021-01-30;UMB;1575;486;1089;43;1532;0;0;ITI;ITI2;10;Umbria;43.10675841;12.38824698;346;55;401;5110;5511;34;228;29474;772;35757;623158;282438
2021-01-30;SAR;3946;1425;2521;367;3579;0;0;ITG;ITG2;20;Sardegna;39.21531192;9.110616306;450;39;489;15462;15951;-136;229;21438;981;38370;578012;475909
2021-01-30;PAT;396;136;260;155;241;0;0;ITH;ITH2;4;Provincia Autonoma Trento;46.06893511;11.12123097;173;35;208;2257;2465;94;230;23781;1146;27392;526484;161358
2021-01-30;CAL;2213;1173;1040;294;1916;3;0;ITF;ITF6;18;Calabria;38.90597598;16.59440194;272;18;290;8605;8895;-134;225;23071;588;32554;515406;487876
2021-01-30;LOM;12361;4587;7774;146;12206;9;0;ITC;ITC4;3;Lombardia;45.46679409;9.190347404;3454;377;3831;46310;50141;627;1832;459401;27074;536616;5640919;2829643
2021-01-30;VEN;8769;2684;6085;689;8080;0;0;ITH;ITH3;5;Veneto;45.43490485;12.33845213;1438;222;1660;33017;34677;-2288;792;268087;8922;311686;4132597;1320747
2021-01-30;TOS;4627;1623;3004;173;4436;18;0;ITI;ITI1;9;Toscana;43.76923077;11.25588885;648;95;743;8340;9083;81;603;120669;4194;133946;2223132;1188245
2021-01-30;LAZ;7028;2898;4130;817;6210;1;0;ITI;ITI4;12;Lazio;41.89277044;12.48366722;2407;282;2689;61106;63795;-442;1138;135765;4945;204505;3318818;2364920
2021-01-30;LIG;1666;572;1094;22;1643;1;0;ITC;ITC3;7;Liguria;44.41149315;8.9326992;588;62;650;3745;4395;90;255;61625;3341;69361;855992;375966
2021-01-30;PUG;5547;2516;3031;380;5166;1;0;ITF;ITF4;16;Puglia;41.12559576;16.86736689;1389;163;1552;50605;52157;-121;871;66502;3179;121838;1304490;759030
2021-01-30;MAR;1906;669;1237;24;1882;0;0;ITI;ITI3;11;Marche;43.61675973;13.5188753;542;71;613;8547;9160;153;465;44010;1955;55125;685976;412859
2021-01-30;PAB;499;246;253;4;495;0;0;ITH;ITH1;4;Provincia Autonoma Bolzano / Bozen;46.49933453;11.35662422;216;32;248;15083;15331;469;640;23500;869;39700;492413;178834
2021-01-30;VDA;440;203;237;12;426;2;0;ITC;ITC2;2;Valle d'Aosta / Vallée d'Aoste;45.73750286;7.320149366;41;4;45;218;263;-7;8;7106;403;7772;69450;41273
2021-01-30;ABR;1515;570;945;62;1452;1;0;ITF;ITF1;13;Abruzzo;42.35122196;13.39843823;389;43;432;9685;10117;49;385;30865;1462;42444;675378;346911
2021-01-30;BAS;713;230;483;129;584;0;0;ITF;ITF5;17;Basilicata;40.63947052;15.80514834;70;2;72;5680;5752;-384;70;7125;325;13202;210951;129285
2021-01-30;MOL;465;161;304;12;453;0;0;ITF;ITF2;14;Molise;41.55774754;14.65916051;48;9;57;979;1036;14;83;6800;263;8099;135181;122522
2021-01-31;PUG;1828;835;993;73;1755;0;0;ITF;ITF4;16;Puglia;41.12559576;16.86736689;1397;164;1561;51183;52744;587;1069;66971;3192;122907;1312676;760108
2021-01-31;MOL;268;70;198;6;262;0;0;ITF;ITF2;14;Molise;41.55774754;14.65916051;53;8;61;1010;1071;35;79;6842;265;8178;136002;123261
2021-01-31;MAR;1921;772;1149;93;1824;4;0;ITI;ITI3;11;Marche;43.61675973;13.5188753;529;72;601;8657;9258;98;362;44263;1966;55487;690203;415370
2021-01-31;LAZ;4468;1859;2609;481;3987;0;0;ITI;ITI4;12;Lazio;41.89277044;12.48366722;2388;284;2672;60529;63201;-594;943;137263;4984;205448;3342016;2380303
2021-01-31;SIC;4061;1943;2118;107;3952;2;0;ITG;ITG1;19;Sicilia;38.11569725;13.362356699999998;1325;204;1529;40760;42289;-579;716;90336;3478;136103;1784459;985615
2021-01-31;VDA;291;91;200;58;233;0;0;ITC;ITC2;2;Valle d'Aosta / Vallée d'Aoste;45.73750286;7.320149366;36;4;40;213;253;-10;8;7124;403;7780;69596;41328
2021-01-31;CAL;1132;564;568;148;984;0;0;ITF;ITF6;18;Calabria;38.90597598;16.59440194;276;20;296;8613;8909;14;193;23246;592;32747;518350;490510
2021-01-31;CAM;8069;3712;4357;21;8047;1;0;ITF;ITF3;15;Campania;40.83956555;14.25084984;1417;99;1516;60906;62422;766;1401;156006;3757;222185;2432221;1610642
2021-01-31;BAS;78;24;54;0;78;0;0;ITF;ITF5;17;Basilicata;40.63947052;15.80514834;66;2;68;5356;5424;-328;29;7481;326;13231;211624;129584
2021-01-31;ABR;1523;495;1028;285;1237;1;0;ITF;ITF1;13;Abruzzo;42.35122196;13.39843823;383;46;429;10058;10487;370;402;30892;1467;42846;690016;356214
2021-01-31;EMR;7710;2771;4939;240;7470;0;0;ITH;ITH5;8;Emilia-Romagna;44.49436681;11.341720800000001;2112;206;2318;44550;46868;509;1277;162307;9476;218651;3103697;1357767
2021-01-31;VEN;4788;1565;3223;407;4381;0;0;ITH;ITH3;5;Veneto;45.43490485;12.33845213;1430;217;1647;32298;33945;-732;499;269309;8931;312185;4153641;1323060
2021-01-31;TOS;3052;1131;1921;100;2949;3;0;ITI;ITI1;9;Toscana;43.76923077;11.25588885;648;96;744;8431;9175;92;510;121079;4202;134456;2237018;1195439
2021-01-31;LIG;625;271;354;4;621;0;0;ITC;ITC3;7;Liguria;44.41149315;8.9326992;612;65;677;3759;4436;41;307;61880;3352;69668;862130;377791
2021-01-31;SAR;2155;766;1389;45;2110;0;0;ITG;ITG2;20;Sardegna;39.21531192;9.110616306;446;39;485;15495;15980;29;167;21575;982;38537;580215;477746
2021-01-31;LOM;9828;3815;6013;29;9799;0;0;ITC;ITC4;3;Lombardia;45.46679409;9.190347404;3503;362;3865;47212;51077;936;1438;459879;27098;538054;5665413;2837007
2021-01-31;UMB;1061;276;785;25;1036;0;0;ITI;ITI2;10;Umbria;43.10675841;12.38824698;361;54;415;5214;5629;118;294;29641;781;36051;629140;283677
2021-01-31;FVG;2729;842;1887;386;2343;0;0;ITH;ITH4;6;Friuli-Venezia Giulia;45.6494354;13.76813649;590;60;650;10683;11333;39;396;53807;2394;67534;1146864;416815
2021-01-31;PIE;4156;1769;2387;114;4042;0;0;ITC;ITC1;1;Piemonte;45.0732745;7.680687483;2122;146;2268;10044;12312;-70;538;201938;8847;223097;2072804;1099174
2021-01-31;PAT;77;16;61;1;76;0;0;ITH;ITH2;4;Provincia Autonoma Trento;46.06893511;11.12123097;178;35;213;2256;2469;4;135;23911;1147;27527;528986;161655
2021-02-01;LAZ;5688;2187;3501;352;5335;1;0;ITI;ITI4;12;Lazio;41.89277044;12.48366722;2373;288;2661;58829;61490;-1711;717;139653;5022;206165;3355115;2387784
2021-02-01;EMR;10332;3618;6714;354;9976;2;0;ITH;ITH5;8;Emilia-Romagna;44.49436681;11.341720800000001;2181;207;2388;44219;46607;-261;1051;163585;9510;219702;3113966;1360212
2021-02-01;CAL;2561;1214;1347;237;2321;3;0;ITF;ITF6;18;Calabria;38.90597598;16.59440194;276;21;297;8382;8679;-230;195;23667;596;32942;520326;492399
2021-02-01;UMB;1285;342;943;48;1237;0;0;ITI;ITI2;10;Umbria;43.10675841;12.38824698;363;58;421;5222;5643;14;143;29762;789;36194;630341;283870
2021-02-01;FVG;2108;691;1417;17;2091;0;0;ITH;ITH4;6;Friuli-Venezia Giulia;45.6494354;13.76813649;593;61;654;10655;11309;-24;129;53936;2418;67663;1148761;417547
2021-02-01;SAR;1555;620;935;226;1329;0;0;ITG;ITG2;20;Sardegna;39.21531192;9.110616306;439;39;478;15078;15556;-424;123;22118;986;38660;582290;478843
2021-02-01;PIE;8702;3073;5629;580;8121;1;0;ITC;ITC1;1;Piemonte;45.0732745;7.680687483;2151;153;2304;9960;12264;-48;514;202489;8858;223611;2083854;1101742
2021-02-01;PAT;1278;356;922;98;1180;0;0;ITH;ITH2;4;Provincia Autonoma Trento;46.06893511;11.12123097;180;35;215;2288;2503;34;53;23930;1147;27580;529694;161795
2021-02-01;PUG;3981;1668;2313;352;3628;1;0;ITF;ITF4;16;Puglia;41.12559576;16.86736689;1411;171;1582;50502;52084;-660;379;67974;3228;123286;1316798;762384
2021-02-01;SIC;5956;2642;3314;291;5651;14;0;ITG;ITG1;19;Sicilia;38.11569725;13.362356699999998;1336;204;1540;40662;42202;-87;766;91159;3508;136869;1817208;989907
2021-02-01;VEN;8564;2502;6062;157;8407;0;0;ITH;ITH3;5;Veneto;45.43490485;12.33845213;1410;214;1624;32196;33820;-125;510;269905;8970;312695;4165203;1324579
2021-02-01;PAB;1467;448;1019;13;1453;1;0;ITH;ITH1;4;Provincia Autonoma Bolzano / Bozen;46.49933453;11.35662422;223;32;255;4363;4618;-10713;467;34676;873;40167;497235;180213
2021-02-01;TOS;5524;1962;3562;520;4994;10;0;ITI;ITI1;9;Toscana;43.76923077;11.25588885;656;101;757;8525;9282;107;373;121330;4217;134829;2244425;1199293
2021-02-01;BAS;248;94;154;46;202;0;0;ITF;ITF5;17;Basilicata;40.63947052;15.80514834;71;2;73;4881;4954;-470;13;7964;326;13244;211889;129725
2021-02-01;VDA;409;128;281;86;320;3;0;ITC;ITC2;2;Valle d'Aosta / Vallée d'Aoste;45.73750286;7.320149366;35;4;39;209;248;-5;1;7129;404;7781;69831;41402
2021-02-01;MOL;563;201;362;14;549;0;0;ITF;ITF2;14;Molise;41.55774754;14.65916051;54;8;62;1053;1115;44;83;6879;267;8261;136872;124044
2021-02-01;LIG;2575;929;1646;101;2474;0;0;ITC;ITC3;7;Liguria;44.41149315;8.9326992;631;65;696;3870;4566;130;149;61892;3359;69817;864254;378515
2021-02-01;LOM;16139;5346;10793;307;15830;2;0;ITC;ITC4;3;Lombardia;45.46679409;9.190347404;3489;371;3860;44615;48475;-2602;1093;463522;27150;539147;5682564;2842721
2021-02-01;CAM;3988;1814;2174;104;3876;8;0;ITF;ITF3;15;Campania;40.83956555;14.25084984;1437;97;1534;60799;62333;-89;994;157081;3765;223179;2440638;1614098
2021-02-01;MAR;1362;479;883;93;1266;3;0;ITI;ITI3;11;Marche;43.61675973;13.5188753;535;72;607;8565;9172;-86;189;44526;1978;55676;691642;416358
2021-02-01;ABR;1633;574;1059;268;1364;1;0;ITF;ITF1;13;Abruzzo;42.35122196;13.39843823;401;47;448;9988;10436;-51;161;31101;1470;43007;700984;363861
2021-02-02;LIG;2675;1007;1668;127;2546;2;0;ITC;ITC3;7;Liguria;44.41149315;8.9326992;630;64;694;3691;4385;-181;238;62299;3371;70055;869782;380164
2021-02-02;MAR;1193;398;795;70;1123;0;0;ITI;ITI3;11;Marche;43.61675973;13.5188753;544;68;612;8069;8681;-491;333;45342;1986;56009;697600;420206
2021-02-02;ABR;1764;668;1096;217;1543;4;0;ITF;ITF1;13;Abruzzo;42.35122196;13.39843823;414;44;458;9604;10062;-374;210;31674;1478;43214;708915;367003
2021-02-02;BAS;370;145;225;175;194;1;0;ITF;ITF5;17;Basilicata;40.63947052;15.80514834;72;2;74;3787;3861;-1093;55;9112;326;13299;213710;130241
2021-02-02;MOL;540;176;364;216;323;1;0;ITF;ITF2;14;Molise;41.55774754;14.65916051;58;9;67;1092;1159;44;93;6928;267;8354;137879;124927
2021-02-02;CAM;5751;2821;2930;432;5288;31;0;ITF;ITF3;15;Campania;40.83956555;14.25084984;1480;103;1583;60276;61859;-474;919;158436;3803;224098;2451711;1621550
2021-02-02;UMB;945;272;673;32;913;0;0;ITI;ITI2;10;Umbria;43.10675841;12.38824698;369;61;430;5342;5772;129;283;29904;801;36477;638694;285288
2021-02-02;SIC;5324;2499;2825;608;4706;10;0;ITG;ITG1;19;Sicilia;38.11569725;13.362356699999998;1327;202;1529;40084;41613;-589;984;92695;3545;137853;1839463;995922
2021-02-02;LAZ;5924;2220;3704;642;5279;3;0;ITI;ITI4;12;Lazio;41.89277044;12.48366722;2336;289;2625;58148;60773;-717;842;141160;5074;207007;3378181;2402138
2021-02-02;SAR;1534;681;853;258;1276;0;0;ITG;ITG2;20;Sardegna;39.21531192;9.110616306;430;34;464;14728;15192;-364;71;22545;994;38731;585718;481279
2021-02-02;VEN;6516;1882;4634;396;6120;0;0;ITH;ITH3;5;Veneto;45.43490485;12.33845213;1423;193;1616;30428;32044;-1776;621;272226;9046;313316;4204507;1326953
2021-02-02;LOM;20021;6653;13368;497;19521;3;0;ITC;ITC4;3;Lombardia;45.46679409;9.190347404;3544;361;3905;42654;46559;-1916;912;466287;27213;540059;5705263;2847233
2021-02-02;EMR;9499;3056;6443;534;8964;1;0;ITH;ITH5;8;Emilia-Romagna;44.49436681;11.341720800000001;2176;198;2374;42938;45312;-1295;879;165682;9581;220575;3142398;1365345
2021-02-02;TOS;3745;1477;2268;187;3551;7;0;ITI;ITI1;9;Toscana;43.76923077;11.25588885;669;109;778;8424;9202;-80;399;121800;4226;135228;2259345;1205264
2021-02-02;CAL;2376;1170;1206;176;2200;0;0;ITF;ITF6;18;Calabria;38.90597598;16.59440194;264;24;288;8326;8614;-65;166;23895;599;33108;522934;494884
2021-02-02;PIE;10292;3525;6767;814;9477;1;0;ITC;ITC1;1;Piemonte;45.0732745;7.680687483;2138;152;2290;9835;12125;-139;765;203356;8895;224376;2103721;1107431
2021-02-02;PAT;943;255;688;192;751;0;0;ITH;ITH2;4;Provincia Autonoma Trento;46.06893511;11.12123097;174;34;208;2188;2396;-107;172;24206;1150;27752;532289;162184
2021-02-02;FVG;2496;821;1675;220;2276;0;0;ITH;ITH4;6;Friuli-Venezia Giulia;45.6494354;13.76813649;579;61;640;10586;11226;-83;258;54251;2444;67921;1154752;418885
2021-02-02;PUG;4368;1859;2509;575;3792;1;0;ITF;ITF4;16;Puglia;41.12559576;16.86736689;1432;170;1602;50100;51702;-382;879;69209;3254;124165;1325499;767709
2021-02-02;VDA;287;73;214;3;284;0;0;ITC;ITC2;2;Valle d'Aosta / Vallée d'Aoste;45.73750286;7.320149366;32;3;35;198;233;-15;16;7160;404;7797;70139;41505
2021-02-02;PAB;1752;509;1243;8;1744;0;0;ITH;ITH1;4;Provincia Autonoma Bolzano / Bozen;46.49933453;11.35662422;233;34;267;4512;4779;161;316;34829;875;40483;500552;181357
2021-02-03;VDA;354;116;238;15;339;0;0;ITC;ITC2;2;Valle d'Aosta / Vallée d'Aoste;45.73750286;7.320149366;33;3;36;193;229;-4;3;7166;405;7800;70227;41528
2021-02-03;BAS;676;305;371;32;644;0;0;ITF;ITF5;17;Basilicata;40.63947052;15.80514834;70;1;71;3350;3421;-440;68;9618;328;13367;214633;130608
2021-02-03;CAL;2873;1481;1392;515;2353;5;0;ITF;ITF6;18;Calabria;38.90597598;16.59440194;253;23;276;8354;8630;16;318;24190;606;33426;526244;497810
2021-02-03;CAM;8910;4006;4904;843;8031;36;0;ITF;ITF3;15;Campania;40.83956555;14.25084984;1475;100;1575;60542;62117;258;1539;159700;3820;225637;2471140;1632795
2021-02-03;SIC;5946;2793;3153;706;5232;8;0;ITG;ITG1;19;Sicilia;38.11569725;13.362356699999998;1317;193;1510;39612;41122;-491;886;94038;3579;138739;1863593;1002162
2021-02-03;ABR;2062;717;1345;410;1644;8;0;ITF;ITF1;13;Abruzzo;42.35122196;13.39843823;427;47;474;9545;10019;-43;449;32162;1482;43663;714963;369985
2021-02-03;LAZ;6504;2495;4009;966;5533;5;0;ITI;ITI4;12;Lazio;41.89277044;12.48366722;2350;279;2629;57140;59769;-1004;1164;143279;5123;208171;3405739;2420258
2021-02-03;PIE;10229;3313;6916;609;9618;2;0;ITC;ITC1;1;Piemonte;45.0732745;7.680687483;2092;147;2239;9813;12052;-73;819;204223;8920;225195;2122420;1113483
2021-02-03;TOS;4228;1452;2776;237;3987;4;0;ITI;ITI1;9;Toscana;43.76923077;11.25588885;663;109;772;8573;9345;143;551;122187;4247;135779;2276931;1213838
2021-02-03;FVG;2655;793;1862;24;2630;1;0;ITH;ITH4;6;Friuli-Venezia Giulia;45.6494354;13.76813649;561;63;624;10556;11180;-46;692;54962;2471;68613;1166449;422735
2021-02-03;PAT;877;326;551;417;460;0;0;ITH;ITH2;4;Provincia Autonoma Trento;46.06893511;11.12123097;158;33;191;2304;2495;99;261;24365;1153;28013;535579;162409
2021-02-03;LIG;2321;792;1529;51;2270;0;0;ITC;ITC3;7;Liguria;44.41149315;8.9326992;641;64;705;3734;4439;54;233;62451;3398;70288;876302;381711
2021-02-03;UMB;727;174;553;67;660;0;0;ITI;ITI2;10;Umbria;43.10675841;12.38824698;367;64;431;5568;5999;227;458;30126;810;36935;646717;286806
2021-02-03;VEN;5955;1672;4283;474;5477;4;0;ITH;ITH3;5;Veneto;45.43490485;12.33845213;1306;176;1482;28878;30360;-1684;629;274482;9103;313945;4243554;1329843
2021-02-03;SAR;1123;420;703;427;695;1;0;ITG;ITG2;20;Sardegna;39.21531192;9.110616306;416;29;445;14393;14838;-354;143;23035;1001;38874;590068;484292
2021-02-03;PAB;1508;480;1028;5;1503;0;0;ITH;ITH1;4;Provincia Autonoma Bolzano / Bozen;46.49933453;11.35662422;233;34;267;4741;5008;229;639;35234;880;41122;509703;182033
2021-02-03;MOL;749;255;494;347;402;0;0;ITF;ITF2;14;Molise;41.55774754;14.65916051;61;9;70;1136;1206;47;54;6934;268;8408;138414;125442
2021-02-03;PUG;5061;2012;3049;705;4355;1;0;ITF;ITF4;16;Puglia;41.12559576;16.86736689;1429;155;1584;50131;51715;13;1044;70194;3300;125209;1336292;771982
2021-02-03;MAR;2129;743;1386;97;2011;21;0;ITI;ITI3;11;Marche;43.61675973;13.5188753;535;68;603;7750;8353;-328;408;46068;1996;56417;702605;423244
2021-02-03;LOM;25746;7960;17786;1078;24663;5;0;ITC;ITC4;3;Lombardia;45.46679409;9.190347404;3554;359;3913;43432;47345;786;1738;467193;27259;541797;5743914;2856882
2021-02-03;EMR;9353;2993;6360;962;8390;1;0;ITH;ITH5;8;Emilia-Romagna;44.49436681;11.341720800000001;2122;194;2316;42086;44402;-910;1047;167556;9656;221615;3166204;1369671
2021-02-04;FVG;2730;809;1921;36;2694;0;0;ITH;ITH4;6;Friuli-Venezia Giulia;45.6494354;13.76813649;550;64;614;10647;11261;81;355;55217;2490;68968;1172232;424647
2021-02-04;LOM;28033;8172;19861;2049;25979;5;0;ITC;ITC4;3;Lombardia;45.46679409;9.190347404;3539;362;3901;42995;46896;-449;1746;469348;27299;543543;5776961;2865764
2021-02-04;LIG;2820;990;1830;177;2643;0;0;ITC;ITC3;7;Liguria;44.41149315;8.9326992;627;64;691;3712;4403;-36;489;62966;3408;70777;884099;383859
2021-02-04;SAR;2303;826;1477;915;1385;3;0;ITG;ITG2;20;Sardegna;39.21531192;9.110616306;398;28;426;14325;14751;-87;205;23323;1005;39079;593009;486426
2021-02-04;VEN;7398;2030;5368;550;6847;1;0;ITH;ITH3;5;Veneto;45.43490485;12.33845213;1232;176;1408;27296;28704;-1656;896;276972;9165;314841;4279848;1332977
2021-02-04;PIE;10260;3363;6897;583;9675;2;0;ITC;ITC1;1;Piemonte;45.0732745;7.680687483;2065;143;2208;9822;12030;-22;807;205021;8951;226002;2139869;1117995
2021-02-04;TOS;4264;1597;2667;942;3295;27;0;ITI;ITI1;9;Toscana;43.76923077;11.25588885;642;112;754;8936;9690;345;760;122580;4269;136539;2293582;1221727
2021-02-04;CAM;7946;3430;4516;1249;6638;59;0;ITF;ITF3;15;Campania;40.83956555;14.25084984;1468;100;1568;60781;62349;232;1544;160976;3856;227181;2489654;1643920
2021-02-04;PUG;5946;2368;3578;1132;4810;4;0;ITF;ITF4;16;Puglia;41.12559576;16.86736689;1420;158;1578;49852;51430;-285;975;71423;3331;126184;1346440;775587
2021-02-04;SIC;6761;3083;3678;1419;5313;29;0;ITG;ITG1;19;Sicilia;38.11569725;13.362356699999998;1286;187;1473;39181;40654;-468;789;95271;3603;139528;1885970;1008097
2021-02-04;PAT;1014;321;693;430;583;1;0;ITH;ITH2;4;Provincia Autonoma Trento;46.06893511;11.12123097;144;32;176;2266;2442;-53;240;24653;1158;28253;539446;162761
2021-02-04;MAR;2389;844;1545;107;2277;5;0;ITI;ITI3;11;Marche;43.61675973;13.5188753;529;76;605;7507;8112;-241;480;46774;2011;56897;707989;426581
2021-02-04;MOL;763;296;467;78;685;0;0;ITF;ITF2;14;Molise;41.55774754;14.65916051;58;8;66;1112;1178;-28;31;6989;272;8439;138859;125800
2021-02-04;PAB;1968;598;1370;8;1960;0;0;ITH;ITH1;4;Provincia Autonoma Bolzano / Bozen;46.49933453;11.35662422;241;32;273;5477;5750;742;653;35140;885;41775;518555;182952
2021-02-04;BAS;1109;447;662;64;1045;0;0;ITF;ITF5;17;Basilicata;40.63947052;15.80514834;71;1;72;3364;3436;15;68;9668;331;13435;217404;131249
2021-02-04;ABR;1685;617;1068;600;1073;12;0;ITF;ITF1;13;Abruzzo;42.35122196;13.39843823;452;47;499;9744;10243;224;526;32458;1488;44189;722445;373231
2021-02-04;VDA;295;86;209;8;287;0;0;ITC;ITC2;2;Valle d'Aosta / Vallée d'Aoste;45.73750286;7.320149366;25;3;28;173;201;-28;4;7198;405;7804;70530;41648
2021-02-04;UMB;736;226;510;26;710;0;0;ITI;ITI2;10;Umbria;43.10675841;12.38824698;372;66;438;5753;6191;192;373;30304;813;37308;654241;288222
2021-02-04;LAZ;6479;2585;3894;1148;5330;1;0;ITI;ITI4;12;Lazio;41.89277044;12.48366722;2308;273;2581;55445;58026;-1743;1174;146154;5165;209345;3440379;2444101
2021-02-04;EMR;9935;3208;6727;1235;8699;1;0;ITH;ITH5;8;Emilia-Romagna;44.49436681;11.341720800000001;2046;188;2234;41575;43809;-593;1192;169281;9714;222804;3192086;1375061
2021-02-04;CAL;3679;1748;1931;647;3026;6;0;ITF;ITF6;18;Calabria;38.90597598;16.59440194;256;25;281;8262;8543;-87;202;24476;609;33628;529075;500314
2021-02-05;ABR;1535;521;1014;772;747;16;0;ITF;ITF1;13;Abruzzo;42.35122196;13.39843823;453;48;501;9725;10226;-17;276;32740;1498;44464;728884;376247
2021-02-05;VDA;296;103;193;102;194;0;0;ITC;ITC2;2;Valle d'Aosta / Vallée d'Aoste;45.73750286;7.320149366;29;3;32;157;189;-12;11;7220;406;7815;70882;41731
2021-02-05;MOL;599;271;328;56;543;0;0;ITF;ITF2;14;Molise;41.55774754;14.65916051;65;6;71;1111;1182;4;78;7059;276;8517;140097;126865
2021-02-05;BAS;998;449;549;64;932;2;0;ITF;ITF5;17;Basilicata;40.63947052;15.80514834;84;2;86;3255;3341;-95;89;9852;331;13524;218685;131942
2021-02-05;CAM;7268;3464;3804;2023;5130;115;0;ITF;ITF3;15;Campania;40.83956555;14.25084984;1490;103;1593;61726;63319;970;1665;161648;3879;228846;2506569;1655392
2021-02-05;LOM;25801;7496;18305;2430;23359;12;0;ITC;ITC4;3;Lombardia;45.46679409;9.190347404;3549;359;3908;44294;48202;1306;2504;470500;27345;546047;5815964;2877075
2021-02-05;TOS;5770;2250;3520;1905;3831;34;0;ITI;ITI1;9;Toscana;43.76923077;11.25588885;643;105;748;9344;10092;402;703;122865;4285;137242;2310528;1229279
2021-02-05;CAL;3866;1747;2119;472;3379;15;0;ITF;ITF6;18;Calabria;38.90597598;16.59440194;261;26;287;8060;8347;-196;239;24907;613;33867;531634;502510
2021-02-05;UMB;783;234;549;18;765;0;0;ITI;ITI2;10;Umbria;43.10675841;12.38824698;377;66;443;5955;6398;207;443;30530;823;37751;662890;289717
2021-02-05;VEN;8392;2541;5851;1407;6976;9;0;ITH;ITH3;5;Veneto;45.43490485;12.33845213;1194;172;1366;26560;27926;-778;668;278393;9190;315509;4311466;1335643
2021-02-05;MAR;2159;656;1503;438;1720;1;0;ITI;ITI3;11;Marche;43.61675973;13.5188753;532;74;606;7321;7927;-185;414;47357;2027;57311;712718;429688
2021-02-05;PAB;3212;1190;2022;8;3204;0;0;ITH;ITH1;4;Provincia Autonoma Bolzano / Bozen;46.49933453;11.35662422;249;35;284;5607;5891;141;747;35744;887;42522;526211;183686
2021-02-05;LIG;2740;994;1746;299;2440;1;0;ITC;ITC3;7;Liguria;44.41149315;8.9326992;631;62;693;3794;4487;84;332;63205;3417;71109;891881;386424
2021-02-05;PUG;5657;2279;3378;1313;4339;5;0;ITF;ITF4;16;Puglia;41.12559576;16.86736689;1416;168;1584;49442;51026;-404;1215;73013;3360;127399;1356327;779903
2021-02-05;PIE;9638;3148;6490;656;8980;2;0;ITC;ITC1;1;Piemonte;45.0732745;7.680687483;2021;147;2168;10027;12195;165;936;205770;8973;226938;2158679;1124347
2021-02-05;PAT;835;288;547;285;550;0;0;ITH;ITH2;4;Provincia Autonoma Trento;46.06893511;11.12123097;142;32;174;2341;2515;73;202;24782;1158;28455;542779;163001
2021-02-05;EMR;9314;2965;6349;1617;7693;4;0;ITH;ITH5;8;Emilia-Romagna;44.49436681;11.341720800000001;1990;182;2172;40964;43136;-673;1364;171260;9768;224164;3219440;1380164
2021-02-05;FVG;2633;793;1840;89;2544;0;0;ITH;ITH4;6;Friuli-Venezia Giulia;45.6494354;13.76813649;536;65;601;10454;11055;-206;446;55837;2522;69414;1179534;427502
2021-02-05;SAR;1924;757;1167;435;1487;2;0;ITG;ITG2;20;Sardegna;39.21531192;9.110616306;403;29;432;14274;14706;-45;169;23532;1010;39248;596329;488815
2021-02-05;SIC;6789;3006;3783;2086;4665;38;0;ITG;ITG1;19;Sicilia;38.11569725;13.362356699999998;1244;182;1426;38128;39554;-1100;616;96956;3634;140144;1911176;1013674
2021-02-05;LAZ;7347;3008;4339;1220;6123;4;0;ITI;ITI4;12;Lazio;41.89277044;12.48366722;2264;272;2536;54285;56821;-1205;1141;148464;5201;210486;3470340;2465620
2021-02-06;VEN;4099;1354;2745;708;3391;0;0;ITH;ITH3;5;Veneto;45.43490485;12.33845213;1123;158;1281;25936;27217;-709;831;279870;9253;316340;4348682;1338389
2021-02-06;CAL;2937;1352;1585;439;2497;1;0;ITF;ITF6;18;Calabria;38.90597598;16.59440194;249;27;276;7866;8142;-205;197;25305;617;34064;534256;504906
2021-02-06;PAT;582;302;280;439;143;0;0;ITH;ITH2;4;Provincia Autonoma Trento;46.06893511;11.12123097;131;28;159;2465;2624;109;278;24949;1160;28733;546110;163333
2021-02-06;CAM;5343;2666;2677;2002;3241;100;0;ITF;ITF3;15;Campania;40.83956555;14.25084984;1499;108;1607;62633;64240;921;1546;162264;3888;230392;2525894;1788715
2021-02-06;LAZ;6317;2583;3734;907;5405;5;0;ITI;ITI4;12;Lazio;41.89277044;12.48366722;2273;270;2543;53900;56443;-378;1014;149818;5239;211500;3498179;2485629
2021-02-06;UMB;437;163;274;34;403;0;0;ITI;ITI2;10;Umbria;43.10675841;12.38824698;388;70;458;6124;6582;184;351;30689;831;38102;671839;291099
2021-02-06;SIC;4736;2119;2617;1450;3266;20;0;ITG;ITG1;19;Sicilia;38.11569725;13.362356699999998;1228;177;1405;37861;39266;-288;836;98057;3657;140980;1936886;1019978
2021-02-06;EMR;7606;2410;5196;2108;5494;4;0;ITH;ITH5;8;Emilia-Romagna;44.49436681;11.341720800000001;1956;183;2139;40509;42648;-488;1383;173085;9812;225545;3247836;1385467
2021-02-06;FVG;1157;341;816;21;1135;1;0;ITH;ITH4;6;Friuli-Venezia Giulia;45.6494354;13.76813649;533;63;596;10276;10872;-183;413;56408;2547;69827;1191476;432116
2021-02-06;SAR;1983;706;1277;566;1414;3;0;ITG;ITG2;20;Sardegna;39.21531192;9.110616306;394;31;425;14223;14648;-58;125;23709;1016;39373;599083;491094
2021-02-06;LOM;15315;5556;9759;1014;14296;5;0;ITC;ITC4;3;Lombardia;45.46679409;9.190347404;3540;354;3894;44415;48309;107;1923;472266;27395;547970;5852056;2885842
2021-02-06;PAB;2635;1178;1457;19;2616;0;0;ITH;ITH1;4;Provincia Autonoma Bolzano / Bozen;46.49933453;11.35662422;255;35;290;6083;6373;482;687;35943;893;43209;534472;184552
2021-02-06;PIE;8016;2670;5346;396;7618;2;0;ITC;ITC1;1;Piemonte;45.0732745;7.680687483;2007;140;2147;10035;12182;-13;717;206479;8994;227655;2178038;1128845
2021-02-06;ABR;1613;745;868;595;1011;7;0;ITF;ITF1;13;Abruzzo;42.35122196;13.39843823;461;49;510;10042;10552;326;509;32918;1502;44972;736955;379823
2021-02-06;PUG;4560;1937;2623;1579;2966;15;0;ITF;ITF4;16;Puglia;41.12559576;16.86736689;1427;157;1584;49491;51075;49;926;73859;3391;128325;1366157;783795
2021-02-06;LIG;1892;768;1124;145;1747;0;0;ITC;ITC3;7;Liguria;44.41149315;8.9326992;609;61;670;3924;4594;107;276;63346;3445;71385;898257;388159
2021-02-06;MAR;2462;902;1560;512;1941;9;0;ITI;ITI3;11;Marche;43.61675973;13.5188753;531;75;606;7019;7625;-302;436;48089;2033;57747;718208;433086
2021-02-06;BAS;928;381;547;146;782;0;0;ITF;ITF5;17;Basilicata;40.63947052;15.80514834;84;1;85;3192;3277;-64;85;9995;337;13609;220528;132669
2021-02-06;VDA;291;104;187;91;199;1;0;ITC;ITC2;2;Valle d'Aosta / Vallée d'Aoste;45.73750286;7.320149366;27;3;30;158;188;-1;11;7232;406;7826;71235;41815
2021-02-06;TOS;4540;1555;2985;1270;3237;33;0;ITI;ITI1;9;Toscana;43.76923077;11.25588885;643;109;752;9513;10265;173;708;123389;4296;137950;2327331;1237112
2021-02-06;MOL;432;179;253;30;402;0;0;ITF;ITF2;14;Molise;41.55774754;14.65916051;62;11;73;1155;1228;46;80;7087;282;8597;140848;127479
2021-02-07;MOL;67;32;35;20;47;0;0;ITF;ITF2;14;Molise;41.55774754;14.65916051;65;10;75;1218;1293;65;101;7121;284;8698;141789;128346
2021-02-07;PUG;1586;669;917;253;1333;0;0;ITF;ITF4;16;Puglia;41.12559576;16.86736689;1434;162;1596;49670;51266;191;765;74425;3399;129090;1374908;785476
2021-02-07;MAR;1872;735;1137;331;1529;12;0;ITI;ITI3;11;Marche;43.61675973;13.5188753;528;74;602;7024;7626;1;394;48473;2042;58141;722696;435964
2021-02-07;PAB;2684;1189;1495;333;2351;0;0;ITH;ITH1;4;Provincia Autonoma Bolzano / Bozen;46.49933453;11.35662422;242;34;276;4716;4992;-1381;802;38122;897;44011;543822;185338
2021-02-07;BAS;385;163;222;49;336;0;0;ITF;ITF5;17;Basilicata;40.63947052;15.80514834;84;1;85;3207;3292;15;77;10054;340;13686;221599;133162
2021-02-07;ABR;780;307;473;199;580;1;0;ITF;ITF1;13;Abruzzo;42.35122196;13.39843823;470;51;521;10455;10976;424;436;32919;1513;45408;750538;388039
2021-02-07;FVG;1570;483;1087;385;1184;1;0;ITH;ITH4;6;Friuli-Venezia Giulia;45.6494354;13.76813649;521;63;584;10203;10787;-85;285;56764;2561;70112;1196172;433968
2021-02-07;EMR;4794;1537;3257;1724;3068;2;0;ITH;ITH5;8;Emilia-Romagna;44.49436681;11.341720800000001;1950;181;2131;41130;43261;613;1382;173828;9837;226926;3264051;1390037
2021-02-07;VDA;292;120;172;190;102;0;0;ITC;ITC2;2;Valle d'Aosta / Vallée d'Aoste;45.73750286;7.320149366;25;3;28;151;179;-9;8;7248;407;7834;71446;41905
2021-02-07;CAM;2929;1382;1547;2066;771;92;0;ITF;ITF3;15;Campania;40.83956555;14.25084984;1500;105;1605;63867;65472;1232;1741;162770;3891;232133;2545475;1796170
2021-02-07;SIC;2322;983;1339;663;1649;10;0;ITG;ITG1;19;Sicilia;38.11569725;13.362356699999998;1198;178;1376;37633;39009;-257;574;98863;3682;141554;1961519;1024409
2021-02-07;CAL;873;435;438;143;728;2;0;ITF;ITF6;18;Calabria;38.90597598;16.59440194;233;26;259;7544;7803;-339;127;25764;624;34191;537077;507606
2021-02-07;LOM;7324;2832;4492;335;6986;3;0;ITC;ITC4;3;Lombardia;45.46679409;9.190347404;3467;358;3825;45015;48840;531;1515;473192;27453;549485;5879680;2894441
2021-02-07;LIG;407;153;254;2;405;0;0;ITC;ITC3;7;Liguria;44.41149315;8.9326992;608;61;669;3982;4651;57;364;63644;3454;71749;902861;389514
2021-02-07;VEN;2316;863;1453;714;1601;1;0;ITH;ITH3;5;Veneto;45.43490485;12.33845213;1110;153;1263;25707;26970;-247;496;280585;9281;316836;4366107;1340565
2021-02-07;LAZ;4979;2052;2927;413;4565;1;0;ITI;ITI4;12;Lazio;41.89277044;12.48366722;2232;264;2496;50862;53358;-3085;920;153803;5259;212420;3520345;2500220
2021-02-07;SAR;1128;397;731;228;899;1;0;ITG;ITG2;20;Sardegna;39.21531192;9.110616306;382;34;416;14269;14685;37;154;23823;1019;39527;600974;492669
2021-02-07;TOS;2818;958;1860;871;1927;20;0;ITI;ITI1;9;Toscana;43.76923077;11.25588885;650;108;758;9682;10440;175;668;123860;4318;138618;2339959;1243732
2021-02-07;UMB;55;17;38;1;54;0;0;ITI;ITI2;10;Umbria;43.10675841;12.38824698;411;73;484;6300;6784;202;382;30866;834;38484;679753;292454
2021-02-07;PIE;3104;978;2126;447;2656;1;0;ITC;ITC1;1;Piemonte;45.0732745;7.680687483;2017;140;2157;10165;12322;140;624;206955;9002;228279;2186106;1132152
2021-02-08;UMB;637;203;434;88;549;0;0;ITI;ITI2;10;Umbria;43.10675841;12.38824698;423;77;500;6402;6902;118;190;30932;840;38674;681597;292665
2021-02-08;LOM;10139;2938;7201;2125;8006;8;0;ITC;ITC4;3;Lombardia;45.46679409;9.190347404;3491;362;3853;42521;46374;-2466;895;476502;27504;550380;5893600;2899283
2021-02-08;SAR;1477;536;941;859;617;1;0;ITG;ITG2;20;Sardegna;39.21531192;9.110616306;380;35;415;14112;14527;-158;56;24033;1023;39583;602824;493759
2021-02-08;PIE;6935;2356;4579;666;6264;5;0;ITC;ITC1;1;Piemonte;45.0732745;7.680687483;2036;148;2184;10107;12291;-31;483;207457;9014;228762;2196114;1134772
2021-02-08;SIC;3888;1680;2208;2081;1759;48;0;ITG;ITG1;19;Sicilia;38.11569725;13.362356699999998;1192;181;1373;37559;38932;-77;478;99396;3704;142032;1983965;1028509
2021-02-08;LAZ;9765;4172;5593;4507;5256;2;0;ITI;ITI4;12;Lazio;41.89277044;12.48366722;2248;272;2520;47030;49550;-3808;782;158361;5291;213202;3534649;2506811
2021-02-08;TOS;4132;1372;2760;3561;459;112;0;ITI;ITI1;9;Toscana;43.76923077;11.25588885;691;112;803;9916;10719;279;523;124089;4333;139141;2347868;1248041
2021-02-08;PAT;1195;333;862;348;847;0;0;ITH;ITH2;4;Provincia Autonoma Trento;46.06893511;11.12123097;136;26;162;2514;2676;52;175;25067;1165;28908;548473;163600
2021-02-08;VEN;5007;1559;3448;1923;3078;6;0;ITH;ITH3;5;Veneto;45.43490485;12.33845213;1110;153;1263;25667;26930;-40;442;281049;9299;317278;4380776;1342044
2021-02-08;EMR;5239;1537;3702;2318;2918;3;0;ITH;ITH5;8;Emilia-Romagna;44.49436681;11.341720800000001;2002;183;2185;40588;42773;-488;1273;175556;9869;228198;3275041;1392846
2021-02-08;FVG;2361;697;1664;90;2270;1;0;ITH;ITH4;6;Friuli-Venezia Giulia;45.6494354;13.76813649;527;63;590;10152;10742;-45;132;56907;2595;70244;1198414;434761
2021-02-08;PUG;4013;1623;2390;1583;2415;15;0;ITF;ITF4;16;Puglia;41.12559576;16.86736689;1450;164;1614;48671;50285;-981;377;75760;3422;129467;1378491;788200
2021-02-08;VDA;224;83;141;25;199;0;0;ITC;ITC2;2;Valle d'Aosta / Vallée d'Aoste;45.73750286;7.320149366;24;3;27;141;168;-11;8;7266;408;7842;71659;41965
2021-02-08;ABR;1194;396;798;487;707;0;0;ITF;ITF1;13;Abruzzo;42.35122196;13.39843823;487;49;536;10418;10954;-22;184;33120;1518;45592;770149;402022
2021-02-08;BAS;567;195;372;156;411;0;0;ITF;ITF5;17;Basilicata;40.63947052;15.80514834;82;1;83;3185;3268;-24;15;10090;343;13701;221863;133264
2021-02-08;PAB;2;1;1;1;1;0;0;ITH;ITH1;4;Provincia Autonoma Bolzano / Bozen;46.49933453;11.35662422;242;35;277;5012;5289;297;470;38290;902;44481;549137;186072
2021-02-08;MOL;338;142;196;218;120;0;0;ITF;ITF2;14;Molise;41.55774754;14.65916051;66;12;78;1235;1313;20;78;7178;285;8776;142685;129134
2021-02-08;CAM;5128;2459;2669;4162;815;151;0;ITF;ITF3;15;Campania;40.83956555;14.25084984;1542;110;1652;64056;65708;236;1189;163710;3904;233322;2555030;1800322
2021-02-08;CAL;1880;748;1132;667;1210;3;0;ITF;ITF6;18;Calabria;38.90597598;16.59440194;234;25;259;7305;7564;-239;142;26144;625;34333;538810;509214
2021-02-08;LIG;1983;744;1239;299;1684;0;0;ITC;ITC3;7;Liguria;44.41149315;8.9326992;609;63;672;4122;4794;143;220;63709;3466;71969;906468;391081
2021-02-08;MAR;834;259;575;366;463;5;0;ITI;ITI3;11;Marche;43.61675973;13.5188753;536;73;609;7060;7669;43;171;48593;2050;58312;724002;436633
2021-02-09;TOS;4534;1485;3049;3809;611;114;0;ITI;ITI1;9;Toscana;43.76923077;11.25588885;701;113;814;9927;10741;22;453;124493;4360;139594;2363704;1255241
2021-02-09;PUG;3857;1577;2280;2160;1677;20;0;ITF;ITF4;16;Puglia;41.12559576;16.86736689;1415;165;1580;46980;48560;-1725;681;78125;3463;130148;1387753;792523
2021-02-09;LIG;1957;697;1260;262;1692;3;0;ITC;ITC3;7;Liguria;44.41149315;8.9326992;616;63;679;4051;4730;-64;257;64020;3476;72226;912708;393393
2021-02-09;MAR;125;42;83;46;79;0;0;ITI;ITI3;11;Marche;43.61675973;13.5188753;542;74;616;6989;7605;-64;270;48919;2058;58582;729110;439935
2021-02-09;LAZ;8875;3820;5055;4580;4288;7;0;ITI;ITI4;12;Lazio;41.89277044;12.48366722;2257;268;2525;44521;47046;-2504;847;161679;5324;214049;3564258;2526336
2021-02-09;ABR;924;326;598;513;410;1;0;ITF;ITF1;13;Abruzzo;42.35122196;13.39843823;491;51;542;10207;10749;-205;241;33558;1526;45833;777439;405665
2021-02-09;MOL;361;171;190;198;163;0;0;ITF;ITF2;14;Molise;41.55774754;14.65916051;69;11;80;1275;1355;42;91;7224;288;8867;143474;129826
2021-02-09;SIC;4350;1800;2550;3248;1037;65;0;ITG;ITG1;19;Sicilia;38.11569725;13.362356699999998;1161;176;1337;37184;38521;-411;744;100527;3728;142776;2005913;1033929
2021-02-09;VEN;5250;1892;3358;3431;1806;13;0;ITH;ITH3;5;Veneto;45.43490485;12.33845213;1112;147;1259;25071;26330;-600;701;282285;9364;317979;4415169;1344750
2021-02-09;EMR;4162;1254;2908;2308;1853;1;0;ITH;ITH5;8;Emilia-Romagna;44.49436681;11.341720800000001;1971;182;2153;40731;42884;111;977;176359;9914;229157;3304742;1396803
2021-02-09;BAS;496;216;280;318;178;0;0;ITF;ITF5;17;Basilicata;40.63947052;15.80514834;82;3;85;3205;3290;22;106;10173;344;13807;223725;133854
2021-02-09;CAL;2180;923;1257;954;1216;10;0;ITF;ITF6;18;Calabria;38.90597598;16.59440194;243;24;267;6959;7226;-338;188;26665;630;34521;541444;511647
2021-02-09;CAM;4655;2209;2446;4228;264;163;0;ITF;ITF3;15;Campania;40.83956555;14.25084984;1540;112;1652;63681;65333;-375;1274;165335;3928;234596;2568721;1807945
2021-02-09;LOM;12234;3338;8896;4027;8193;14;0;ITC;ITC4;3;Lombardia;45.46679409;9.190347404;3553;363;3916;43123;47039;665;1625;477407;27559;552005;5923079;2906344
2021-02-09;SAR;2300;840;1460;1290;1005;5;0;ITG;ITG2;20;Sardegna;39.21531192;9.110616306;371;37;408;13978;14386;-141;81;24247;1031;39664;620008;495196
2021-02-09;PAT;959;305;654;448;510;1;0;ITH;ITH2;4;Provincia Autonoma Trento;46.06893511;11.12123097;141;28;169;2428;2597;-79;66;25207;1170;28974;549351;163822
2021-02-09;FVG;1848;558;1290;1556;291;1;0;ITH;ITH4;6;Friuli-Venezia Giulia;45.6494354;13.76813649;501;66;567;9979;10546;-196;271;57364;2605;70515;1204993;437096
2021-02-09;PIE;7417;2322;5095;719;6696;2;0;ITC;ITC1;1;Piemonte;45.0732745;7.680687483;2040;148;2188;9883;12071;-220;619;208261;9049;229381;2215289;1140808
2021-02-09;PAB;317;126;191;1;316;0;0;ITH;ITH1;4;Provincia Autonoma Bolzano / Bozen;46.49933453;11.35662422;250;30;280;5176;5456;167;255;38373;907;44736;551854;186416
2021-02-09;VDA;255;86;169;70;184;1;0;ITC;ITC2;2;Valle d'Aosta / Vallée d'Aoste;45.73750286;7.320149366;24;3;27;135;162;-6;1;7272;409;7843;71822;42029
2021-02-10;BAS;552;241;311;497;53;2;0;ITF;ITF5;17;Basilicata;40.63947052;15.80514834;82;5;87;3250;3337;47;94;10219;345;13901;224623;134291
2021-02-10;ABR;946;311;635;492;444;10;0;ITF;ITF1;13;Abruzzo;42.35122196;13.39843823;496;52;548;10259;10807;58;314;33807;1533;46147;789446;411903
2021-02-10;VDA;248;77;171;141;107;0;0;ITC;ITC2;2;Valle d'Aosta / Vallée d'Aoste;45.73750286;7.320149366;25;3;28;137;165;3;13;7281;410;7856;71962;42078
2021-02-10;FVG;1364;508;856;1275;89;0;0;ITH;ITH4;6;Friuli-Venezia Giulia;45.6494354;13.76813649;481;65;546;9773;10319;-227;361;57938;2619;70876;1214627;440088
2021-02-10;CAM;6939;3439;3500;6483;206;250;0;ITF;ITF3;15;Campania;40.83956555;14.25084984;1486;103;1589;64162;65751;418;1635;166526;3954;236231;2589633;1821077
2021-02-10;SIC;4355;1777;2578;3887;384;84;0;ITG;ITG1;19;Sicilia;38.11569725;13.362356699999998;1108;170;1278;36309;37587;-934;695;102127;3757;143471;2028273;1039395
2021-02-10;MOL;152;80;72;132;20;0;0;ITF;ITF2;14;Molise;41.55774754;14.65916051;71;11;82;1322;1404;49;84;7254;293;8951;144168;130457
2021-02-10;CAL;2527;1087;1440;877;1635;15;0;ITF;ITF6;18;Calabria;38.90597598;16.59440194;235;27;262;6955;7217;-9;214;26886;632;34735;544013;514040
2021-02-10;PIE;7572;2384;5188;1302;6255;15;0;ITC;ITC1;1;Piemonte;45.0732745;7.680687483;2003;153;2156;9893;12049;-22;669;208934;9067;230050;2234171;1147023
2021-02-10;LOM;14469;4531;9938;7569;6871;29;0;ITC;ITC4;3;Lombardia;45.46679409;9.190347404;3564;371;3935;42676;46611;-428;1849;479645;27598;553854;5959396;2915298
2021-02-10;LAZ;8280;3470;4810;4851;3423;6;0;ITI;ITI4;12;Lazio;41.89277044;12.48366722;2233;260;2493;42341;44834;-2212;1027;164867;5375;215076;3592299;2544252
2021-02-10;UMB;715;350;365;700;15;0;0;ITI;ITI2;10;Umbria;43.10675841;12.38824698;434;79;513;6660;7173;271;375;31025;851;39049;691112;294399
2021-02-10;PAT;872;295;577;513;358;1;0;ITH;ITH2;4;Provincia Autonoma Trento;46.06893511;11.12123097;144;29;173;2399;2572;-25;164;25393;1173;29138;551717;164101
2021-02-10;PUG;3660;1444;2216;2127;1513;20;0;ITF;ITF4;16;Puglia;41.12559576;16.86736689;1488;167;1655;45451;47106;-1454;1063;80617;3488;131211;1398270;796957
2021-02-10;PAB;1637;605;1032;26;1610;1;0;ITH;ITH1;4;Provincia Autonoma Bolzano / Bozen;46.49933453;11.35662422;250;30;280;5376;5656;200;721;38888;913;45457;563445;186732
2021-02-10;TOS;4315;1309;3006;3633;526;156;0;ITI;ITI1;9;Toscana;43.76923077;11.25588885;700;115;815;10108;10923;182;671;124966;4376;140265;2383750;1264715
2021-02-10;MAR;1442;452;990;1040;360;42;0;ITI;ITI3;11;Marche;43.61675973;13.5188753;534;72;606;6906;7512;-93;421;49421;2070;59003;734693;443412
2021-02-10;LIG;2326;841;1485;1017;1306;3;0;ITC;ITC3;7;Liguria;44.41149315;8.9326992;607;62;669;4012;4681;-49;364;64426;3483;72590;919858;395970
2021-02-10;SAR;1977;775;1202;1445;526;6;0;ITG;ITG2;20;Sardegna;39.21531192;9.110616306;365;32;397;13915;14312;-74;161;24477;1036;39825;643535;497712
2021-02-10;EMR;4024;1385;2639;2757;1261;6;0;ITH;ITH5;8;Emilia-Romagna;44.49436681;11.341720800000001;1937;183;2120;39593;41713;-1171;930;178414;9951;230078;3335406;1402305
2021-02-10;VEN;4763;1593;3170;3692;1061;10;0;ITH;ITH3;5;Veneto;45.43490485;12.33845213;1062;136;1198;24773;25971;-359;828;283441;9395;318807;4452517;1347882
2021-02-11;LOM;17138;5027;12111;9637;7424;77;0;ITC;ITC4;3;Lombardia;45.46679409;9.190347404;3550;368;3918;43092;47010;399;2434;481626;27652;556288;6001331;2927173
2021-02-11;CAM;6293;2716;3577;5909;77;307;0;ITF;ITF3;15;Campania;40.83956555;14.25084984;1425;115;1540;64753;66293;542;1694;167666;3966;237925;2611091;1833291
2021-02-11;TOS;5423;2037;3386;5099;242;82;0;ITI;ITI1;9;Toscana;43.76923077;11.25588885;688;120;808;10553;11361;438;894;125415;4383;141159;2403172;1274655
2021-02-11;LIG;1990;773;1217;1092;888;10;0;ITC;ITC3;7;Liguria;44.41149315;8.9326992;604;62;666;4131;4797;116;319;64621;3491;72909;926352;398480
2021-02-11;SAR;1322;490;832;1207;115;0;0;ITG;ITG2;20;Sardegna;39.21531192;9.110616306;358;33;391;13800;14191;-121;125;24713;1046;39950;646950;500558
2021-02-11;VEN;4015;1238;2777;3349;628;38;0;ITH;ITH3;5;Veneto;45.43490485;12.33845213;1029;135;1164;24454;25618;-353;708;284471;9426;319515;4483794;1350925
2021-02-11;PIE;6782;2112;4670;2994;3769;19;0;ITC;ITC1;1;Piemonte;45.0732745;7.680687483;1956;150;2106;10084;12190;141;1189;209960;9089;231239;2254299;1153341
2021-02-11;PAT;1171;377;794;803;367;1;0;ITH;ITH2;4;Provincia Autonoma Trento;46.06893511;11.12123097;142;29;171;2495;2666;94;305;25603;1174;29443;555598;164440
2021-02-11;LAZ;7127;3096;4031;6458;644;25;0;ITI;ITI4;12;Lazio;41.89277044;12.48366722;2160;257;2417;40727;43144;-1690;1271;167797;5406;216347;3622508;2563273
2021-02-11;EMR;4260;1417;2843;3401;842;17;0;ITH;ITH5;8;Emilia-Romagna;44.49436681;11.341720800000001;1903;178;2081;38591;40672;-1041;1345;180721;10022;231415;3363109;1407697
2021-02-11;SIC;5239;2061;3178;4654;467;118;0;ITG;ITG1;19;Sicilia;38.11569725;13.362356699999998;1071;165;1236;35419;36655;-932;760;103793;3783;144231;2049875;1045265
2021-02-11;FVG;2016;713;1303;1753;259;4;0;ITH;ITH4;6;Friuli-Venezia Giulia;45.6494354;13.76813649;457;66;523;9714;10237;-82;409;58389;2659;71285;1225100;442616
2021-02-11;CAL;2355;1054;1301;1064;1269;22;0;ITF;ITF6;18;Calabria;38.90597598;16.59440194;223;25;248;6716;6964;-253;198;27331;638;34933;546673;516656
2021-02-11;PUG;3701;1402;2299;2393;1280;28;0;ITF;ITF4;16;Puglia;41.12559576;16.86736689;1485;165;1650;42528;44178;-2928;1248;84760;3521;132459;1408642;800262
2021-02-11;MAR;1988;657;1331;1557;390;41;0;ITI;ITI3;11;Marche;43.61675973;13.5188753;529;75;604;7104;7708;196;530;49747;2078;59533;741378;447939
2021-02-11;PAB;1096;433;663;238;857;1;0;ITH;ITH1;4;Provincia Autonoma Bolzano / Bozen;46.49933453;11.35662422;250;34;284;7424;7708;2052;789;37623;915;46246;573697;187415
2021-02-11;ABR;815;262;553;770;43;2;0;ITF;ITF1;13;Abruzzo;42.35122196;13.39843823;502;53;555;10319;10874;67;540;34274;1538;46686;802736;418610
2021-02-11;BAS;958;406;552;873;83;2;0;ITF;ITF5;17;Basilicata;40.63947052;15.80514834;77;5;82;3210;3292;-45;102;10365;346;14003;225917;134784
2021-02-11;MOL;297;133;164;260;37;0;0;ITF;ITF2;14;Molise;41.55774754;14.65916051;69;10;79;1275;1354;-50;21;7323;295;8972;144666;130850
2021-02-11;UMB;839;348;491;834;5;0;0;ITI;ITI2;10;Umbria;43.10675841;12.38824698;426;80;506;6891;7397;224;415;31204;863;39464;700176;296052
2021-02-11;VDA;232;107;125;222;9;1;0;ITC;ITC2;2;Valle d'Aosta / Vallée d'Aoste;45.73750286;7.320149366;19;3;22;133;155;-10;14;7304;411;7870;72264;42169
2021-02-12;PAB;730;217;513;464;248;18;0;ITH;ITH1;4;Provincia Autonoma Bolzano / Bozen;46.49933453;11.35662422;251;36;287;7662;7949;241;680;38052;925;46926;584613;188128
2021-02-12;MOL;337;152;185;212;124;1;0;ITF;ITF2;14;Molise;41.55774754;14.65916051;66;9;75;1388;1463;109;144;7357;296;9116;145763;131844
2021-02-12;ABR;1227;567;660;1025;189;13;0;ITF;ITF1;13;Abruzzo;42.35122196;13.39843823;507;53;560;10497;11057;183;357;34441;1545;47043;811199;422386
2021-02-12;VDA;263;96;167;216;46;1;0;ITC;ITC2;2;Valle d'Aosta / Vallée d'Aoste;45.73750286;7.320149366;15;3;18;129;147;-8;7;7319;411;7877;72509;42262
2021-02-12;CAL;1717;673;1044;943;768;6;0;ITF;ITF6;18;Calabria;38.90597598;16.59440194;224;23;247;6546;6793;-171;115;27615;640;35048;549118;518967
2021-02-12;PAT;1033;346;687;592;439;2;0;ITH;ITH2;4;Provincia Autonoma Trento;46.06893511;11.12123097;152;29;181;2503;2684;18;253;25837;1175;29696;559166;164826
2021-02-12;FVG;1200;430;770;1145;51;4;0;ITH;ITH4;6;Friuli-Venezia Giulia;45.6494354;13.76813649;440;64;504;9681;10185;-52;290;58719;2671;71575;1231738;444712
2021-02-12;UMB;674;224;450;668;6;0;0;ITI;ITI2;10;Umbria;43.10675841;12.38824698;440;80;520;7033;7553;156;363;31402;872;39827;708800;297629
2021-02-12;CAM;6565;2878;3687;6083;219;263;0;ITF;ITF3;15;Campania;40.83956555;14.25084984;1399;106;1505;65827;67332;1039;1637;168249;3981;239562;2629484;1844532
2021-02-12;PUG;4215;1672;2543;3098;1094;23;0;ITF;ITF4;16;Puglia;41.12559576;16.86736689;1427;169;1596;40004;41600;-2578;1020;88325;3554;133479;1418783;804169
2021-02-12;PIE;6926;2227;4699;3926;2975;25;0;ITC;ITC1;1;Piemonte;45.0732745;7.680687483;1924;144;2068;10277;12345;155;869;210654;9109;232108;2274943;1158696
2021-02-12;EMR;5333;1680;3653;3903;1407;23;0;ITH;ITH5;8;Emilia-Romagna;44.49436681;11.341720800000001;1886;175;2061;37952;40013;-659;1538;182876;10049;232938;3391095;1412826
2021-02-12;LIG;1941;691;1250;896;1044;1;0;ITC;ITC3;7;Liguria;44.41149315;8.9326992;597;57;654;4283;4937;140;332;64805;3499;73241;933085;401117
2021-02-12;TOS;7682;2719;4963;7355;213;114;0;ITI;ITI1;9;Toscana;43.76923077;11.25588885;685;126;811;10738;11549;188;727;125937;4400;141886;2422330;1284213
2021-02-12;MAR;1582;619;963;1404;151;27;0;ITI;ITI3;11;Marche;43.61675973;13.5188753;532;75;607;7352;7959;251;515;50004;2085;60048;746607;451353
2021-02-12;VEN;4314;1446;2868;3670;572;72;0;ITH;ITH3;5;Veneto;45.43490485;12.33845213;1002;123;1125;24284;25409;-209;756;285402;9460;320271;4523375;1353634
2021-02-12;BAS;782;335;447;749;32;1;0;ITF;ITF5;17;Basilicata;40.63947052;15.80514834;69;4;73;3273;3346;54;90;10397;350;14093;226920;135300
2021-02-12;LAZ;6912;2888;4024;6376;453;83;0;ITI;ITI4;12;Lazio;41.89277044;12.48366722;2140;256;2396;38997;41393;-1751;1089;170603;5440;217436;3652138;2580736
2021-02-12;SAR;2249;938;1311;2183;60;6;0;ITG;ITG2;20;Sardegna;39.21531192;9.110616306;350;33;383;13683;14066;-125;87;24917;1054;40037;655411;502681
2021-02-12;SIC;4606;1829;2777;4241;286;79;0;ITG;ITG1;19;Sicilia;38.11569725;13.362356699999998;1055;169;1224;34083;35307;-1348;491;105611;3804;144722;2072966;1050954
2021-02-12;LOM;14030;4390;9640;8893;4982;155;0;ITC;ITC4;3;Lombardia;45.46679409;9.190347404;3583;359;3942;44528;48470;1460;2526;482645;27699;558814;6039796;2938732
2021-02-13;FVG;569;180;389;561;6;2;0;ITH;ITH4;6;Friuli-Venezia Giulia;45.6494354;13.76813649;425;60;485;9536;10021;-164;357;59229;2682;71932;1240999;447280
2021-02-13;EMR;3634;1086;2548;3021;599;14;0;ITH;ITH5;8;Emilia-Romagna;44.49436681;11.341720800000001;1889;171;2060;36518;38578;-1435;1488;185756;10085;234419;3420148;1417820
2021-02-13;SIC;2979;1124;1855;2686;256;37;0;ITG;ITG1;19;Sicilia;38.11569725;13.362356699999998;1043;168;1211;33759;34970;-337;543;106471;3824;145265;2095696;1056048
2021-02-13;UMB;114;27;87;111;3;0;0;ITI;ITI2;10;Umbria;43.10675841;12.38824698;439;84;523;7355;7878;325;494;31559;884;40321;716693;299125
2021-02-13;SAR;1458;563;895;1452;2;4;0;ITG;ITG2;20;Sardegna;39.21531192;9.110616306;333;28;361;13664;14025;-41;87;25040;1059;40124;658208;505021
2021-02-13;CAM;5508;2549;2959;5102;217;189;0;ITF;ITF3;15;Campania;40.83956555;14.25084984;1356;104;1460;66624;68084;752;1751;169230;3999;241313;2649897;1857334
2021-02-13;LAZ;6625;2631;3994;6149;425;51;0;ITI;ITI4;12;Lazio;41.89277044;12.48366722;2121;256;2377;38245;40622;-771;1060;172413;5461;218496;3682326;2597972
2021-02-13;CAL;1420;613;807;1046;371;3;0;ITF;ITF6;18;Calabria;38.90597598;16.59440194;217;22;239;6478;6717;-76;237;27926;642;35285;551577;521411
2021-02-13;PIE;4172;1344;2828;2931;1225;16;0;ITC;ITC1;1;Piemonte;45.0732745;7.680687483;1889;141;2030;10237;12267;-78;749;211465;9125;232857;2298777;1164303
2021-02-13;PAT;543;335;208;174;369;0;0;ITH;ITH2;4;Provincia Autonoma Trento;46.06893511;11.12123097;152;28;180;2490;2670;-14;219;26069;1176;29915;562487;165089
2021-02-13;VEN;3267;1473;1794;3231;20;16;0;ITH;ITH3;5;Veneto;45.43490485;12.33845213;942;111;1053;23876;24929;-480;689;286542;9489;320960;4556738;1356280
2021-02-13;MOL;132;80;52;132;0;0;0;ITF;ITF2;14;Molise;41.55774754;14.65916051;67;6;73;1428;1501;38;75;7388;302;9191;146462;132482
2021-02-13;PUG;3735;1462;2273;3023;696;16;0;ITF;ITF4;16;Puglia;41.12559576;16.86736689;1384;164;1548;39974;41522;-78;945;89320;3582;134424;1428130;807684
2021-02-13;LOM;6428;2446;3982;4887;1480;61;0;ITC;ITC4;3;Lombardia;45.46679409;9.190347404;3574;365;3939;45212;49151;681;2277;484180;27760;561091;6080774;2948767
2021-02-13;TOS;7868;2389;5479;7492;227;149;0;ITI;ITI1;9;Toscana;43.76923077;11.25588885;685;129;814;11085;11899;350;764;126337;4414;142650;2441931;1294292
2021-02-13;LIG;1081;509;572;798;280;3;0;ITC;ITC3;7;Liguria;44.41149315;8.9326992;561;56;617;4213;4830;-107;300;65204;3507;73541;939440;403596
2021-02-13;MAR;1093;462;631;987;82;24;0;ITI;ITI3;11;Marche;43.61675973;13.5188753;542;75;617;7462;8079;120;405;50278;2096;60453;752690;455237
2021-02-13;BAS;802;314;488;703;61;38;0;ITF;ITF5;17;Basilicata;40.63947052;15.80514834;64;5;69;3327;3396;50;84;10431;350;14177;228077;135908
2021-02-13;VDA;219;199;20;216;1;2;0;ITC;ITC2;2;Valle d'Aosta / Vallée d'Aoste;45.73750286;7.320149366;15;3;18;130;148;1;9;7327;411;7886;72818;42348
2021-02-13;ABR;870;395;475;441;425;4;0;ITF;ITF1;13;Abruzzo;42.35122196;13.39843823;548;51;599;10834;11433;376;508;34558;1558;47549;821085;426759
2021-02-13;PAB;318;79;239;310;6;2;0;ITH;ITH1;4;Provincia Autonoma Bolzano / Bozen;46.49933453;11.35662422;247;37;284;7905;8189;240;640;38447;930;47566;593384;188866
2021-02-14;PAB;299;131;168;297;2;0;0;ITH;ITH1;4;Provincia Autonoma Bolzano / Bozen;46.49933453;11.35662422;244;37;281;8130;8411;222;611;38831;935;48177;603277;189492
2021-02-14;MAR;738;301;437;726;0;12;0;ITI;ITI3;11;Marche;43.61675973;13.5188753;544;80;624;7506;8130;51;355;50574;2104;60808;757070;457692
2021-02-14;PUG;790;348;442;658;127;5;0;ITF;ITF4;16;Puglia;41.12559576;16.86736689;1359;161;1520;40134;41654;132;732;89903;3599;135156;1435404;808985
2021-02-14;VEN;126;56;70;113;13;0;0;ITH;ITH3;5;Veneto;45.43490485;12.33845213;927;113;1040;23774;24814;-115;515;287163;9498;321475;4573844;1358570
2021-02-14;VDA;48;16;32;1;47;0;0;ITC;ITC2;2;Valle d'Aosta / Vallée d'Aoste;45.73750286;7.320149366;14;2;16;128;144;-4;9;7339;412;7895;73275;42436
2021-02-14;BAS;151;48;103;105;0;46;0;ITF;ITF5;17;Basilicata;40.63947052;15.80514834;66;6;72;3378;3450;54;74;10449;352;14251;228848;136407
2021-02-14;EMR;1405;378;1027;1278;120;7;0;ITH;ITH5;8;Emilia-Romagna;44.49436681;11.341720800000001;1911;171;2082;35838;37920;-658;1323;187688;10126;235734;3436964;1422487
2021-02-14;CAL;491;229;262;453;37;1;0;ITF;ITF6;18;Calabria;38.90597598;16.59440194;206;22;228;6524;6752;35;151;28037;647;35436;553848;523446
2021-02-14;TOS;9064;2587;6477;8800;110;154;0;ITI;ITI1;9;Toscana;43.76923077;11.25588885;693;130;823;11342;12165;266;725;126779;4431;143375;2458071;1303704
2021-02-14;PAT;250;189;61;11;239;0;0;ITH;ITH2;4;Provincia Autonoma Trento;46.06893511;11.12123097;156;26;182;2531;2713;43;249;26275;1176;30164;565928;165461
2021-02-14;FVG;1;0;1;0;1;0;0;ITH;ITH4;6;Friuli-Venezia Giulia;45.6494354;13.76813649;414;61;475;9296;9771;-250;216;59684;2693;72148;1246637;449167
2021-02-14;PIE;1483;501;982;871;605;7;0;ITC;ITC1;1;Piemonte;45.0732745;7.680687483;1913;140;2053;10308;12361;94;549;211914;9131;233406;2309767;1168303
2021-02-14;LIG;233;122;111;233;0;0;0;ITC;ITC3;7;Liguria;44.41149315;8.9326992;591;62;653;4362;5015;185;274;65285;3515;73815;944081;405331
2021-02-14;SAR;542;263;279;540;2;0;0;ITG;ITG2;20;Sardegna;39.21531192;9.110616306;320;27;347;13655;14002;-23;83;25139;1066;40207;660526;506586
2021-02-14;CAM;3928;1922;2006;3841;34;53;0;ITF;ITF3;15;Campania;40.83956555;14.25084984;1322;111;1433;67561;68994;910;1603;169916;4006;242916;2669884;1871335
2021-02-14;LOM;3586;1547;2039;2934;637;15;0;ITC;ITC4;3;Lombardia;45.46679409;9.190347404;3562;364;3926;46691;50617;1466;1987;484680;27781;563078;6111063;2958489
2021-02-14;SIC;1055;402;653;905;140;10;0;ITG;ITG1;19;Sicilia;38.11569725;13.362356699999998;1030;165;1195;33671;34866;-104;479;107030;3848;145744;2115681;1059724
2021-02-14;LAZ;5809;2383;3426;5298;479;32;0;ITI;ITI4;12;Lazio;41.89277044;12.48366722;2092;259;2351;37238;39589;-1033;809;174244;5472;219305;3705417;2613208
2021-02-15;VDA;264;136;128;226;35;3;0;ITC;ITC2;2;Valle d'Aosta / Vallée d'Aoste;45.73750286;7.320149366;13;2;15;126;141;-3;9;7351;412;7904;73538;42531
2021-02-15;EMR;2905;851;2054;2712;125;68;0;ITH;ITH5;8;Emilia-Romagna;44.49436681;11.341720800000001;1972;172;2144;35426;37570;-350;1391;189406;10147;237123;3449022;1425777
2021-02-15;LAZ;8108;3603;4505;7327;655;126;0;ITI;ITI4;12;Lazio;41.89277044;12.48366722;2090;254;2344;36086;38430;-1159;760;176129;5506;220065;3721071;2621112
2021-02-15;BAS;637;240;397;576;44;17;0;ITF;ITF5;17;Basilicata;40.63947052;15.80514834;70;6;76;3359;3435;-15;29;10492;353;14280;229330;136631
2021-02-15;FVG;2461;914;1547;2201;254;6;0;ITH;ITH4;6;Friuli-Venezia Giulia;45.6494354;13.76813649;412;63;475;9284;9759;-12;40;59724;2705;72188;1247709;449582
2021-02-15;PIE;4447;1603;2844;3214;1210;23;0;ITC;ITC1;1;Piemonte;45.0732745;7.680687483;1933;144;2077;10249;12326;-35;438;212373;9145;233844;2320030;1171154
2021-02-15;SAR;962;349;613;923;31;8;0;ITG;ITG2;20;Sardegna;39.21531192;9.110616306;320;25;345;13600;13945;-57;56;25246;1072;40263;703892;507953
2021-02-15;CAM;5472;2516;2956;5148;175;149;0;ITF;ITF3;15;Campania;40.83956555;14.25084984;1281;107;1388;67668;69056;62;966;170804;4022;243882;2679393;1877897
2021-02-15;LOM;9067;3173;5894;8406;487;174;0;ITC;ITC4;3;Lombardia;45.46679409;9.190347404;3572;366;3938;44692;48630;-1987;945;487577;27816;564023;6125323;2963592
2021-02-15;UMB;1367;692;675;1364;1;2;0;ITI;ITI2;10;Umbria;43.10675841;12.38824698;448;83;531;7551;8082;204;346;31691;894;40667;725122;300464
2021-02-15;SIC;3777;1769;2008;3137;564;76;0;ITG;ITG1;19;Sicilia;38.11569725;13.362356699999998;1035;165;1200;33349;34549;-317;332;107658;3869;146076;2134318;1063740
2021-02-15;PAT;547;193;354;419;126;2;0;ITH;ITH2;4;Provincia Autonoma Trento;46.06893511;11.12123097;164;26;190;2599;2789;76;167;26365;1177;30331;568411;165709
2021-02-15;VEN;4392;1827;2565;4143;240;9;0;ITH;ITH3;5;Veneto;45.43490485;12.33845213;929;110;1039;23771;24810;-4;241;287397;9509;321716;4582065;1359987
2021-02-15;ABR;1794;832;962;1735;42;17;0;ITF;ITF1;13;Abruzzo;42.35122196;13.39843823;547;52;599;11049;11648;215;222;34560;1563;47771;828505;430322
2021-02-15;PAB;72;42;30;23;46;3;0;ITH;ITH1;4;Provincia Autonoma Bolzano / Bozen;46.49933453;11.35662422;255;40;295;8063;8358;-53;395;39271;943;48572;609106;190126
2021-02-15;PUG;3271;1273;1998;2602;624;45;0;ITF;ITF4;16;Puglia;41.12559576;16.86736689;1345;159;1504;38960;40464;-1190;345;91416;3621;135501;1438375;810912
2021-02-15;TOS;8865;3407;5458;7865;828;172;0;ITI;ITI1;9;Toscana;43.76923077;11.25588885;713;132;845;11491;12336;171;428;127018;4449;143803;2465755;1308159
2021-02-15;MOL;145;70;75;142;3;0;0;ITF;ITF2;14;Molise;41.55774754;14.65916051;64;8;72;1460;1532;31;107;7463;303;9298;147578;133476
2021-02-15;CAL;1185;569;616;1015;165;5;0;ITF;ITF6;18;Calabria;38.90597598;16.59440194;195;22;217;6529;6746;-6;128;28169;649;35564;555254;524810
2021-02-15;MAR;967;412;555;939;13;15;0;ITI;ITI3;11;Marche;43.61675973;13.5188753;537;83;620;7524;8144;14;128;50676;2116;60936;758190;458293
2021-02-15;LIG;2265;840;1425;1853;400;12;0;ITC;ITC3;7;Liguria;44.41149315;8.9326992;594;61;655;4396;5051;36;194;65436;3522;74009;947699;406743
2021-02-16;LIG;2431;958;1473;1996;430;5;0;ITC;ITC3;7;Liguria;44.41149315;8.9326992;587;59;646;4314;4960;-91;221;65738;3532;74230;954434;409345
2021-02-16;LOM;9536;3081;6455;8982;454;100;0;ITC;ITC4;3;Lombardia;45.46679409;9.190347404;3693;373;4066;44607;48673;43;1696;489192;27854;565719;6155169;2971445
2021-02-16;PAT;676;248;428;660;5;11;0;ITH;ITH2;4;Provincia Autonoma Trento;46.06893511;11.12123097;174;27;201;2482;2683;-106;26;26495;1179;30357;569057;165866
2021-02-16;VEN;6644;2870;3774;6440;176;28;0;ITH;ITH3;5;Veneto;45.43490485;12.33845213;893;102;995;23258;24253;-557;638;288550;9551;322354;4617095;1362585
2021-02-16;MOL;159;73;86;152;6;1;0;ITF;ITF2;14;Molise;41.55774754;14.65916051;66;8;74;1469;1543;11;73;7522;306;9371;148581;134356
2021-02-16;TOS;9372;3367;6005;8420;721;231;0;ITI;ITI1;9;Toscana;43.76923077;11.25588885;718;133;851;11460;12311;-25;444;127472;4464;144247;2483037;1315677
2021-02-16;PUG;3395;1457;1938;2714;649;32;0;ITF;ITF4;16;Puglia;41.12559576;16.86736689;1324;156;1480;37708;39188;-1276;694;93352;3655;136195;1448475;815496
2021-02-16;BAS;908;377;531;791;98;19;0;ITF;ITF5;17;Basilicata;40.63947052;15.80514834;72;7;79;3381;3460;25;80;10546;354;14360;230455;137183
2021-02-16;ABR;1916;842;1074;1891;12;13;0;ITF;ITF1;13;Abruzzo;42.35122196;13.39843823;537;57;594;11383;11977;329;533;34747;1575;48299;852876;444845
2021-02-16;MAR;1287;475;812;1225;30;32;0;ITI;ITI3;11;Marche;43.61675973;13.5188753;535;80;615;7390;8005;-139;277;51088;2120;61213;763152;461288
2021-02-16;SAR;704;291;413;667;27;10;0;ITG;ITG2;20;Sardegna;39.21531192;9.110616306;311;24;335;13491;13826;-119;66;25424;1079;40329;707233;510206
2021-02-16;PAB;530;205;325;529;0;1;0;ITH;ITH1;4;Provincia Autonoma Bolzano / Bozen;46.49933453;11.35662422;258;39;297;8034;8331;-27;212;39507;946;48784;611273;190530
2021-02-16;SIC;4200;2208;1992;3663;467;70;0;ITG;ITG1;19;Sicilia;38.11569725;13.362356699999998;1005;158;1163;33317;34480;-69;625;108330;3891;146701;2157186;1069402
2021-02-16;EMR;5775;2448;3327;5231;530;14;0;ITH;ITH5;8;Emilia-Romagna;44.49436681;11.341720800000001;1975;175;2150;34887;37037;-533;968;190855;10182;238074;3483700;1431653
2021-02-16;CAM;5471;2431;3040;4498;787;186;0;ITF;ITF3;15;Campania;40.83956555;14.25084984;1284;106;1390;67590;68980;-76;1135;171998;4039;245017;2693549;1884395
2021-02-16;CAL;1756;746;1010;1469;281;6;0;ITF;ITF6;18;Calabria;38.90597598;16.59440194;197;20;217;6443;6660;-86;121;28375;650;35685;557425;526830
2021-02-16;LAZ;8446;4111;4335;7712;634;100;0;ITI;ITI4;12;Lazio;41.89277044;12.48366722;2065;253;2318;34943;37261;-1169;894;178160;5538;220959;3752570;2640182
2021-02-16;FVG;2521;1139;1382;2399;118;4;0;ITH;ITH4;6;Friuli-Venezia Giulia;45.6494354;13.76813649;396;60;456;9015;9471;-288;260;60262;2715;72448;1255791;452012
2021-02-16;PIE;3992;1770;2222;3180;765;47;0;ITC;ITC1;1;Piemonte;45.0732745;7.680687483;1900;141;2041;10185;12226;-100;771;213207;9182;234615;2338854;1176960
2021-02-16;VDA;329;53;276;317;6;6;0;ITC;ITC2;2;Valle d'Aosta / Vallée d'Aoste;45.73750286;7.320149366;13;2;15;122;137;-4;5;7359;413;7909;73785;42639
2021-02-16;UMB;1308;655;653;1299;9;0;0;ITI;ITI2;10;Umbria;43.10675841;12.38824698;451;84;535;7631;8166;84;292;31889;904;40959;731666;301617
2021-02-17;VDA;329;146;183;225;101;3;0;ITC;ITC2;2;Valle d'Aosta / Vallée d'Aoste;45.73750286;7.320149366;10;2;12;126;138;1;9;7367;413;7918;73934;42663
2021-02-17;BAS;1137;493;644;1058;77;2;0;ITF;ITF5;17;Basilicata;40.63947052;15.80514834;72;7;79;3374;3453;-7;85;10633;359;14445;232055;137928
2021-02-17;LAZ;9242;4631;4611;8272;900;70;0;ITI;ITI4;12;Lazio;41.89277044;12.48366722;2044;239;2283;34324;36607;-654;871;179630;5593;221830;3781008;2656049
2021-02-17;CAL;1880;834;1046;1650;213;17;0;ITF;ITF6;18;Calabria;38.90597598;16.59440194;179;18;197;6334;6531;-129;170;28667;657;35855;559992;529107
2021-02-17;ABR;2071;948;1123;1780;282;9;0;ITF;ITF1;13;Abruzzo;42.35122196;13.39843823;535;64;599;11705;12304;327;493;34905;1582;48791;862998;448769
2021-02-17;UMB;1619;748;871;1266;352;1;0;ITI;ITI2;10;Umbria;43.10675841;12.38824698;464;84;548;7604;8152;-14;109;32005;911;41068;732898;301786
2021-02-17;SIC;5222;3204;2018;4499;670;53;0;ITG;ITG1;19;Sicilia;38.11569725;13.362356699999998;961;154;1115;32540;33655;-825;484;109615;3915;147185;2180980;1075049
2021-02-17;PAT;1175;450;725;1058;112;5;0;ITH;ITH2;4;Provincia Autonoma Trento;46.06893511;11.12123097;168;27;195;2522;2717;34;195;26652;1183;30552;571258;166147
2021-02-17;FVG;2368;1008;1360;1873;492;3;0;ITH;ITH4;6;Friuli-Venezia Giulia;45.6494354;13.76813649;384;59;443;8969;9412;-59;333;60647;2722;72781;1265663;454819
2021-02-17;PIE;4821;2173;2648;3767;991;63;0;ITC;ITC1;1;Piemonte;45.0732745;7.680687483;1875;138;2013;10154;12167;-59;959;214203;9204;235574;2361005;1184276
2021-02-17;SAR;1419;582;837;1281;74;64;0;ITG;ITG2;20;Sardegna;39.21531192;9.110616306;302;29;331;13327;13658;-168;109;25692;1088;40438;709892;512435
2021-02-17;PAB;156;51;105;139;17;0;0;ITH;ITH1;4;Provincia Autonoma Bolzano / Bozen;46.49933453;11.35662422;254;39;293;7656;7949;-382;564;40448;951;49348;623502;190893
2021-02-17;PUG;4299;1756;2543;3618;641;40;0;ITF;ITF4;16;Puglia;41.12559576;16.86736689;1314;156;1470;36564;38034;-1154;883;95372;3672;137078;1458849;819456
2021-02-17;LOM;12041;3780;8261;10451;1392;198;0;ITC;ITC4;3;Lombardia;45.46679409;9.190347404;3740;363;4103;44590;48693;20;1764;490907;27883;567483;6193465;2980514
2021-02-17;CAM;7419;3229;4190;6210;1073;136;0;ITF;ITF3;15;Campania;40.83956555;14.25084984;1301;107;1408;68271;69679;699;1575;172860;4053;246592;2714018;1896847
2021-02-17;LIG;2701;1185;1516;2254;435;12;0;ITC;ITC3;7;Liguria;44.41149315;8.9326992;569;60;629;4227;4856;-104;309;66140;3543;74539;962220;412417
2021-02-17;MAR;1828;701;1127;1642;118;68;0;ITI;ITI3;11;Marche;43.61675973;13.5188753;534;78;612;7543;8155;150;471;51394;2135;61684;769043;464771
2021-02-17;EMR;6545;2766;3779;5758;774;13;0;ITH;ITH5;8;Emilia-Romagna;44.49436681;11.341720800000001;1902;176;2078;33190;35268;-1769;1025;193610;10213;239091;3511647;1437392
2021-02-17;TOS;8229;3194;5035;7350;754;125;0;ITI;ITI1;9;Toscana;43.76923077;11.25588885;699;137;836;11560;12396;85;773;128138;4486;145020;2503762;1325740
2021-02-17;VEN;6022;2772;3250;5900;94;28;0;ITH;ITH3;5;Veneto;45.43490485;12.33845213;875;97;972;22406;23378;-875;492;289847;9621;322846;4656125;1365422
2021-02-17;MOL;73;33;40;50;15;8;0;ITF;ITF2;14;Molise;41.55774754;14.65916051;69;9;78;1507;1585;42;112;7590;308;9483;150003;135627
2021-02-18;LAZ;10120;5037;5083;9111;895;114;0;ITI;ITI4;12;Lazio;41.89277044;12.48366722;1945;232;2177;33461;35638;-969;1025;181583;5634;222855;3810949;2673149
2021-02-18;EMR;7049;2895;4154;6442;591;16;0;ITH;ITH5;8;Emilia-Romagna;44.49436681;11.341720800000001;1890;181;2071;32858;34929;-339;1565;195486;10235;240650;3541280;1443179
2021-02-18;FVG;3232;1503;1729;2804;410;18;0;ITH;ITH4;6;Friuli-Venezia Giulia;45.6494354;13.76813649;361;58;419;8991;9410;-2;262;60900;2733;73043;1273548;457337
2021-02-18;CAL;1893;879;1014;1640;234;19;0;ITF;ITF6;18;Calabria;38.90597598;16.59440194;173;20;193;6272;6465;-66;166;28897;659;36021;562061;531096
2021-02-18;LOM;14067;4932;9135;12828;1039;200;0;ITC;ITC4;3;Lombardia;45.46679409;9.190347404;3716;368;4084;45889;49973;1280;2540;492112;27938;570023;6235973;2992098
2021-02-18;SAR;1898;738;1160;1794;64;40;0;ITG;ITG2;20;Sardegna;39.21531192;9.110616306;295;25;320;13182;13502;-156;100;25940;1096;40538;712437;513913
2021-02-18;TOS;8875;3302;5573;7793;898;184;0;ITI;ITI1;9;Toscana;43.76923077;11.25588885;717;144;861;11942;12803;407;956;128676;4497;145976;2524789;1337126
2021-02-18;PIE;4822;2115;2707;4305;429;88;0;ITC;ITC1;1;Piemonte;45.0732745;7.680687483;1866;128;1994;10012;12006;-161;501;214849;9220;236075;2375443;1187837
2021-02-18;SIC;5342;3148;2194;4843;431;68;0;ITG;ITG1;19;Sicilia;38.11569725;13.362356699999998;930;145;1075;31929;33004;-651;480;110720;3941;147665;2205754;1080729
2021-02-18;UMB;1497;583;914;1029;467;1;0;ITI;ITI2;10;Umbria;43.10675841;12.38824698;463;84;547;7738;8285;133;233;32094;922;41301;741016;302914
2021-02-18;LIG;2772;1128;1644;2425;339;8;0;ITC;ITC3;7;Liguria;44.41149315;8.9326992;541;59;600;4210;4810;-46;334;66519;3544;74873;969946;415469
2021-02-18;CAM;9110;3833;5277;8146;727;237;0;ITF;ITF3;15;Campania;40.83956555;14.25084984;1290;110;1400;67782;69182;-497;1573;174901;4082;248165;2733904;1909854
2021-02-18;MAR;2146;787;1359;1806;288;52;0;ITI;ITI3;11;Marche;43.61675973;13.5188753;520;79;599;7757;8356;201;532;51708;2152;62216;776442;469765
2021-02-18;VEN;5833;2456;3377;5730;64;39;0;ITH;ITH3;5;Veneto;45.43490485;12.33845213;830;98;928;21058;21986;-1392;1042;292251;9651;323888;4689379;1368822
2021-02-18;MOL;325;74;251;308;13;4;0;ITF;ITF2;14;Molise;41.55774754;14.65916051;74;11;85;1481;1566;-19;41;7648;310;9524;150395;135968
2021-02-18;PUG;4390;1850;2540;3718;610;62;0;ITF;ITF4;16;Puglia;41.12559576;16.86736689;1283;159;1442;34287;35729;-2305;844;98484;3709;137922;1468882;823608
2021-02-18;ABR;2292;934;1358;2142;133;17;0;ITF;ITF1;13;Abruzzo;42.35122196;13.39843823;551;63;614;11593;12207;-97;438;35434;1588;49229;872817;452963
2021-02-18;BAS;1076;405;671;856;217;3;0;ITF;ITF5;17;Basilicata;40.63947052;15.80514834;73;6;79;3395;3474;21;111;10723;359;14556;233380;138743
2021-02-18;PAB;1838;457;1381;1810;7;21;0;ITH;ITH1;4;Provincia Autonoma Bolzano / Bozen;46.49933453;11.35662422;254;39;293;7519;7812;-137;450;41030;956;49798;632885;191540
2021-02-18;VDA;349;153;196;256;88;5;0;ITC;ITC2;2;Valle d'Aosta / Vallée d'Aoste;45.73750286;7.320149366;8;2;10;116;126;-12;4;7383;413;7922;74226;42787
2021-02-18;PAT;1437;505;932;1350;69;18;0;ITH;ITH2;4;Provincia Autonoma Trento;46.06893511;11.12123097;162;26;188;2599;2787;70;311;26889;1187;30863;575045;166571
2021-02-19;MOL;171;95;76;169;2;0;0;ITF;ITF2;14;Molise;41.55774754;14.65916051;80;11;91;1423;1514;-52;7;7703;314;9531;150753;136259
2021-02-19;MAR;2002;739;1263;1826;135;41;0;ITI;ITI3;11;Marche;43.61675973;13.5188753;524;82;606;7895;8501;145;488;52034;2169;62704;781587;472892
2021-02-19;PAB;2252;512;1740;2193;11;48;0;ITH;ITH1;4;Provincia Autonoma Bolzano / Bozen;46.49933453;11.35662422;253;37;290;7563;7853;41;478;41462;961;50276;644717;192208
2021-02-19;PUG;4762;2030;2732;4314;393;55;0;ITF;ITF4;16;Puglia;41.12559576;16.86736689;1261;163;1424;31906;33330;-2399;874;101730;3736;138796;1478023;827529
2021-02-19;VDA;292;102;190;267;24;1;0;ITC;ITC2;2;Valle d'Aosta / Vallée d'Aoste;45.73750286;7.320149366;8;2;10;121;131;5;14;7392;413;7936;74548;42882
2021-02-19;UMB;743;293;450;525;217;1;0;ITI;ITI2;10;Umbria;43.10675841;12.38824698;471;83;554;7877;8431;146;438;32375;933;41739;749120;304193
2021-02-19;SIC;4982;2696;2286;4331;564;87;0;ITG;ITG1;19;Sicilia;38.11569725;13.362356699999998;884;150;1034;30535;31569;-1435;440;112573;3963;148105;2228960;1086166
2021-02-19;FVG;3370;1382;1988;2857;496;17;0;ITH;ITH4;6;Friuli-Venezia Giulia;45.6494354;13.76813649;349;56;405;8956;9361;-49;310;61244;2748;73353;1281941;459555
2021-02-19;PIE;5565;2188;3377;4936;504;125;0;ITC;ITC1;1;Piemonte;45.0732745;7.680687483;1849;130;1979;10458;12437;431;1307;215700;9245;237382;2403012;1195422
2021-02-19;CAL;1521;689;832;1248;264;9;0;ITF;ITF6;18;Calabria;38.90597598;16.59440194;173;15;188;6312;6500;35;177;29035;663;36198;564151;533084
2021-02-19;LIG;3226;1309;1917;3035;177;14;0;ITC;ITC3;7;Liguria;44.41149315;8.9326992;523;58;581;4251;4832;22;274;66756;3559;75147;976976;418181
2021-02-19;VEN;7324;3141;4183;6996;204;124;0;ITH;ITH3;5;Veneto;45.43490485;12.33845213;790;98;888;20599;21487;-499;657;293375;9683;324545;4716720;1368822
2021-02-19;PAT;945;366;579;847;65;33;0;ITH;ITH2;4;Provincia Autonoma Trento;46.06893511;11.12123097;172;27;199;2700;2899;112;292;27067;1189;31155;578565;166877
2021-02-19;TOS;8348;2969;5379;7655;513;180;0;ITI;ITI1;9;Toscana;43.76923077;11.25588885;723;149;872;12338;13210;407;924;129174;4516;146900;2547014;1348205
2021-02-19;EMR;7330;3012;4318;6802;514;14;0;ITH;ITH5;8;Emilia-Romagna;44.49436681;11.341720800000001;1902;183;2085;32852;34937;8;1821;197244;10281;242462;3571996;1448201
2021-02-19;ABR;3300;1551;1749;3161;100;39;0;ITF;ITF1;13;Abruzzo;42.35122196;13.39843823;552;70;622;11686;12308;101;482;35803;1599;49710;882711;457272
2021-02-19;BAS;1627;739;888;1559;63;5;0;ITF;ITF5;17;Basilicata;40.63947052;15.80514834;77;4;81;3454;3535;61;136;10795;362;14692;235066;139752
2021-02-19;SAR;1521;477;1044;1416;56;49;0;ITG;ITG2;20;Sardegna;39.21531192;9.110616306;282;27;309;13020;13329;-173;44;26151;1102;40582;715073;515803
2021-02-19;CAM;9588;3569;6019;8681;662;245;0;ITF;ITF3;15;Campania;40.83956555;14.25084984;1313;110;1423;67806;69229;47;1616;176457;4095;249781;2753612;1921145
2021-02-19;LAZ;10144;5129;5015;9085;903;156;0;ITI;ITI4;12;Lazio;41.89277044;12.48366722;1925;231;2156;33452;35608;-30;990;182565;5672;223845;3839816;2689445
2021-02-19;LOM;14235;5404;8831;13328;729;178;0;ITC;ITC4;3;Lombardia;45.46679409;9.190347404;3733;373;4106;47683;51789;1816;3724;493987;27971;573747;6287867;3007961
2021-02-20;UMB;283;101;182;259;24;0;0;ITI;ITI2;10;Umbria;43.10675841;12.38824698;469;85;554;7864;8418;-13;319;32692;948;42058;756403;305182
2021-02-20;CAL;1522;791;731;1180;328;14;0;ITF;ITF6;18;Calabria;38.90597598;16.59440194;163;15;178;6420;6598;98;218;29153;665;36416;566590;535040
2021-02-20;LAZ;9247;4289;4958;8379;796;72;0;ITI;ITI4;12;Lazio;41.89277044;12.48366722;1883;228;2111;33335;35446;-162;921;183616;5704;224766;3871085;2707237
2021-02-20;VEN;6433;2019;4414;6277;75;81;0;ITH;ITH3;5;Veneto;45.43490485;12.33845213;772;100;872;20915;21787;300;1244;294301;9701;325789;4760865;1372199
2021-02-20;CAM;8573;3080;5493;8087;303;183;0;ITF;ITF3;15;Campania;40.83956555;14.25084984;1289;112;1401;68951;70352;1123;1677;177000;4106;251458;2774505;1935326
2021-02-20;EMR;5320;2094;3226;5050;263;7;0;ITH;ITH5;8;Emilia-Romagna;44.49436681;11.341720800000001;1899;176;2075;33058;35133;196;1724;198733;10304;244170;3603939;1454701
2021-02-20;TOS;4724;1815;2909;4051;537;136;0;ITI;ITI1;9;Toscana;43.76923077;11.25588885;746;147;893;12844;13737;527;953;129585;4531;147853;2568586;1359653
2021-02-20;SIC;7171;3707;3464;6802;272;97;0;ITG;ITG1;19;Sicilia;38.11569725;13.362356699999998;862;145;1007;28899;29906;-1663;474;114692;3981;148579;2252267;1090761
2021-02-20;PAT;412;247;165;124;287;1;0;ITH;ITH2;4;Provincia Autonoma Trento;46.06893511;11.12123097;172;25;197;2687;2884;-15;256;27334;1193;31411;581938;167207
2021-02-20;LOM;9377;3877;5500;8847;333;197;0;ITC;ITC4;3;Lombardia;45.46679409;9.190347404;3722;382;4104;49261;53365;1576;3019;495393;28008;576766;6331879;3021909
2021-02-20;LIG;1338;639;699;1335;1;2;0;ITC;ITC3;7;Liguria;44.41149315;8.9326992;509;53;562;4275;4837;5;361;67102;3569;75508;983717;420762
2021-02-20;MOL;1022;444;578;1002;20;0;0;ITF;ITF2;14;Molise;41.55774754;14.65916051;77;12;89;1465;1554;40;120;7778;319;9651;152150;137465
2021-02-20;SAR;2044;856;1188;1683;337;24;0;ITG;ITG2;20;Sardegna;39.21531192;9.110616306;277;29;306;12974;13280;-49;73;26266;1109;40655;717300;517658
2021-02-20;FVG;2081;942;1139;1934;144;3;0;ITH;ITH4;6;Friuli-Venezia Giulia;45.6494354;13.76813649;348;60;408;8844;9252;-109;326;61671;2756;73679;1291733;462473
2021-02-20;PIE;3850;1265;2585;3573;174;103;0;ITC;ITC1;1;Piemonte;45.0732745;7.680687483;1857;130;1987;10621;12608;171;765;216282;9257;238147;2423607;1201114
2021-02-20;VDA;257;215;42;244;10;3;0;ITC;ITC2;2;Valle d'Aosta / Vallée d'Aoste;45.73750286;7.320149366;10;2;12;124;136;5;11;7398;413;7947;74831;42980
2021-02-20;BAS;1169;536;633;1050;119;0;0;ITF;ITF5;17;Basilicata;40.63947052;15.80514834;79;4;83;3463;3546;11;88;10870;364;14780;236564;140512
2021-02-20;MAR;4163;1732;2431;4042;111;10;0;ITI;ITI3;11;Marche;43.61675973;13.5188753;532;80;612;8081;8693;192;547;52381;2177;63251;787557;476674
2021-02-20;ABR;4777;1844;2933;4657;76;44;0;ITF;ITF1;13;Abruzzo;42.35122196;13.39843823;546;73;619;11758;12377;69;494;36219;1608;50204;889920;459742
2021-02-20;PUG;2978;1079;1899;2688;257;33;0;ITF;ITF4;16;Puglia;41.12559576;16.86736689;1251;164;1415;31669;33084;-246;905;102858;3759;139701;1487903;831381
2021-02-20;PAB;1802;540;1262;1755;18;29;0;ITH;ITH1;4;Provincia Autonoma Bolzano / Bozen;46.49933453;11.35662422;254;36;290;6988;7278;-575;524;42552;970;50800;654963;192795
2021-02-21;PUG;2178;475;1703;2064;63;51;0;ITF;ITF4;16;Puglia;41.12559576;16.86736689;1262;169;1431;31767;33198;114;758;103496;3765;140459;1494986;833064
2021-02-21;MAR;376;141;235;363;1;12;0;ITI;ITI3;11;Marche;43.61675973;13.5188753;531;75;606;8306;8912;219;488;52643;2184;63739;793433;480761
2021-02-21;LIG;868;490;378;862;4;2;0;ITC;ITC3;7;Liguria;44.41149315;8.9326992;516;54;570;4320;4890;53;266;67311;3573;75774;988266;422561
2021-02-21;MOL;577;228;349;575;2;0;0;ITF;ITF2;14;Molise;41.55774754;14.65916051;77;12;89;1531;1620;66;149;7858;322;9800;153353;138593
2021-02-21;EMR;4451;1708;2743;4001;440;10;0;ITH;ITH5;8;Emilia-Romagna;44.49436681;11.341720800000001;1939;184;2123;33905;36028;895;1852;199647;10345;246020;3624288;1460142
2021-02-21;FVG;805;282;523;421;382;2;0;ITH;ITH4;6;Friuli-Venezia Giulia;45.6494354;13.76813649;350;57;407;8867;9274;22;284;61925;2764;73963;1296872;464049
2021-02-21;ABR;1219;550;669;1192;1;26;0;ITF;ITF1;13;Abruzzo;42.35122196;13.39843823;567;75;642;11841;12483;106;387;36497;1610;50590;898728;463490
2021-02-21;VDA;18;3;15;0;18;0;0;ITC;ITC2;2;Valle d'Aosta / Vallée d'Aoste;45.73750286;7.320149366;9;2;11;122;133;-3;8;7409;413;7955;75155;43154
2021-02-21;PIE;5105;2091;3014;4951;104;50;0;ITC;ITC1;1;Piemonte;45.0732745;7.680687483;1868;138;2006;10814;12820;212;802;216864;9265;238949;2435595;1206701
2021-02-21;TOS;5164;2103;3061;4789;170;205;0;ITI;ITI1;9;Toscana;43.76923077;11.25588885;744;147;891;13324;14215;478;968;130060;4546;148821;2588263;1370971
2021-02-21;VEN;4640;1212;3428;4516;5;119;0;ITH;ITH3;5;Veneto;45.43490485;12.33845213;764;102;866;21219;22085;298;718;294710;9712;326507;4798655;1377232
2021-02-21;UMB;1;0;1;1;0;0;0;ITI;ITI2;10;Umbria;43.10675841;12.38824698;462;83;545;7894;8439;21;301;32961;959;42359;763845;306231
2021-02-21;PAT;158;95;63;44;114;0;0;ITH;ITH2;4;Provincia Autonoma Trento;46.06893511;11.12123097;162;27;189;2835;3024;140;312;27505;1194;31723;585615;167613
2021-02-21;CAL;674;308;366;594;79;1;0;ITF;ITF6;18;Calabria;38.90597598;16.59440194;167;16;183;6184;6367;-231;170;29553;666;36586;568373;536992
2021-02-21;BAS;284;113;171;284;0;0;0;ITF;ITF5;17;Basilicata;40.63947052;15.80514834;78;4;82;3496;3578;32;65;10902;365;14845;237670;141170
2021-02-21;CAM;5841;2242;3599;5487;228;126;0;ITF;ITF3;15;Campania;40.83956555;14.25084984;1300;120;1420;69874;71294;942;1658;177702;4120;253116;2794759;1948853
2021-02-21;LAZ;7001;3184;3817;6482;468;51;0;ITI;ITI4;12;Lazio;41.89277044;12.48366722;1859;234;2093;33346;35439;-7;1048;184656;5719;225814;3895727;2721141
2021-02-21;SAR;1589;709;880;1558;30;1;0;ITG;ITG2;20;Sardegna;39.21531192;9.110616306;275;26;301;12907;13208;-72;33;26367;1113;40688;718833;518935
2021-02-21;LOM;5055;1864;3191;4940;17;98;0;ITC;ITC4;3;Lombardia;45.46679409;9.190347404;3741;386;4127;50918;55045;1680;2514;496177;28058;579280;6365027;3033240
2021-02-21;SIC;5169;2501;2668;5044;107;18;0;ITG;ITG1;19;Sicilia;38.11569725;13.362356699999998;846;143;989;28191;29180;-726;411;115811;3999;148990;2272179;1095427
2021-02-22;ABR;2641;1174;1467;2584;30;27;0;ITF;ITF1;13;Abruzzo;42.35122196;13.39843823;586;76;662;12262;12924;441;503;36549;1620;51093;918825;473253
2021-02-22;BAS;1799;778;1021;1737;53;9;0;ITF;ITF5;17;Basilicata;40.63947052;15.80514834;80;4;84;3505;3589;11;41;10929;368;14886;238294;141395
2021-02-22;VDA;318;95;223;212;104;2;0;ITC;ITC2;2;Valle d'Aosta / Vallée d'Aoste;45.73750286;7.320149366;8;1;9;125;134;1;4;7411;414;7959;75407;43273
2021-02-22;SAR;1652;955;697;1392;234;26;0;ITG;ITG2;20;Sardegna;39.21531192;9.110616306;264;27;291;12871;13162;-46;77;26485;1118;40765;744236;519835
2021-02-22;CAM;10699;3298;7401;10150;279;270;0;ITF;ITF3;15;Campania;40.83956555;14.25084984;1319;125;1444;69808;71252;-42;1202;178925;4141;254318;2805856;1955767
2021-02-22;CAL;2110;1076;1034;1539;562;9;0;ITF;ITF6;18;Calabria;38.90597598;16.59440194;176;19;195;6147;6342;-25;118;29695;667;36704;569685;537967
2021-02-22;PIE;8508;3476;5032;7807;595;106;0;ITC;ITC1;1;Piemonte;45.0732745;7.680687483;1905;141;2046;10874;12920;100;639;217381;9287;239588;2446789;1210042
2021-02-22;UMB;1892;807;1085;1806;86;0;0;ITI;ITI2;10;Umbria;43.10675841;12.38824698;459;86;545;7975;8520;81;363;33230;972;42722;768574;307175
2021-02-22;FVG;2495;1199;1296;2070;420;5;0;ITH;ITH4;6;Friuli-Venezia Giulia;45.6494354;13.76813649;350;56;406;8885;9291;17;145;62042;2775;74108;1299729;464867
2021-02-22;LIG;3349;1479;1870;3197;143;9;0;ITC;ITC3;7;Liguria;44.41149315;8.9326992;515;56;571;4427;4998;108;136;67328;3584;75910;991704;423907
2021-02-22;LOM;11958;4825;7133;11449;310;199;0;ITC;ITC4;3;Lombardia;45.46679409;9.190347404;3826;391;4217;49152;53369;-1676;1491;499299;28103;580771;6382898;3039913
2021-02-22;MAR;3461;1532;1929;3351;75;35;0;ITI;ITI3;11;Marche;43.61675973;13.5188753;543;78;621;8288;8909;-3;117;52752;2195;63856;794480;481285
2021-02-22;PAT;755;262;493;663;86;6;0;ITH;ITH2;4;Provincia Autonoma Trento;46.06893511;11.12123097;167;29;196;2913;3109;85;259;27679;1194;31982;588274;167949
2021-02-22;SIC;7948;4132;3816;7369;493;86;0;ITG;ITG1;19;Sicilia;38.11569725;13.362356699999998;843;142;985;28382;29367;187;412;116017;4018;149402;2290737;1099845
2021-02-22;LAZ;11539;5038;6501;10817;558;164;0;ITI;ITI4;12;Lazio;41.89277044;12.48366722;1861;233;2094;33116;35210;-229;854;185715;5743;226668;3910343;2729147
2021-02-22;VEN;7018;3044;3974;6580;391;47;0;ITH;ITH3;5;Veneto;45.43490485;12.33845213;772;103;875;21409;22284;199;509;295011;9721;327016;4808969;1378883
2021-02-22;EMR;7487;3094;4393;7201;273;13;0;ITH;ITH5;8;Emilia-Romagna;44.49436681;11.341720800000001;2017;194;2211;34305;36516;488;1847;200972;10368;247856;3636600;1463743
2021-02-22;PUG;9662;4542;5120;9234;337;91;0;ITF;ITF4;16;Puglia;41.12559576;16.86736689;1282;160;1442;31253;32695;-503;343;104325;3782;140802;1499147;835594
2021-02-22;PAB;527;143;384;497;12;18;0;ITH;ITH1;4;Provincia Autonoma Bolzano / Bozen;46.49933453;11.35662422;249;36;285;6846;7131;-147;477;43172;974;51277;666158;193455
2021-02-22;TOS;9891;4276;5615;9236;277;378;0;ITI;ITI1;9;Toscana;43.76923077;11.25588885;797;155;952;13835;14787;572;911;130383;4562;149732;2599096;1377334
2021-02-22;MOL;267;129;138;250;15;2;0;ITF;ITF2;14;Molise;41.55774754;14.65916051;80;11;91;1592;1683;63;114;7904;327;9914;154240;139428
2021-02-23;VEN;7384;3253;4131;7028;270;86;0;ITH;ITH3;5;Veneto;45.43490485;12.33845213;806;105;911;21386;22297;13;1062;296039;9742;328078;4846574;1381843
2021-02-23;PAT;1128;403;725;887;218;23;0;ITH;ITH2;4;Provincia Autonoma Trento;46.06893511;11.12123097;175;30;205;2788;2993;-116;60;27853;1196;32042;589181;168163
2021-02-23;LOM;11835;4807;7028;11290;332;213;0;ITC;ITC4;3;Lombardia;45.46679409;9.190347404;3917;408;4325;50390;54715;1346;2480;500390;28146;583251;6418047;3049391
2021-02-23;TOS;7755;3337;4418;7241;162;352;0;ITI;ITI1;9;Toscana;43.76923077;11.25588885;824;159;983;14138;15121;334;824;130853;4582;150556;2618821;1386367
2021-02-23;LIG;3809;1559;2250;3663;109;37;0;ITC;ITC3;7;Liguria;44.41149315;8.9326992;498;53;551;4316;4867;-131;381;67827;3597;76291;999439;427053
2021-02-23;FVG;2655;1282;1373;2467;181;7;0;ITH;ITH4;6;Friuli-Venezia Giulia;45.6494354;13.76813649;353;57;410;8761;9171;-120;241;62386;2792;74349;1309050;467090
2021-02-23;SIC;8785;4667;4118;8229;468;88;0;ITG;ITG1;19;Sicilia;38.11569725;13.362356699999998;818;135;953;27704;28657;-710;452;117158;4039;149854;2315916;1104845
2021-02-23;SAR;1579;1052;527;1280;282;17;0;ITG;ITG2;20;Sardegna;39.21531192;9.110616306;247;24;271;12816;13087;-75;47;26600;1125;40812;746694;521897
2021-02-23;PAB;769;324;445;760;6;3;0;ITH;ITH1;4;Provincia Autonoma Bolzano / Bozen;46.49933453;11.35662422;246;36;282;6677;6959;-172;313;43651;980;51590;672688;193983
2021-02-23;PIE;9287;3743;5544;8520;590;177;0;ITC;ITC1;1;Piemonte;45.0732745;7.680687483;1919;145;2064;11041;13105;185;1023;218197;9309;240611;2468673;1217712
2021-02-23;MOL;586;223;363;362;221;3;0;ITF;ITF2;14;Molise;41.55774754;14.65916051;91;13;104;1603;1707;24;93;7969;331;10007;155374;140464
2021-02-23;MAR;3314;1432;1882;3243;56;15;0;ITI;ITI3;11;Marche;43.61675973;13.5188753;555;78;633;8491;9124;215;581;53109;2204;64437;801796;486227
2021-02-23;BAS;1912;773;1139;1753;141;18;0;ITF;ITF5;17;Basilicata;40.63947052;15.80514834;79;5;84;3608;3692;103;151;10977;368;15037;243750;142341
2021-02-23;ABR;2779;1273;1506;2753;11;15;0;ITF;ITF1;13;Abruzzo;42.35122196;13.39843823;593;76;669;12304;12973;49;351;36841;1628;51442;933593;480727
2021-02-23;PUG;9404;4436;4968;8814;497;93;0;ITF;ITF4;16;Puglia;41.12559576;16.86736689;1265;164;1429;31013;32442;-253;823;105369;3814;141625;1511214;841295
2021-02-23;VDA;217;124;93;216;0;1;0;ITC;ITC2;2;Valle d'Aosta / Vallée d'Aoste;45.73750286;7.320149366;6;1;7;126;133;-1;5;7417;414;7964;75666;43399
2021-02-23;LAZ;11135;4802;6333;10214;787;134;0;ITI;ITI4;12;Lazio;41.89277044;12.48366722;1850;229;2079;32848;34927;-283;889;186854;5776;227557;3941971;2749305
2021-02-23;CAL;1620;766;854;1496;119;5;0;ITF;ITF6;18;Calabria;38.90597598;16.59440194;181;19;200;5998;6198;-144;116;29954;668;36820;571766;539962
2021-02-23;CAM;11020;3399;7621;10150;544;326;0;ITF;ITF3;15;Campania;40.83956555;14.25084984;1327;132;1459;69074;70533;-719;1436;181042;4179;255754;2820917;1959798
2021-02-23;EMR;8216;3218;4998;7818;386;12;0;ITH;ITH5;8;Emilia-Romagna;44.49436681;11.341720800000001;2043;196;2239;34486;36725;209;1588;202311;10393;249429;3671610;1468388
2021-02-23;UMB;1691;657;1034;1648;42;1;0;ITI;ITI2;10;Umbria;43.10675841;12.38824698;468;83;551;7997;8548;28;270;33461;983;42992;774186;308224
2021-02-24;BAS;1815;744;1071;1729;75;11;0;ITF;ITF5;17;Basilicata;40.63947052;15.80514834;82;5;87;3706;3793;101;166;11041;369;15203;245207;143249
2021-02-24;ABR;3306;1442;1864;3112;177;17;0;ITF;ITF1;13;Abruzzo;42.35122196;13.39843823;595;78;673;12150;12823;-150;322;37289;1652;51764;942013;483666
2021-02-24;VDA;185;84;101;163;21;1;0;ITC;ITC2;2;Valle d'Aosta / Vallée d'Aoste;45.73750286;7.320149366;6;1;7;139;146;13;14;7418;414;7978;75772;43431
2021-02-24;MOL;672;281;391;326;338;8;0;ITF;ITF2;14;Molise;41.55774754;14.65916051;91;14;105;1584;1689;-18;67;8052;333;10074;156374;141404
2021-02-24;EMR;9361;3568;5793;8458;887;16;0;ITH;ITH5;8;Emilia-Romagna;44.49436681;11.341720800000001;2025;201;2226;34545;36771;46;1427;203642;10426;250839;3713779;1474690
2021-02-24;LOM;14728;5961;8767;13575;958;195;0;ITC;ITC4;3;Lombardia;45.46679409;9.190347404;3946;406;4352;50873;55225;510;3310;503152;28184;586561;6468315;3061940
2021-02-24;PAB;1368;407;961;1320;12;36;0;ITH;ITH1;4;Provincia Autonoma Bolzano / Bozen;46.49933453;11.35662422;259;33;292;6632;6924;-35;183;43856;993;51773;679919;194278
2021-02-24;CAM;11810;4158;7652;10804;715;291;0;ITF;ITF3;15;Campania;40.83956555;14.25084984;1319;130;1449;70381;71830;1297;2185;181890;4219;257939;2842283;1973219
2021-02-24;PIE;11421;4620;6801;10762;505;154;0;ITC;ITC1;1;Piemonte;45.0732745;7.680687483;1911;152;2063;11554;13617;512;1453;219121;9326;242064;2490036;1225693
2021-02-24;UMB;1521;564;957;1506;15;0;0;ITI;ITI2;10;Umbria;43.10675841;12.38824698;475;81;556;7918;8474;-74;97;33622;993;43089;775431;308361
2021-02-24;SIC;9379;4803;4576;8701;567;111;0;ITG;ITG1;19;Sicilia;38.11569725;13.362356699999998;816;130;946;26744;27690;-967;542;118646;4060;150396;2342356;1109928
2021-02-24;SAR;2452;1313;1139;2212;196;44;0;ITG;ITG2;20;Sardegna;39.21531192;9.110616306;238;21;259;12712;12971;-116;65;26774;1132;40877;749112;523912
2021-02-24;PUG;10073;4719;5354;9378;597;98;0;ITF;ITF4;16;Puglia;41.12559576;16.86736689;1255;162;1417;30673;32090;-352;991;106688;3838;142616;1522139;845682
2021-02-24;LAZ;12133;5245;6888;10944;1054;135;0;ITI;ITI4;12;Lazio;41.89277044;12.48366722;1827;227;2054;32826;34880;-47;1188;188051;5814;228745;3978005;2769399
2021-02-24;FVG;2533;1093;1440;2504;18;11;0;ITH;ITH4;6;Friuli-Venezia Giulia;45.6494354;13.76813649;345;58;403;8914;9317;146;503;62733;2802;74852;1318662;470238
2021-02-24;PAT;1373;543;830;943;406;24;0;ITH;ITH2;4;Provincia Autonoma Trento;46.06893511;11.12123097;174;32;206;2786;2992;-1;232;28085;1197;32274;592138;168470
2021-02-24;CAL;1954;997;957;1468;480;6;0;ITF;ITF6;18;Calabria;38.90597598;16.59440194;180;19;199;5970;6169;-29;278;30258;671;37098;574228;542311
2021-02-24;MAR;3535;1548;1987;3425;78;32;0;ITI;ITI3;11;Marche;43.61675973;13.5188753;555;84;639;8724;9363;239;616;53481;2209;65053;807749;489703
2021-02-24;LIG;3769;1562;2207;3458;259;52;0;ITC;ITC3;7;Liguria;44.41149315;8.9326992;499;55;554;4353;4907;40;285;68061;3608;76576;1007146;429882
2021-02-24;TOS;10408;4489;5919;10070;198;140;0;ITI;ITI1;9;Toscana;43.76923077;11.25588885;842;163;1005;14400;15405;284;857;131409;4599;151413;2640019;1396362
2021-02-24;VEN;8623;3680;4943;7998;489;136;0;ITH;ITH3;5;Veneto;45.43490485;12.33845213;798;103;901;21431;22332;35;895;296878;9763;328973;4886528;1385155
2021-02-25;VEN;7904;3345;4559;7157;607;140;0;ITH;ITH3;5;Veneto;45.43490485;12.33845213;793;106;899;22050;22949;617;1304;297537;9791;330277;4932271;1389455
2021-02-25;SAR;2943;1276;1667;2298;608;37;0;ITG;ITG2;20;Sardegna;39.21531192;9.110616306;229;22;251;12641;12892;-79;80;26923;1142;40957;752668;525848
2021-02-25;UMB;1334;496;838;1274;52;8;0;ITI;ITI2;10;Umbria;43.10675841;12.38824698;473;79;552;7957;8509;35;262;33839;1003;43351;782676;309492
2021-02-25;CAM;12444;4487;7957;10938;1208;298;0;ITF;ITF3;15;Campania;40.83956555;14.25084984;1305;131;1436;71536;72972;1142;2385;183104;4248;260324;2865932;1988321
2021-02-25;SIC;9943;5210;4733;8686;1164;93;0;ITG;ITG1;19;Sicilia;38.11569725;13.362356699999998;799;131;930;26096;27026;-664;613;119908;4075;151009;2367543;1115332
2021-02-25;PIE;12303;5312;6991;11569;547;187;0;ITC;ITC1;1;Piemonte;45.0732745;7.680687483;1909;162;2071;12252;14323;706;1454;219849;9346;243518;2511427;1233224
2021-02-25;PAT;1656;649;1007;1200;446;10;0;ITH;ITH2;4;Provincia Autonoma Trento;46.06893511;11.12123097;170;35;205;2865;3070;78;357;28361;1200;32631;596262;168874
2021-02-25;EMR;9250;3498;5752;8272;955;23;0;ITH;ITH5;8;Emilia-Romagna;44.49436681;11.341720800000001;2058;203;2261;35432;37693;922;2090;204763;10459;252915;3754583;1481936
2021-02-25;CAL;2941;1583;1358;2296;605;40;0;ITF;ITF6;18;Calabria;38.90597598;16.59440194;186;17;203;5931;6134;-35;194;30484;674;37292;576682;544654
2021-02-25;LAZ;12844;5624;7220;11413;1223;208;0;ITI;ITI4;12;Lazio;41.89277044;12.48366722;1807;227;2034;32961;34995;115;1256;189174;5832;230001;4014576;2776834
2021-02-25;TOS;10648;4315;6333;9484;995;169;0;ITI;ITI1;9;Toscana;43.76923077;11.25588885;853;159;1012;15118;16130;725;1374;132044;4613;152787;2662754;1408946
2021-02-25;LIG;3461;1351;2110;3308;130;23;0;ITC;ITC3;7;Liguria;44.41149315;8.9326992;493;52;545;4530;5075;168;452;68338;3615;77028;1015161;432933
2021-02-25;LOM;15362;6371;8991;13534;1624;204;0;ITC;ITC4;3;Lombardia;45.46679409;9.190347404;4024;407;4431;53397;57828;2603;4243;504748;28228;590804;6519788;3077516
2021-02-25;MAR;3562;1465;2097;3318;181;63;0;ITI;ITI3;11;Marche;43.61675973;13.5188753;559;84;643;8967;9610;247;732;53956;2219;65785;815619;495328
2021-02-25;ABR;3055;1343;1712;2506;530;19;0;ITF;ITF1;13;Abruzzo;42.35122196;13.39843823;617;76;693;12027;12720;-103;535;37917;1662;52299;953486;488386
2021-02-25;PUG;12010;5077;6933;10688;1185;137;0;ITF;ITF4;16;Puglia;41.12559576;16.86736689;1253;165;1418;30554;31972;-118;1154;107933;3865;143770;1532395;849741
2021-02-25;MOL;544;239;305;471;69;4;0;ITF;ITF2;14;Molise;41.55774754;14.65916051;97;13;110;1592;1702;13;83;8119;336;10157;157152;142082
2021-02-25;BAS;1797;741;1056;1738;48;11;0;ITF;ITF5;17;Basilicata;40.63947052;15.80514834;85;5;90;3773;3863;70;124;11094;370;15327;246508;144007
2021-02-25;PAB;1498;549;949;1488;1;9;0;ITH;ITH1;4;Provincia Autonoma Bolzano / Bozen;46.49933453;11.35662422;259;33;292;6814;7106;182;374;44035;1006;52147;696789;194606
2021-02-25;VDA;202;101;101;190;8;4;0;ITC;ITC2;2;Valle d'Aosta / Vallée d'Aoste;45.73750286;7.320149366;6;0;6;130;136;-10;4;7431;415;7982;76105;43569
2021-02-25;FVG;3180;1662;1518;3117;30;33;0;ITH;ITH4;6;Friuli-Venezia Giulia;45.6494354;13.76813649;335;56;391;9249;9640;323;683;63078;2817;75535;1328704;473707
2021-02-26;PAB;1528;551;977;1471;30;27;0;ITH;ITH1;4;Provincia Autonoma Bolzano / Bozen;46.49933453;11.35662422;227;35;262;6749;7011;-95;355;44479;1012;52502;713176;195047
2021-02-26;PUG;13812;5072;8740;12527;1082;203;0;ITF;ITF4;16;Puglia;41.12559576;16.86736689;1246;164;1410;30629;32039;67;1104;108948;3887;144874;1540574;854520
2021-02-26;MOL;567;262;305;492;74;1;0;ITF;ITF2;14;Molise;41.55774754;14.65916051;106;15;121;1600;1721;19;26;8121;341;10183;157502;142405
2021-02-26;BAS;2165;908;1257;2077;82;6;0;ITF;ITF5;17;Basilicata;40.63947052;15.80514834;87;7;94;3766;3860;-3;87;11184;370;15414;247657;144651
2021-02-26;LAZ;13250;5778;7472;11553;1512;185;0;ITI;ITI4;12;Lazio;41.89277044;12.48366722;1830;217;2047;33386;35433;438;1539;190256;5851;231540;4049291;2795020
2021-02-26;VDA;210;58;152;110;86;14;0;ITC;ITC2;2;Valle d'Aosta / Vallée d'Aoste;45.73750286;7.320149366;9;1;10;136;146;10;14;7435;415;7996;76453;43686
2021-02-26;UMB;660;253;407;650;8;2;0;ITI;ITI2;10;Umbria;43.10675841;12.38824698;460;80;540;7877;8417;-92;292;34212;1014;43643;789962;310556
2021-02-26;SIC;11988;5882;6106;10191;1681;116;0;ITG;ITG1;19;Sicilia;38.11569725;13.362356699999998;776;132;908;25689;26597;-429;578;120894;4096;151587;2392113;1120327
2021-02-26;FVG;3811;2152;1659;3596;182;33;0;ITH;ITH4;6;Friuli-Venezia Giulia;45.6494354;13.76813649;348;56;404;9471;9875;235;468;63305;2823;76003;1337295;476513
2021-02-26;PAT;1257;445;812;932;299;26;0;ITH;ITH2;4;Provincia Autonoma Trento;46.06893511;11.12123097;168;36;204;3111;3315;245;406;28519;1203;33037;600202;169229
2021-02-26;TOS;10106;3849;6257;8676;1211;219;0;ITI;ITI1;9;Toscana;43.76923077;11.25588885;844;163;1007;15876;16883;753;1254;132523;4635;154041;2685782;1420746
2021-02-26;PIE;12326;4945;7381;11372;743;211;0;ITC;ITC1;1;Piemonte;45.0732745;7.680687483;1938;163;2101;13022;15123;800;1526;220570;9351;245044;2537151;1242421
2021-02-26;EMR;9642;3675;5967;8563;1054;25;0;ITH;ITH5;8;Emilia-Romagna;44.49436681;11.341720800000001;2092;211;2303;36919;39222;1529;2575;205768;10489;255479;3794731;1488902
2021-02-26;VEN;8297;3273;5024;6942;1260;95;0;ITH;ITH3;5;Veneto;45.43490485;12.33845213;784;106;890;22549;23439;490;1174;298198;9814;331451;4970754;1392786
2021-02-26;SAR;2838;1118;1720;2474;308;56;0;ITG;ITG2;20;Sardegna;39.21531192;9.110616306;224;22;246;12571;12817;-75;70;27063;1147;41027;756558;527643
2021-02-26;MAR;3681;1523;2158;3096;480;105;0;ITI;ITI3;11;Marche;43.61675973;13.5188753;561;81;642;9102;9744;134;686;54503;2224;66471;821182;498803
2021-02-26;ABR;3923;1679;2244;2928;969;26;0;ITF;ITF1;13;Abruzzo;42.35122196;13.39843823;609;78;687;11948;12635;-85;653;38638;1678;52951;967052;493564
2021-02-26;CAL;3178;1688;1490;2698;464;16;0;ITF;ITF6;18;Calabria;38.90597598;16.59440194;189;19;208;6031;6239;105;241;30617;677;37533;579690;547334
2021-02-26;CAM;13366;4236;9130;11682;1368;316;0;ITF;ITF3;15;Campania;40.83956555;14.25084984;1294;144;1438;72263;73701;729;2519;184883;4259;262843;2888348;2001847
2021-02-26;LOM;18449;7573;10876;16330;1910;209;0;ITC;ITC4;3;Lombardia;45.46679409;9.190347404;4034;416;4450;56817;61267;3439;4557;505819;28275;595361;6566513;3092577
2021-02-26;LIG;3772;1526;2246;3418;329;25;0;ITC;ITC3;7;Liguria;44.41149315;8.9326992;491;52;543;4640;5183;108;351;68576;3620;77379;1021703;435483
2021-02-27;UMB;1658;354;1304;1642;16;0;0;ITI;ITI2;10;Umbria;43.10675841;12.38824698;448;77;525;7797;8322;-95;267;34565;1023;43910;796251;311511
2021-02-27;SIC;12242;5506;6736;10937;1204;101;0;ITG;ITG1;19;Sicilia;38.11569725;13.362356699999998;734;134;868;24903;25771;-826;518;122217;4117;152105;2418042;1125332
2021-02-27;CAM;13957;4471;9486;11960;1653;344;0;ITF;ITF3;15;Campania;40.83956555;14.25084984;1301;138;1439;73552;74991;1290;2215;185794;4273;265058;2911080;2016532
2021-02-27;LOM;13955;5876;8079;13153;645;157;0;ITC;ITC4;3;Lombardia;45.46679409;9.190347404;4062;435;4497;59217;63714;2447;4191;507514;28324;599552;6612378;3106090
2021-02-27;TOS;2000;763;1237;1019;903;78;0;ITI;ITI1;9;Toscana;43.76923077;11.25588885;887;166;1053;16376;17429;546;1126;133083;4655;155167;2709142;1433158
2021-02-27;FVG;3548;1207;2341;3530;1;17;0;ITH;ITH4;6;Friuli-Venezia Giulia;45.6494354;13.76813649;355;62;417;9568;9985;110;468;63652;2834;76471;1345374;479004
2021-02-27;LAZ;11553;4340;7213;10355;1054;144;0;ITI;ITI4;12;Lazio;41.89277044;12.48366722;1814;216;2030;33634;35664;231;1347;191352;5871;232887;4081562;2814175
2021-02-27;MOL;1375;572;803;1349;20;6;0;ITF;ITF2;14;Molise;41.55774754;14.65916051;96;14;110;1599;1709;-12;110;8236;343;10288;158805;143615
2021-02-27;EMR;10969;3999;6970;9194;1742;33;0;ITH;ITH5;8;Emilia-Romagna;44.49436681;11.341720800000001;2178;214;2392;38279;40671;1449;2542;206815;10521;258007;3826860;1496542
2021-02-27;SAR;1930;646;1284;1326;561;43;0;ITG;ITG2;20;Sardegna;39.21531192;9.110616306;217;19;236;12599;12835;18;87;27126;1153;41114;759279;529886
2021-02-27;MAR;3401;1457;1944;3158;209;34;0;ITI;ITI3;11;Marche;43.61675973;13.5188753;571;77;648;9411;10059;315;798;54970;2240;67269;829646;504718
2021-02-27;PIE;12739;4862;7877;12161;337;241;0;ITC;ITC1;1;Piemonte;45.0732745;7.680687483;1956;166;2122;13521;15643;520;1188;221224;9365;246232;2562917;1249383
2021-02-27;CAL;4074;2100;1974;3680;387;7;0;ITF;ITF6;18;Calabria;38.90597598;16.59440194;187;20;207;6097;6304;65;187;30736;680;37720;582134;549628
2021-02-27;VEN;8994;2693;6301;7964;849;181;0;ITH;ITH3;5;Veneto;45.43490485;12.33845213;776;107;883;23149;24032;593;1285;298867;9837;332736;5012057;1396700
2021-02-27;PAT;1055;469;586;607;428;20;0;ITH;ITH2;4;Provincia Autonoma Trento;46.06893511;11.12123097;173;38;211;3310;3521;206;351;28663;1204;33388;603677;169620
2021-02-27;BAS;2005;863;1142;1823;165;17;0;ITF;ITF5;17;Basilicata;40.63947052;15.80514834;82;7;89;3862;3951;91;120;11212;371;15534;249147;145526
2021-02-27;ABR;2813;1338;1475;2513;267;33;0;ITF;ITF1;13;Abruzzo;42.35122196;13.39843823;614;74;688;12043;12731;96;594;39125;1689;53545;975981;496651
2021-02-27;LIG;1889;921;968;1755;129;5;0;ITC;ITC3;7;Liguria;44.41149315;8.9326992;491;50;541;4660;5201;18;351;68901;3628;77730;1028736;438176
2021-02-27;PUG;14252;4826;9426;12827;1237;188;0;ITF;ITF4;16;Puglia;41.12559576;16.86736689;1239;161;1400;31057;32457;418;1123;109633;3907;145997;1549574;859293
2021-02-27;PAB;2458;759;1699;2414;10;34;0;ITH;ITH1;4;Provincia Autonoma Bolzano / Bozen;46.49933453;11.35662422;225;34;259;6670;6929;-82;355;44913;1015;52857;730953;195490
2021-02-27;VDA;232;86;146;120;107;5;0;ITC;ITC2;2;Valle d'Aosta / Vallée d'Aoste;45.73750286;7.320149366;10;1;11;131;142;-4;2;7441;415;7998;76738;43783
2021-02-28;TOS;1665;669;996;868;727;70;0;ITI;ITI1;9;Toscana;43.76923077;11.25588885;909;168;1077;16972;18049;620;1068;133518;4668;156235;2728258;1444307
2021-02-28;LIG;1060;580;480;1048;11;1;0;ITC;ITC3;7;Liguria;44.41149315;8.9326992;500;52;552;4831;5383;182;248;68965;3630;77978;1033573;440188
2021-02-28;MAR;2837;1251;1586;2823;6;8;0;ITI;ITI3;11;Marche;43.61675973;13.5188753;582;72;654;9576;10230;171;588;55375;2252;67857;833982;507294
2021-02-28;PUG;6087;1813;4274;5819;191;77;0;ITF;ITF4;16;Puglia;41.12559576;16.86736689;1228;170;1398;31683;33081;624;1053;110046;3923;147050;1557266;861270
2021-02-28;ABR;1703;509;1194;1665;2;36;0;ITF;ITF1;13;Abruzzo;42.35122196;13.39843823;611;77;688;12035;12723;-8;355;39479;1698;53900;984691;499389
2021-02-28;MOL;841;338;503;795;43;3;0;ITF;ITF2;14;Molise;41.55774754;14.65916051;109;15;124;1574;1698;-11;65;8309;346;10353;159605;144368
2021-02-28;VEN;4136;1389;2747;3225;837;74;0;ITH;ITH3;5;Veneto;45.43490485;12.33845213;781;112;893;23626;24519;487;911;299281;9847;333647;5032579;1399695
2021-02-28;VDA;260;86;174;73;183;4;0;ITC;ITC2;2;Valle d'Aosta / Vallée d'Aoste;45.73750286;7.320149366;8;1;9;132;141;-1;13;7455;415;8011;77004;43899
2021-02-28;PAT;246;122;124;236;0;10;0;ITH;ITH2;4;Provincia Autonoma Trento;46.06893511;11.12123097;173;38;211;3444;3655;134;341;28868;1206;33729;607688;170197
2021-02-28;PIE;10850;4068;6782;10429;241;180;0;ITC;ITC1;1;Piemonte;45.0732745;7.680687483;2015;168;2183;13894;16077;434;902;221688;9369;247134;2573650;1254138
2021-02-28;FVG;2693;1006;1687;2269;395;29;0;ITH;ITH4;6;Friuli-Venezia Giulia;45.6494354;13.76813649;361;61;422;9660;10082;97;341;63889;2841;76812;1349711;480845
2021-02-28;SIC;7132;3034;4098;6456;631;45;0;ITG;ITG1;19;Sicilia;38.11569725;13.362356699999998;725;133;858;25124;25982;211;453;122438;4138;152558;2442832;1130192
2021-02-28;CAM;10412;3208;7204;8273;1901;238;0;ITF;ITF3;15;Campania;40.83956555;14.25084984;1341;130;1471;75552;77023;2032;2561;186318;4278;267619;2935448;2033984
2021-02-28;BAS;813;347;466;772;37;4;0;ITF;ITF5;17;Basilicata;40.63947052;15.80514834;85;10;95;3937;4032;81;101;11232;371;15635;250546;146414
2021-02-28;SAR;369;170;199;140;227;2;0;ITG;ITG2;20;Sardegna;39.21531192;9.110616306;215;19;234;12621;12855;20;77;27178;1158;41191;761789;531953
2021-02-28;LOM;7886;3256;4630;7604;210;72;0;ITC;ITC4;3;Lombardia;45.46679409;9.190347404;4118;426;4544;61797;66341;2627;3529;508379;28361;603081;6649629;3119343
2021-02-28;CAL;2389;1089;1300;2227;159;3;0;ITF;ITF6;18;Calabria;38.90597598;16.59440194;190;20;210;6054;6264;-40;160;30933;683;37880;583901;551283
2021-02-28;LAZ;10304;4045;6259;9656;546;102;0;ITI;ITI4;12;Lazio;41.89277044;12.48366722;1767;213;1980;33821;35801;137;1341;192544;5883;234228;4116403;2833843
2021-02-28;EMR;6830;2528;4302;4959;1852;19;0;ITH;ITH5;8;Emilia-Romagna;44.49436681;11.341720800000001;2255;227;2482;40196;42678;2007;2610;207381;10543;260602;3851466;1503946
2021-03-01;ABR;3477;1384;2093;2702;751;24;0;ITF;ITF1;13;Abruzzo;42.35122196;13.39843823;622;82;704;12540;13244;521;568;39523;1701;54468;1002799;506869
2021-03-01;BAS;553;286;267;384;169;0;0;ITF;ITF5;17;Basilicata;40.63947052;15.80514834;87;9;96;3998;4094;62;75;11242;374;15710;251905;147466
2021-03-01;VDA;182;66;116;140;34;8;0;ITC;ITC2;2;Valle d'Aosta / Vallée d'Aoste;45.73750286;7.320149366;9;2;11;133;144;3;10;7462;415;8021;77262;44049
2021-03-01;FVG;2971;1045;1926;2894;53;24;0;ITH;ITH4;6;Friuli-Venezia Giulia;45.6494354;13.76813649;373;62;435;9727;10162;80;172;63978;2844;76984;1351758;481762
2021-03-01;EMR;10105;3585;6520;7817;2263;25;0;ITH;ITH5;8;Emilia-Romagna;44.49436681;11.341720800000001;2375;236;2611;41667;44278;1600;2597;208350;10566;263194;3863929;1507734
2021-03-01;CAL;2766;1567;1199;2301;461;4;0;ITF;ITF6;18;Calabria;38.90597598;16.59440194;196;19;215;6058;6273;9;151;31070;688;38031;585355;552660
2021-03-01;CAM;12134;4249;7885;7736;4113;285;0;ITF;ITF3;15;Campania;40.83956555;14.25084984;1337;140;1477;76476;77953;930;1896;187264;4298;269515;2950071;2043394
2021-03-01;PAT;1256;460;796;928;303;25;0;ITH;ITH2;4;Provincia Autonoma Trento;46.06893511;11.12123097;185;39;224;3709;3933;278;329;28919;1206;34058;610402;170637
2021-03-01;LIG;3542;1447;2095;3387;136;19;0;ITC;ITC3;7;Liguria;44.41149315;8.9326992;517;54;571;4914;5485;102;309;69166;3636;78287;1038374;442437
2021-03-01;LAZ;17164;7381;9783;12991;3896;277;0;ITI;ITI4;12;Lazio;41.89277044;12.48366722;1840;223;2063;33660;35723;-78;1044;193638;5911;235272;4132010;2844511
2021-03-01;SIC;12773;6076;6697;10989;1658;126;0;ITG;ITG1;19;Sicilia;38.11569725;13.362356699999998;726;132;858;25323;26181;199;478;122699;4156;153036;2463696;1135110
2021-03-01;UMB;1505;775;730;1385;114;6;0;ITI;ITI2;10;Umbria;43.10675841;12.38824698;441;78;519;7809;8328;6;331;34883;1030;44241;802418;312553
2021-03-01;PIE;12191;4968;7223;11197;813;181;0;ITC;ITC1;1;Piemonte;45.0732745;7.680687483;2043;175;2218;14403;16621;544;1155;222293;9375;248289;2587586;1258594
2021-03-01;TOS;4476;1732;2744;766;3643;67;0;ITI;ITI1;9;Toscana;43.76923077;11.25588885;950;172;1122;17343;18465;416;877;133961;4686;157112;2740531;1451505
2021-03-01;LOM;18803;8238;10565;16890;1708;205;0;ITC;ITC4;3;Lombardia;45.46679409;9.190347404;4224;441;4665;60337;65002;-1339;2135;511811;28403;605216;6670200;3126924
2021-03-01;SAR;2298;1168;1130;1599;667;32;0;ITG;ITG2;20;Sardegna;39.21531192;9.110616306;210;19;229;12576;12805;-50;45;27265;1166;41236;768303;533202
2021-03-01;MAR;3772;1520;2252;3503;248;21;0;ITI;ITI3;11;Marche;43.61675973;13.5188753;575;74;649;9336;9985;-245;446;56059;2259;68303;837003;509111
2021-03-01;VEN;9395;3717;5678;7411;1822;162;0;ITH;ITH3;5;Veneto;45.43490485;12.33845213;806;112;918;23992;24910;391;603;299488;9852;334250;5043165;1401428
2021-03-01;PUG;15145;5886;9259;13604;1386;155;0;ITF;ITF4;16;Puglia;41.12559576;16.86736689;1255;167;1422;31540;32962;-119;631;110767;3952;147681;1561952;864140
2021-03-01;MOL;670;276;394;433;217;20;0;ITF;ITF2;14;Molise;41.55774754;14.65916051;95;16;111;1635;1746;48;131;8389;349;10484;160696;145391
2021-03-01;PAB;925;224;701;889;1;35;0;ITH;ITH1;4;Provincia Autonoma Bolzano / Bozen;46.49933453;11.35662422;223;34;257;6518;6775;-154;350;45410;1022;53207;743698;195992
2021-03-02;FVG;4229;1523;2706;2707;1500;22;0;ITH;ITH4;6;Friuli-Venezia Giulia;45.6494354;13.76813649;380;61;441;9765;10206;44;479;64401;2856;77463;1361337;484934
2021-03-02;PIE;11349;4623;6726;10338;815;196;0;ITC;ITC1;1;Piemonte;45.0732745;7.680687483;2139;180;2319;15014;17333;712;1609;223170;9395;249898;2610826;1268524
2021-03-02;CAM;12762;4560;8202;8178;4345;239;0;ITF;ITF3;15;Campania;40.83956555;14.25084984;1360;133;1493;77792;79285;1332;2046;187942;4334;271561;2965331;2054196
2021-03-02;LOM;22844;9711;13133;19527;3049;268;0;ITC;ITC4;3;Lombardia;45.46679409;9.190347404;4408;476;4884;62806;67690;2688;3762;512830;28458;608978;6712252;3137037
2021-03-02;SIC;14783;6380;8403;11886;2781;116;0;ITG;ITG1;19;Sicilia;38.11569725;13.362356699999998;726;123;849;24880;25729;-452;566;123703;4170;153602;2488439;1139681
2021-03-02;PAT;1323;446;877;910;382;31;0;ITH;ITH2;4;Provincia Autonoma Trento;46.06893511;11.12123097;190;42;232;3465;3697;-236;57;29210;1208;34115;611545;171005
2021-03-02;LIG;4084;1696;2388;3766;310;8;0;ITC;ITC3;7;Liguria;44.41149315;8.9326992;520;50;570;4857;5427;-58;337;69553;3644;78624;1045969;445111
2021-03-02;CAL;4432;2507;1925;3626;797;9;0;ITF;ITF6;18;Calabria;38.90597598;16.59440194;195;20;215;6050;6265;-8;102;31175;693;38133;587436;554680
2021-03-02;VEN;11498;4628;6870;7935;3312;251;0;ITH;ITH3;5;Veneto;45.43490485;12.33845213;823;118;941;24283;25224;314;1228;300380;9874;335478;5085877;1405583
2021-03-02;SAR;3063;1636;1427;1823;1162;78;0;ITG;ITG2;20;Sardegna;39.21531192;9.110616306;206;20;226;12513;12739;-66;70;27397;1170;41306;778916;535261
2021-03-02;LAZ;17287;7658;9629;13124;3957;206;0;ITI;ITI4;12;Lazio;41.89277044;12.48366722;1831;226;2057;33738;35795;72;1188;194725;5940;236460;4169881;2866352
2021-03-02;MAR;5003;1968;3035;4370;566;67;0;ITI;ITI3;11;Marche;43.61675973;13.5188753;570;78;648;9124;9772;-213;415;56671;2275;68718;844097;514151
2021-03-02;PAB;696;200;496;694;2;0;0;ITH;ITH1;4;Provincia Autonoma Bolzano / Bozen;46.49933453;11.35662422;213;32;245;6539;6784;9;371;45768;1026;53578;758123;196482
2021-03-02;TOS;10600;3796;6804;7039;3447;114;0;ITI;ITI1;9;Toscana;43.76923077;11.25588885;989;174;1163;17665;18828;363;1058;134643;4699;158170;2763855;1463071
2021-03-02;PUG;16439;6112;10327;14875;1311;253;0;ITF;ITF4;16;Puglia;41.12559576;16.86736689;1269;163;1432;31679;33111;149;1021;111599;3992;148702;1571274;870531
2021-03-02;ABR;3966;1675;2291;3263;686;17;0;ITF;ITF1;13;Abruzzo;42.35122196;13.39843823;633;81;714;12397;13111;-133;199;39844;1709;54664;1012623;511603
2021-03-02;MOL;675;388;287;508;159;8;0;ITF;ITF2;14;Molise;41.55774754;14.65916051;95;17;112;1626;1738;-8;63;8460;349;10547;161549;146158
2021-03-02;VDA;340;166;174;291;3;46;0;ITC;ITC2;2;Valle d'Aosta / Vallée d'Aoste;45.73750286;7.320149366;10;2;12;162;174;30;33;7465;415;8054;77627;44232
2021-03-02;EMR;12666;4276;8390;10521;2088;57;0;ITH;ITH5;8;Emilia-Romagna;44.49436681;11.341720800000001;2476;239;2715;43132;45847;1569;2040;208757;10610;265214;3904900;1513475
2021-03-02;UMB;3648;1346;2302;3638;8;2;0;ITI;ITI2;10;Umbria;43.10675841;12.38824698;421;78;499;7716;8215;-113;230;35219;1037;44471;808622;313463
2021-03-02;BAS;814;390;424;669;140;5;0;ITF;ITF5;17;Basilicata;40.63947052;15.80514834;92;9;101;4083;4184;90;147;11298;375;15857;253755;148507
2021-03-03;ABR;4641;1900;2741;3716;906;19;0;ITF;ITF1;13;Abruzzo;42.35122196;13.39843823;634;85;719;12336;13055;-56;246;40135;1720;54910;1018678;513827
2021-03-03;PAB;1181;395;786;1162;13;6;0;ITH;ITH1;4;Provincia Autonoma Bolzano / Bozen;46.49933453;11.35662422;218;33;251;6451;6702;-82;226;46071;1031;53804;765274;196914
2021-03-03;VDA;258;119;139;182;71;5;0;ITC;ITC2;2;Valle d'Aosta / Vallée d'Aoste;45.73750286;7.320149366;14;2;16;152;168;-6;3;7474;415;8057;77765;44274
2021-03-03;VEN;12102;4648;7454;8389;3502;211;0;ITH;ITH3;5;Veneto;45.43490485;12.33845213;840;128;968;24796;25764;540;1272;301095;9891;336750;5129954;1409434
2021-03-03;PIE;12393;4872;7521;11377;821;195;0;ITC;ITC1;1;Piemonte;45.0732745;7.680687483;2140;181;2321;15610;17931;598;1537;224093;9411;251435;2631888;1276314
2021-03-03;PAT;1672;628;1044;1115;520;37;0;ITH;ITH2;4;Provincia Autonoma Trento;46.06893511;11.12123097;191;42;233;3435;3668;-29;220;29458;1209;34335;614605;171470
2021-03-03;EMR;15901;5270;10631;13362;2486;53;0;ITH;ITH5;8;Emilia-Romagna;44.49436681;11.341720800000001;2528;251;2779;43919;46698;851;2456;210282;10650;267630;3945715;1520827
2021-03-03;BAS;1816;848;968;1223;565;28;0;ITF;ITF5;17;Basilicata;40.63947052;15.80514834;101;10;111;4136;4247;63;124;11359;375;15981;255137;149289
2021-03-03;FVG;3658;1643;2015;2351;1277;30;0;ITH;ITH4;6;Friuli-Venezia Giulia;45.6494354;13.76813649;386;62;448;10107;10555;349;693;64735;2866;78156;1370182;488423
2021-03-03;UMB;4433;1772;2661;3719;711;3;0;ITI;ITI2;10;Umbria;43.10675841;12.38824698;436;77;513;7628;8141;-74;212;35492;1050;44683;813081;313787
2021-03-03;SIC;14592;6553;8039;11383;3077;132;0;ITG;ITG1;19;Sicilia;38.11569725;13.362356699999998;696;117;813;24316;25129;-600;539;124825;4187;154141;2513610;1144611
2021-03-03;LAZ;17942;7907;10035;13338;4323;281;0;ITI;ITI4;12;Lazio;41.89277044;12.48366722;1828;237;2065;33724;35789;-6;1520;196216;5975;237980;4207454;2886524
2021-03-03;PUG;16836;6829;10007;14741;1940;155;0;ITF;ITF4;16;Puglia;41.12559576;16.86736689;1280;168;1448;32220;33668;557;1261;112274;4021;149963;1582701;875257
2021-03-03;SAR;4142;2294;1848;2748;1307;87;0;ITG;ITG2;20;Sardegna;39.21531192;9.110616306;192;20;212;12494;12706;-33;101;27528;1173;41407;783633;537630
2021-03-03;LOM;27033;11533;15500;19491;7319;223;0;ITC;ITC4;3;Lombardia;45.46679409;9.190347404;4545;506;5051;64285;69336;1646;4590;515714;28518;613568;6767863;3151288
2021-03-03;CAM;13925;5496;8429;7065;6632;228;0;ITF;ITF3;15;Campania;40.83956555;14.25084984;1356;137;1493;79759;81252;1967;2635;188570;4374;274196;2991864;2070744
2021-03-03;CAL;5128;2800;2328;4024;1090;14;0;ITF;ITF6;18;Calabria;38.90597598;16.59440194;201;20;221;6038;6259;-6;230;31407;697;38363;590389;557211
2021-03-03;LIG;4587;1850;2737;3446;1031;110;0;ITC;ITC3;7;Liguria;44.41149315;8.9326992;526;53;579;4919;5498;71;368;69835;3659;78992;1053405;447907
2021-03-03;MAR;6699;3075;3624;5715;885;99;0;ITI;ITI3;11;Marche;43.61675973;13.5188753;561;84;645;9267;9912;140;759;57279;2286;69477;851158;518930
2021-03-03;MOL;678;320;358;589;83;6;0;ITF;ITF2;14;Molise;41.55774754;14.65916051;95;17;112;1664;1776;38;144;8564;351;10691;162671;147198
2021-03-03;TOS;18231;6536;11695;14494;3609;128;0;ITI;ITI1;9;Toscana;43.76923077;11.25588885;1021;171;1192;18067;19259;431;1163;135347;4727;159333;2788768;1476328
2021-03-04;EMR;16464;5352;11112;13347;3025;92;0;ITH;ITH5;8;Emilia-Romagna;44.49436681;11.341720800000001;2600;259;2859;45269;48128;1430;2545;211352;10675;270155;3983946;1529215
2021-03-04;FVG;3466;1601;1865;2774;663;29;0;ITH;ITH4;6;Friuli-Venezia Giulia;45.6494354;13.76813649;392;63;455;10485;10940;385;643;64983;2876;78799;1379290;491899
2021-03-04;LAZ;19518;8768;10750;14198;5036;284;0;ITI;ITI4;12;Lazio;41.89277044;12.48366722;1860;241;2101;33942;36043;254;1702;197642;5997;239682;4241179;2906083
2021-03-04;CAL;5497;3197;2300;4677;800;20;0;ITF;ITF6;18;Calabria;38.90597598;16.59440194;202;21;223;6131;6354;95;226;31535;700;38589;593053;559627
2021-03-04;UMB;4486;1856;2630;3644;827;15;0;ITI;ITI2;10;Umbria;43.10675841;12.38824698;445;79;524;7474;7998;-143;79;35708;1056;44762;814378;313923
2021-03-04;SIC;15260;6710;8550;11009;4122;129;0;ITG;ITG1;19;Sicilia;38.11569725;13.362356699999998;676;118;794;23751;24545;-584;560;125955;4201;154701;2540447;1149114
2021-03-04;PAT;2392;808;1584;1559;790;43;0;ITH;ITH2;4;Provincia Autonoma Trento;46.06893511;11.12123097;182;47;229;3524;3753;85;357;29728;1211;34692;618666;172150
2021-03-04;PIE;14761;5949;8812;11585;2952;224;0;ITC;ITC1;1;Piemonte;45.0732745;7.680687483;2171;188;2359;16798;19157;1226;2167;225008;9437;253602;2649872;1281529
2021-03-04;SAR;4394;2314;2080;3068;1260;66;0;ITG;ITG2;20;Sardegna;39.21531192;9.110616306;193;23;216;12485;12701;-5;81;27610;1177;41488;786233;539386
2021-03-04;CAM;14709;5395;9314;8521;5897;291;0;ITF;ITF3;15;Campania;40.83956555;14.25084984;1357;140;1497;81461;82958;1706;2780;189604;4414;276976;3015852;2087073
2021-03-04;TOS;17896;6979;10917;14657;3079;160;0;ITI;ITI1;9;Toscana;43.76923077;11.25588885;1029;173;1202;18501;19703;444;1239;136119;4750;160572;2812512;1489353
2021-03-04;PAB;1723;1011;712;1455;229;39;0;ITH;ITH1;4;Provincia Autonoma Bolzano / Bozen;46.49933453;11.35662422;218;31;249;6477;6726;24;121;46160;1039;53925;778466;197105
2021-03-04;LIG;4743;2119;2624;3840;848;55;0;ITC;ITC3;7;Liguria;44.41149315;8.9326992;535;55;590;5095;5685;187;414;70055;3666;79406;1060675;450754
2021-03-04;MAR;6539;2894;3645;5080;1395;64;0;ITI;ITI3;11;Marche;43.61675973;13.5188753;580;87;667;9503;10170;258;919;57931;2295;70396;857713;522867
2021-03-04;VEN;12990;4890;8100;9118;3479;393;0;ITH;ITH3;5;Veneto;45.43490485;12.33845213;866;131;997;25604;26601;837;1487;301725;9911;338237;5170985;1413578
2021-03-04;MOL;860;423;437;517;325;18;0;ITF;ITF2;14;Molise;41.55774754;14.65916051;98;19;117;1617;1734;-42;41;8646;352;10732;162905;147422
2021-03-04;LOM;29379;12138;17241;20066;9089;224;0;ITC;ITC4;3;Lombardia;45.46679409;9.190347404;4735;532;5267;67127;72394;3058;5174;517771;28577;618742;6821426;3167660
2021-03-04;PUG;15405;6118;9287;13727;1441;237;0;ITF;ITF4;16;Puglia;41.12559576;16.86736689;1287;162;1449;32357;33806;138;1438;113542;4053;151401;1592759;879867
2021-03-04;ABR;5942;2359;3583;4972;928;42;0;ITF;ITF1;13;Abruzzo;42.35122196;13.39843823;638;82;720;12320;13040;-15;573;40708;1731;55479;1027262;516369
2021-03-04;VDA;291;139;152;38;251;2;0;ITC;ITC2;2;Valle d'Aosta / Vallée d'Aoste;45.73750286;7.320149366;13;2;15;148;163;-5;6;7485;415;8063;78036;44361
2021-03-04;BAS;1915;912;1003;1077;809;29;0;ITF;ITF5;17;Basilicata;40.63947052;15.80514834;97;10;107;4080;4187;-60;122;11540;376;16103;256325;149988
2021-03-05;PUG;17752;7202;10550;15205;2319;228;0;ITF;ITF4;16;Puglia;41.12559576;16.86736689;1282;161;1443;32807;34250;444;1418;114497;4072;152819;1603289;885085
2021-03-05;MOL;1235;659;576;1011;209;15;0;ITF;ITF2;14;Molise;41.55774754;14.65916051;94;19;113;1571;1684;-50;18;8712;354;10750;163421;147903
2021-03-05;PAB;1843;627;1216;1386;443;14;0;ITH;ITH1;4;Provincia Autonoma Bolzano / Bozen;46.49933453;11.35662422;208;31;239;6653;6892;166;236;46226;1043;54161;799724;197340
2021-03-05;MAR;6225;2873;3352;4689;1469;67;0;ITI;ITI3;11;Marche;43.61675973;13.5188753;593;92;685;9518;10203;33;1027;58913;2307;71423;864775;527545
2021-03-05;BAS;1886;870;1016;1105;764;17;0;ITF;ITF5;17;Basilicata;40.63947052;15.80514834;95;12;107;3769;3876;-311;164;12015;376;16267;258034;150971
2021-03-05;ABR;5346;1958;3388;4589;697;60;0;ITF;ITF1;13;Abruzzo;42.35122196;13.39843823;651;85;736;12343;13079;39;552;41194;1758;56031;1035556;518758
2021-03-05;EMR;17923;5865;12058;14293;3505;125;0;ITH;ITH5;8;Emilia-Romagna;44.49436681;11.341720800000001;2663;266;2929;47385;50314;2186;3246;212341;10721;273376;4026645;1537286
2021-03-05;LOM;29013;11976;17037;20253;8452;308;0;ITC;ITC4;3;Lombardia;45.46679409;9.190347404;4804;543;5347;70781;76128;3734;5210;519186;28638;623952;6878580;3183943
2021-03-05;SAR;5238;2624;2614;2823;2372;43;0;ITG;ITG2;20;Sardegna;39.21531192;9.110616306;192;25;217;12469;12686;-15;89;27712;1179;41577;789675;541830
2021-03-05;VDA;277;125;152;53;223;1;0;ITC;ITC2;2;Valle d'Aosta / Vallée d'Aoste;45.73750286;7.320149366;12;2;14;152;166;3;9;7491;415;8072;78370;44525
2021-03-05;UMB;4625;1403;3222;3951;659;15;0;ITI;ITI2;10;Umbria;43.10675841;12.38824698;446;78;524;7575;8099;101;289;35890;1062;45051;820894;314564
2021-03-05;SIC;15789;6852;8937;11394;4244;151;0;ITG;ITG1;19;Sicilia;38.11569725;13.362356699999998;670;120;790;21888;22678;-1867;519;128329;4213;155220;2563608;1153443
2021-03-05;FVG;3838;1546;2292;2735;1080;23;0;ITH;ITH4;6;Friuli-Venezia Giulia;45.6494354;13.76813649;396;64;460;10933;11393;453;823;65341;2888;79622;1389420;495953
2021-03-05;PIE;15681;6311;9370;11559;3840;282;0;ITC;ITC1;1;Piemonte;45.0732745;7.680687483;2223;185;2408;18093;20501;1344;2283;225923;9461;255885;2687380;1295055
2021-03-05;PAT;2311;736;1575;1646;569;96;0;ITH;ITH2;4;Provincia Autonoma Trento;46.06893511;11.12123097;180;46;226;3475;3701;-52;229;30007;1213;34921;622418;172517
2021-03-05;LAZ;19660;8712;10948;14624;4775;261;0;ITI;ITI4;12;Lazio;41.89277044;12.48366722;1872;248;2120;34442;36562;519;1525;198629;6016;241207;4279701;2927642
2021-03-05;VEN;13343;5024;8319;9221;3676;446;0;ITH;ITH3;5;Veneto;45.43490485;12.33845213;878;129;1007;26433;27440;839;1505;302366;9936;339742;5213735;1417931
2021-03-05;TOS;16905;6697;10208;11962;4761;182;0;ITI;ITI1;9;Toscana;43.76923077;11.25588885;1053;183;1236;18916;20152;449;1231;136890;4761;161803;2837853;1502164
2021-03-05;CAL;6244;3624;2620;5649;579;16;0;ITF;ITF6;18;Calabria;38.90597598;16.59440194;211;23;234;6153;6387;33;260;31762;700;38849;596010;562284
2021-03-05;CAM;16823;6668;10155;9821;6672;330;0;ITF;ITF3;15;Campania;40.83956555;14.25084984;1358;140;1498;83712;85210;2252;2842;190181;4427;279818;3041179;2103965
2021-03-05;LIG;4877;2155;2722;3693;1137;47;0;ITC;ITC3;7;Liguria;44.41149315;8.9326992;517;56;573;5220;5793;108;338;70277;3674;79744;1067494;453310
2021-03-06;VDA;22;4;18;18;0;4;0;ITC;ITC2;2;Valle d'Aosta / Vallée d'Aoste;45.73750286;7.320149366;13;2;15;153;168;2;11;7499;416;8083;78745;44623
2021-03-06;BAS;1381;547;834;754;614;13;0;ITF;ITF5;17;Basilicata;40.63947052;15.80514834;94;13;107;3847;3954;78;178;12113;378;16445;259872;152047
2021-03-06;SIC;12652;5064;7588;9766;2783;103;0;ITG;ITG1;19;Sicilia;38.11569725;13.362356699999998;662;121;783;18944;19727;-2951;592;131862;4223;155812;2589844;1158058
2021-03-06;LAZ;18439;7112;11327;13900;4285;254;0;ITI;ITI4;12;Lazio;41.89277044;12.48366722;1896;242;2138;35031;37169;607;1563;199572;6029;242770;4318699;2951382
2021-03-06;SAR;2950;1219;1731;1081;1795;74;0;ITG;ITG2;20;Sardegna;39.21531192;9.110616306;191;24;215;12431;12646;-40;73;27821;1183;41650;791879;543671
2021-03-06;CAL;8557;4407;4150;7714;818;25;0;ITF;ITF6;18;Calabria;38.90597598;16.59440194;218;24;242;6343;6585;198;293;31853;704;39142;598842;564972
2021-03-06;TOS;7137;2859;4278;2849;4203;85;0;ITI;ITI1;9;Toscana;43.76923077;11.25588885;1081;189;1270;19428;20698;546;1293;137614;4784;163096;2863126;1515066
2021-03-06;VEN;10688;4357;6331;7216;3281;191;0;ITH;ITH3;5;Veneto;45.43490485;12.33845213;902;132;1034;27258;28292;852;1539;303036;9953;341281;5255579;1423350
2021-03-06;CAM;16376;6818;9558;10362;5672;342;0;ITF;ITF3;15;Campania;40.83956555;14.25084984;1385;148;1533;85900;87433;2223;2843;190777;4451;282661;3066706;2118676
2021-03-06;PAT;814;285;529;617;154;43;0;ITH;ITH2;4;Provincia Autonoma Trento;46.06893511;11.12123097;179;48;227;3686;3913;212;406;30198;1216;35327;626272;173203
2021-03-06;LOM;21366;9110;12256;16541;4520;305;0;ITC;ITC4;3;Lombardia;45.46679409;9.190347404;4934;565;5499;75155;80654;4526;5658;520251;28705;629610;6937085;3200247
2021-03-06;EMR;21041;5971;15070;18173;2745;123;0;ITH;ITH5;8;Emilia-Romagna;44.49436681;11.341720800000001;2753;275;3028;49414;52442;2128;3232;213413;10746;276601;4063252;1544781
2021-03-06;LIG;3308;1844;1464;2582;706;20;0;ITC;ITC3;7;Liguria;44.41149315;8.9326992;506;59;565;5295;5860;67;272;70475;3681;80016;1073971;455775
2021-03-06;FVG;3524;1208;2316;3164;328;32;0;ITH;ITH4;6;Friuli-Venezia Giulia;45.6494354;13.76813649;409;63;472;11214;11686;293;661;65698;2899;80283;1399685;499211
2021-03-06;PIE;14048;5235;8813;11068;2800;180;0;ITC;ITC1;1;Piemonte;45.0732745;7.680687483;2263;192;2455;19000;21455;954;1793;226737;9486;257678;2714259;1304576
2021-03-06;MAR;5738;2641;3097;4418;1268;52;0;ITI;ITI3;11;Marche;43.61675973;13.5188753;600;94;694;9596;10290;87;836;59651;2318;72259;871403;531927
2021-03-06;PAB;3976;2082;1894;3678;211;87;0;ITH;ITH1;4;Provincia Autonoma Bolzano / Bozen;46.49933453;11.35662422;205;33;238;6525;6763;-129;280;46634;1044;54441;817046;197741
2021-03-06;MOL;1735;810;925;1560;160;15;0;ITF;ITF2;14;Molise;41.55774754;14.65916051;94;19;113;1645;1758;74;116;8751;357;10866;164799;149194
2021-03-06;ABR;4181;1361;2820;3569;571;41;0;ITF;ITF1;13;Abruzzo;42.35122196;13.39843823;657;87;744;12372;13116;37;473;41621;1766;56503;1050587;523764
2021-03-06;UMB;4308;1149;3159;4136;138;34;0;ITI;ITI2;10;Umbria;43.10675841;12.38824698;431;83;514;7424;7938;-161;301;36347;1067;45352;828523;315735
2021-03-06;PUG;16198;6145;10053;13889;2132;177;0;ITF;ITF4;16;Puglia;41.12559576;16.86736689;1283;156;1439;33414;34853;603;1483;115362;4087;154302;1613815;889948
2021-03-07;PAT;24;6;18;24;0;0;0;ITH;ITH2;4;Provincia Autonoma Trento;46.06893511;11.12123097;185;48;233;3826;4059;146;324;30372;1220;35651;630456;173806
2021-03-07;LIG;1915;1139;776;1602;301;12;0;ITC;ITC3;7;Liguria;44.41149315;8.9326992;507;61;568;5305;5873;13;384;70840;3687;80400;1080054;458469
2021-03-07;TOS;5659;2362;3297;2001;3547;111;0;ITI;ITI1;9;Toscana;43.76923077;11.25588885;1109;199;1308;20105;21413;715;1355;138244;4794;164451;2886131;1528501
2021-03-07;LOM;12101;5367;6734;9341;2563;197;0;ITC;ITC4;3;Lombardia;45.46679409;9.190347404;5058;573;5631;76577;82208;1554;4397;523031;28738;633977;6979676;3214062
2021-03-07;MOL;1134;502;632;1128;2;4;0;ITF;ITF2;14;Molise;41.55774754;14.65916051;100;21;121;1604;1725;-33;56;8838;359;10922;165549;149906
2021-03-07;PAB;443;152;291;19;423;1;0;ITH;ITH1;4;Provincia Autonoma Bolzano / Bozen;46.49933453;11.35662422;197;36;233;6424;6657;-106;253;46989;1048;54694;838101;198197
2021-03-07;MAR;5180;2107;3073;4377;754;49;0;ITI;ITI3;11;Marche;43.61675973;13.5188753;616;98;714;9764;10478;188;852;60299;2334;73111;877296;535414
2021-03-07;PUG;4996;2007;2989;4370;578;48;0;ITF;ITF4;16;Puglia;41.12559576;16.86736689;1303;155;1458;34008;35466;613;1155;115894;4097;155457;1622312;892089
2021-03-07;VDA;64;30;34;11;53;0;0;ITC;ITC2;2;Valle d'Aosta / Vallée d'Aoste;45.73750286;7.320149366;10;2;12;159;171;3;15;7511;416;8098;79061;44685
2021-03-07;LAZ;14190;5490;8700;10334;3633;223;0;ITI;ITI4;12;Lazio;41.89277044;12.48366722;1951;240;2191;35421;37612;443;1399;200515;6042;244169;4349476;2971122
2021-03-07;FVG;2559;940;1619;2498;1;60;0;ITH;ITH4;6;Friuli-Venezia Giulia;45.6494354;13.76813649;447;57;504;11344;11848;162;466;65991;2910;80749;1404463;501473
2021-03-07;UMB;846;180;666;838;7;1;0;ITI;ITI2;10;Umbria;43.10675841;12.38824698;436;82;518;7219;7737;-201;267;36807;1075;45619;835386;316639
2021-03-07;SIC;9272;3457;5815;8130;1082;60;0;ITG;ITG1;19;Sicilia;38.11569725;13.362356699999998;657;123;780;15940;16720;-3007;576;135433;4235;156388;2611985;1162553
2021-03-07;PIE;12013;4675;7338;10882;877;254;0;ITC;ITC1;1;Piemonte;45.0732745;7.680687483;2316;202;2518;19787;22305;850;1543;227421;9495;259221;2729618;1311170
2021-03-07;ABR;2520;630;1890;2482;0;38;0;ITF;ITF1;13;Abruzzo;42.35122196;13.39843823;631;86;717;12390;13107;-9;442;42046;1791;56944;1057893;525994
2021-03-07;BAS;900;313;587;848;40;12;0;ITF;ITF5;17;Basilicata;40.63947052;15.80514834;101;12;113;3672;3785;-169;144;12425;379;16589;261351;152938
2021-03-07;CAL;3418;1744;1674;3311;93;14;0;ITF;ITF6;18;Calabria;38.90597598;16.59440194;217;30;247;6402;6649;64;228;32016;705;39370;601651;567156
2021-03-07;SAR;1663;752;911;1114;545;4;0;ITG;ITG2;20;Sardegna;39.21531192;9.110616306;188;24;212;12474;12686;40;95;27876;1183;41745;794272;545670
2021-03-07;CAM;11975;5407;6568;7761;3844;370;0;ITF;ITF3;15;Campania;40.83956555;14.25084984;1396;145;1541;88054;89595;2162;2560;191162;4464;285221;3091099;2135535
2021-03-07;VEN;4495;1769;2726;3862;561;72;0;ITH;ITH3;5;Veneto;45.43490485;12.33845213;917;132;1049;28019;29068;776;1229;303474;9968;342510;5283403;1427046
2021-03-07;EMR;7852;2963;4889;6288;1526;38;0;ITH;ITH5;8;Emilia-Romagna;44.49436681;11.341720800000001;2813;283;3096;51839;54935;2493;3056;213934;10777;279646;4089140;1552719
2021-03-08;BAS;1480;728;752;824;621;35;0;ITF;ITF5;17;Basilicata;40.63947052;15.80514834;111;13;124;3554;3678;-107;28;12559;380;16617;261772;153154
2021-03-08;ABR;5155;1694;3461;4081;977;97;0;ITF;ITF1;13;Abruzzo;42.35122196;13.39843823;643;84;727;12838;13565;458;553;42131;1801;57497;1068599;529568
2021-03-08;VDA;488;233;255;240;245;3;0;ITC;ITC2;2;Valle d'Aosta / Vallée d'Aoste;45.73750286;7.320149366;10;2;12;161;173;2;16;7525;416;8114;79798;45020
2021-03-08;UMB;3701;1825;1876;2327;1361;13;0;ITI;ITI2;10;Umbria;43.10675841;12.38824698;431;86;517;7086;7603;-134;295;37229;1082;45914;841887;317553
2021-03-08;CAL;5523;2991;2532;4404;1086;33;0;ITF;ITF6;18;Calabria;38.90597598;16.59440194;221;32;253;6368;6621;-28;89;32132;706;39459;602904;568253
2021-03-08;SIC;13526;5975;7551;10780;2616;130;0;ITG;ITG1;19;Sicilia;38.11569725;13.362356699999998;669;120;789;14610;15399;-1321;515;137250;4254;156903;2631181;1166825
2021-03-08;VEN;13644;6282;7362;9302;4078;264;0;ITH;ITH3;5;Veneto;45.43490485;12.33845213;950;137;1087;28427;29514;446;757;303773;9980;343267;5293663;1429352
2021-03-08;MAR;6301;2762;3539;5187;1002;112;0;ITI;ITI3;11;Marche;43.61675973;13.5188753;625;104;729;9457;10186;-292;349;60936;2338;73460;879990;537144
2021-03-08;EMR;12225;5102;7123;9473;2667;85;0;ITH;ITH5;8;Emilia-Romagna;44.49436681;11.341720800000001;2960;286;3246;53772;57018;2083;2987;214771;10827;282616;4106632;1557578
2021-03-08;LOM;29834;11216;18618;22165;7132;537;0;ITC;ITC4;3;Lombardia;45.46679409;9.190347404;5200;597;5797;74332;80129;-2079;2301;527359;28790;636278;7002672;3222181
2021-03-08;LAZ;20987;9121;11866;15362;5318;307;0;ITI;ITI4;12;Lazio;41.89277044;12.48366722;2022;253;2275;35651;37926;314;1175;201354;6064;245344;4368011;2979623
2021-03-08;SAR;4735;2465;2270;3456;1226;53;0;ITG;ITG2;20;Sardegna;39.21531192;9.110616306;190;24;214;12444;12658;-28;68;27971;1184;41813;822499;546622
2021-03-08;LIG;5631;2462;3169;3907;1692;32;0;ITC;ITC3;7;Liguria;44.41149315;8.9326992;514;63;577;5372;5949;76;215;70977;3689;80615;1083265;459713
2021-03-08;CAM;14696;6854;7842;9432;4781;483;0;ITF;ITF3;15;Campania;40.83956555;14.25084984;1425;148;1573;88334;89907;312;1644;192453;4505;286865;3102497;2141987
2021-03-08;MOL;1403;530;873;1216;140;47;0;ITF;ITF2;14;Molise;41.55774754;14.65916051;96;19;115;1643;1758;33;137;8931;370;11059;166470;150752
2021-03-08;TOS;6742;2960;3782;1865;4830;47;0;ITI;ITI1;9;Toscana;43.76923077;11.25588885;1174;202;1376;20547;21923;510;1000;138712;4816;165451;2899140;1536184
2021-03-08;PAB;1213;535;678;1163;27;23;0;ITH;ITH1;4;Provincia Autonoma Bolzano / Bozen;46.49933453;11.35662422;194;36;230;6106;6336;-321;230;47536;1052;54924;854830;198557
2021-03-08;PUG;15026;6448;8578;12448;2417;161;0;ITF;ITF4;16;Puglia;41.12559576;16.86736689;1347;169;1516;33691;35207;-259;594;116722;4122;156051;1626872;894898
2021-03-08;FVG;4141;1651;2490;2031;2095;15;0;ITH;ITH4;6;Friuli-Venezia Giulia;45.6494354;13.76813649;457;58;515;11522;12037;189;415;66198;2929;81164;1408009;503160
2021-03-08;PIE;14314;5607;8707;11352;2717;245;0;ITC;ITC1;1;Piemonte;45.0732745;7.680687483;2371;217;2588;20294;22882;577;1214;228042;9511;260435;2741916;1315479
2021-03-08;PAT;1427;439;988;1043;354;30;0;ITH;ITH2;4;Provincia Autonoma Trento;46.06893511;11.12123097;188;48;236;3932;4168;109;275;30536;1222;35926;633250;174293
2021-03-09;VEN;16567;7459;9108;9829;6339;399;0;ITH;ITH3;5;Veneto;45.43490485;12.33845213;1013;141;1154;29056;30210;696;1608;304656;10009;344875;5336942;1434929
2021-03-09;UMB;4093;2003;2090;2797;1288;8;0;ITI;ITI2;10;Umbria;43.10675841;12.38824698;426;82;508;6917;7425;-178;283;37677;1095;46197;848593;318574
2021-03-09;PAT;1671;620;1051;980;654;37;0;ITH;ITH2;4;Provincia Autonoma Trento;46.06893511;11.12123097;199;48;247;3897;4144;-24;83;30639;1226;36009;634145;174532
2021-03-09;CAL;6600;3444;3156;5535;990;75;0;ITF;ITF6;18;Calabria;38.90597598;16.59440194;231;35;266;6340;6606;-15;149;32293;709;39608;605274;570477
2021-03-09;TOS;11180;4590;6590;5531;5565;84;0;ITI;ITI1;9;Toscana;43.76923077;11.25588885;1215;209;1424;20733;22157;234;1001;139458;4837;166452;2922864;1547684
2021-03-09;SAR;5567;2757;2810;4760;732;75;0;ITG;ITG2;20;Sardegna;39.21531192;9.110616306;185;24;209;12511;12720;62;146;28052;1187;41959;825971;548679
2021-03-09;LAZ;22089;9984;12105;16486;5233;370;0;ITI;ITI4;12;Lazio;41.89277044;12.48366722;2049;261;2310;36267;38577;651;1431;202106;6092;246775;4408743;2999629
2021-03-09;CAM;14145;6878;7267;9892;3799;454;0;ITF;ITF3;15;Campania;40.83956555;14.25084984;1444;144;1588;89645;91233;1326;2709;193791;4550;289574;3126088;2155989
2021-03-09;FVG;4028;1734;2294;1244;2757;27;0;ITH;ITH4;6;Friuli-Venezia Giulia;45.6494354;13.76813649;478;60;538;11672;12210;173;598;66609;2943;81762;1417187;505764
2021-03-09;SIC;13192;5782;7410;10842;2218;132;0;ITG;ITG1;19;Sicilia;38.11569725;13.362356699999998;665;112;777;13425;14202;-1197;595;139024;4272;157498;2654023;1171248
2021-03-09;LOM;33279;12886;20393;25253;7427;599;0;ITC;ITC4;3;Lombardia;45.46679409;9.190347404;5416;611;6027;76316;82343;2214;4084;529166;28853;640362;7050291;3233592
2021-03-09;PUG;13706;6126;7580;11498;2022;186;0;ITF;ITF4;16;Puglia;41.12559576;16.86736689;1369;163;1532;34273;35805;598;1286;117371;4161;157337;1637604;900847
2021-03-09;EMR;14808;6038;8770;10759;3953;96;0;ITH;ITH5;8;Emilia-Romagna;44.49436681;11.341720800000001;3044;307;3351;55045;58396;1378;2429;215754;10871;285021;4150207;1563217
2021-03-09;MAR;5430;2293;3137;4457;881;92;0;ITI;ITI3;11;Marche;43.61675973;13.5188753;631;103;734;9424;10158;-28;423;61375;2350;73883;883973;541127
2021-03-09;PIE;14347;5742;8605;11755;2355;237;0;ITC;ITC1;1;Piemonte;45.0732745;7.680687483;2432;228;2660;21122;23782;900;2018;229138;9533;262453;2770099;1326033
2021-03-09;LIG;5942;2757;3185;4450;1434;58;0;ITC;ITC3;7;Liguria;44.41149315;8.9326992;521;62;583;5347;5930;-19;248;71235;3698;80863;1090485;462299
2021-03-09;MOL;1343;585;758;1156;154;33;0;ITF;ITF2;14;Molise;41.55774754;14.65916051;89;19;108;1585;1693;-65;49;9042;373;11108;167177;151412
2021-03-09;PAB;1195;544;651;1165;2;28;0;ITH;ITH1;4;Provincia Autonoma Bolzano / Bozen;46.49933453;11.35662422;183;37;220;5391;5611;-725;218;48475;1056;55142;869575;198664
2021-03-09;VDA;206;96;110;167;32;7;0;ITC;ITC2;2;Valle d'Aosta / Vallée d'Aoste;45.73750286;7.320149366;9;2;11;166;177;4;7;7527;417;8121;80334;45301
2021-03-09;ABR;5178;1806;3372;4147;939;92;0;ITF;ITF1;13;Abruzzo;42.35122196;13.39843823;665;84;749;12695;13444;-121;273;42510;1813;57767;1076297;531894
2021-03-09;BAS;1422;727;695;782;616;24;0;ITF;ITF5;17;Basilicata;40.63947052;15.80514834;114;14;128;3674;3802;124;182;12616;381;16799;263837;154286
2021-03-10;MOL;1753;726;1027;1679;50;24;0;ITF;ITF2;14;Molise;41.55774754;14.65916051;94;19;113;1563;1676;-17;67;9121;378;11175;168062;152251
2021-03-10;MAR;5711;2442;3269;4477;1180;54;0;ITI;ITI3;11;Marche;43.61675973;13.5188753;653;107;760;9885;10645;487;881;61756;2363;74764;893346;545803
2021-03-10;PUG;14876;6653;8223;11566;3142;168;0;ITF;ITF4;16;Puglia;41.12559576;16.86736689;1397;165;1562;35033;36595;790;1571;118125;4188;158908;1649866;907618
2021-03-10;PAB;1277;537;740;1083;144;50;0;ITH;ITH1;4;Provincia Autonoma Bolzano / Bozen;46.49933453;11.35662422;191;38;229;5127;5356;-255;182;48909;1059;55324;876679;199185
2021-03-10;EMR;18818;7745;11073;12989;5647;182;0;ITH;ITH5;8;Emilia-Romagna;44.49436681;11.341720800000001;3094;333;3427;56021;59448;1052;2155;216774;10914;287136;4191621;1570268
2021-03-10;ABR;5049;1686;3363;4025;957;67;0;ITF;ITF1;13;Abruzzo;42.35122196;13.39843823;672;87;759;12566;13325;-119;187;42804;1825;57954;1082318;533756
2021-03-10;BAS;1690;848;842;840;839;11;0;ITF;ITF5;17;Basilicata;40.63947052;15.80514834;105;16;121;3719;3840;38;115;12693;381;16914;265378;155084
2021-03-10;LAZ;23421;10705;12716;17353;5694;374;0;ITI;ITI4;12;Lazio;41.89277044;12.48366722;2076;267;2343;36533;38876;299;1654;203439;6114;248429;4447144;3022111
2021-03-10;UMB;4033;1944;2089;2761;1257;15;0;ITI;ITI2;10;Umbria;43.10675841;12.38824698;423;80;503;6776;7279;-146;242;38060;1100;46439;853994;319449
2021-03-10;VDA;439;184;255;220;214;5;0;ITC;ITC2;2;Valle d'Aosta / Vallée d'Aoste;45.73750286;7.320149366;9;2;11;190;201;24;30;7533;417;8151;80483;45355
2021-03-10;CAL;6896;3513;3383;5477;1380;39;0;ITF;ITF6;18;Calabria;38.90597598;16.59440194;236;33;269;6499;6768;162;283;32411;712;39891;608146;573121
2021-03-10;TOS;18415;7423;10992;14315;3994;106;0;ITI;ITI1;9;Toscana;43.76923077;11.25588885;1248;208;1456;21041;22497;340;1293;140391;4857;167745;2948810;1560327
2021-03-10;SAR;6086;2966;3120;5148;856;82;0;ITG;ITG2;20;Sardegna;39.21531192;9.110616306;171;25;196;12484;12680;-40;65;28155;1189;42024;828468;550751
2021-03-10;SIC;13961;6135;7826;11625;2187;149;0;ITG;ITG1;19;Sicilia;38.11569725;13.362356699999998;667;108;775;12906;13681;-521;695;140225;4287;158193;2678017;1176363
2021-03-10;CAM;15641;7741;7900;8419;6853;369;0;ITF;ITF3;15;Campania;40.83956555;14.25084984;1471;143;1614;90813;92427;1194;3034;195605;4576;292608;3151955;2171408
2021-03-10;VEN;19044;8728;10316;12960;5686;398;0;ITH;ITH3;5;Veneto;45.43490485;12.33845213;1061;148;1209;29579;30788;578;1561;305625;10023;346436;5380235;1439870
2021-03-10;LOM;33376;12764;20612;24852;7914;610;0;ITC;ITC4;3;Lombardia;45.46679409;9.190347404;5584;617;6201;78866;85067;2724;4422;530794;28923;644784;7105826;3247120
2021-03-10;FVG;3601;1710;1891;1743;1796;62;0;ITH;ITH4;6;Friuli-Venezia Giulia;45.6494354;13.76813649;489;64;553;12118;12671;461;866;67002;2955;82628;1426745;509563
2021-03-10;PIE;13962;5456;8506;11394;2297;271;0;ITC;ITC1;1;Piemonte;45.0732745;7.680687483;2532;244;2776;21901;24677;895;2086;230300;9562;264539;2793857;1335453
2021-03-10;LIG;5924;2868;3056;3952;1917;55;0;ITC;ITC3;7;Liguria;44.41149315;8.9326992;526;67;593;5422;6015;85;342;71484;3706;81205;1098430;465215
2021-03-10;PAT;2486;973;1513;1473;948;65;0;ITH;ITH2;4;Provincia Autonoma Trento;46.06893511;11.12123097;199;49;248;3697;3945;-199;213;31050;1227;36222;637622;175291
2021-03-11;UMB;3687;1799;1888;2668;1008;11;0;ITI;ITI2;10;Umbria;43.10675841;12.38824698;432;84;516;6439;6955;-324;42;38416;1110;46481;854802;319574
2021-03-11;CAL;7327;3483;3844;5953;1321;53;0;ITF;ITF6;18;Calabria;38.90597598;16.59440194;243;30;273;6815;7088;320;414;32503;714;40305;611395;576340
2021-03-11;EMR;17501;7332;10169;11455;5859;187;0;ITH;ITH5;8;Emilia-Romagna;44.49436681;11.341720800000001;3161;345;3506;57160;60666;1218;2845;218332;10959;289957;4231453;1577396
2021-03-11;SAR;6466;3112;3354;5172;1209;85;0;ITG;ITG2;20;Sardegna;39.21531192;9.110616306;174;23;197;12568;12765;85;128;28198;1189;42152;835291;552871
2021-03-11;CAM;18029;9078;8951;10270;7293;466;0;ITF;ITF3;15;Campania;40.83956555;14.25084984;1492;156;1648;92059;93707;1280;2981;197279;4603;295589;3179420;2188861
2021-03-11;LOM;36294;13512;22782;25640;9965;689;0;ITC;ITC4;3;Lombardia;45.46679409;9.190347404;5718;645;6363;82305;88668;3601;5849;532961;29004;650633;7168048;3263973
2021-03-11;LIG;6425;3104;3321;4357;2015;53;0;ITC;ITC3;7;Liguria;44.41149315;8.9326992;514;64;578;5482;6060;45;405;71839;3711;81610;1106134;468303
2021-03-11;FVG;3487;1523;1964;1715;1757;15;0;ITH;ITH4;6;Friuli-Venezia Giulia;45.6494354;13.76813649;497;61;558;12616;13174;503;991;67474;2971;83619;1437532;514073
2021-03-11;PIE;14052;5325;8727;10697;3103;252;0;ITC;ITC1;1;Piemonte;45.0732745;7.680687483;2605;243;2848;23157;26005;1328;2322;231252;9604;266861;2822179;1346009
2021-03-11;VEN;19838;8893;10945;13795;5576;467;0;ITH;ITH3;5;Veneto;45.43490485;12.33845213;1073;154;1227;30447;31674;886;1677;306394;10045;348113;5423229;1445265
2021-03-11;LAZ;25558;12058;13500;18887;6299;372;0;ITI;ITI4;12;Lazio;41.89277044;12.48366722;2088;258;2346;36992;39338;462;1800;204761;6130;250229;4486486;3045212
2021-03-11;SIC;15463;6716;8747;12888;2418;157;0;ITG;ITG1;19;Sicilia;38.11569725;13.362356699999998;671;100;771;12751;13522;-159;672;141038;4305;158865;2701655;1181273
2021-03-11;PAT;2633;989;1644;1512;1061;60;0;ITH;ITH2;4;Provincia Autonoma Trento;46.06893511;11.12123097;201;49;250;3760;4010;65;405;31385;1232;36627;641794;175919
2021-03-11;TOS;16048;6419;9629;12491;3371;186;0;ITI;ITI1;9;Toscana;43.76923077;11.25588885;1280;208;1488;21409;22897;400;1302;141273;4877;169047;2974400;1573504
2021-03-11;MOL;1481;644;837;1455;6;20;0;ITF;ITF2;14;Molise;41.55774754;14.65916051;95;20;115;1510;1625;-51;35;9206;379;11210;168528;152677
2021-03-11;PUG;14876;6609;8267;11471;3197;208;0;ITF;ITF4;16;Puglia;41.12559576;16.86736689;1399;172;1571;35415;36986;391;1634;119351;4205;160542;1660804;913342
2021-03-11;ABR;5494;2216;3278;4264;1140;90;0;ITF;ITF1;13;Abruzzo;42.35122196;13.39843823;669;87;756;12477;13233;-92;372;43255;1835;58323;1093461;536762
2021-03-11;BAS;1806;936;870;819;966;21;0;ITF;ITF5;17;Basilicata;40.63947052;15.80514834;118;13;131;3784;3915;75;151;12766;384;17065;267202;156047
2021-03-11;VDA;392;164;228;152;239;1;0;ITC;ITC2;2;Valle d'Aosta / Vallée d'Aoste;45.73750286;7.320149366;9;2;11;184;195;-6;8;7547;417;8159;80938;45538
2021-03-11;MAR;6637;2824;3813;5144;1412;81;0;ITI;ITI3;11;Marche;43.61675973;13.5188753;662;107;769;10063;10832;187;921;62480;2373;75685;900193;550130
2021-03-11;PAB;1692;831;861;1105;538;49;0;ITH;ITH1;4;Provincia Autonoma Bolzano / Bozen;46.49933453;11.35662422;195;39;234;4896;5130;-226;88;49219;1063;55412;882251;199328
2021-03-12;PUG;14333;6466;7867;10237;3950;146;0;ITF;ITF4;16;Puglia;41.12559576;16.86736689;1409;174;1583;35723;37306;320;1774;120773;4237;162316;1672408;919500
2021-03-12;MAR;4681;1999;2682;3346;1280;55;0;ITI;ITI3;11;Marche;43.61675973;13.5188753;673;111;784;10074;10858;26;874;63317;2384;76559;906059;553703
2021-03-12;VDA;535;177;358;301;226;8;0;ITC;ITC2;2;Valle d'Aosta / Vallée d'Aoste;45.73750286;7.320149366;12;2;14;194;208;13;20;7554;417;8179;81547;45831
2021-03-12;PAB;1669;737;932;1223;413;33;0;ITH;ITH1;4;Provincia Autonoma Bolzano / Bozen;46.49933453;11.35662422;176;39;215;4618;4833;-297;178;49689;1068;55590;896701;199546
2021-03-12;ABR;6043;1993;4050;4353;1610;80;0;ITF;ITF1;13;Abruzzo;42.35122196;13.39843823;661;91;752;12146;12898;-335;608;44161;1872;58931;1105217;539957
2021-03-12;PAT;2603;991;1612;1709;815;79;0;ITH;ITH2;4;Provincia Autonoma Trento;46.06893511;11.12123097;198;49;247;3880;4127;117;370;31637;1233;36997;645459;176427
2021-03-12;LAZ;24200;11195;13005;17388;6432;380;0;ITI;ITI4;12;Lazio;41.89277044;12.48366722;2128;270;2398;37916;40314;976;1757;205518;6154;251986;4524961;3067214
2021-03-12;MOL;1474;642;832;1410;36;28;0;ITF;ITF2;14;Molise;41.55774754;14.65916051;99;26;125;1459;1584;-41;24;9271;379;11234;169009;153118
2021-03-12;BAS;1924;988;936;785;1109;30;0;ITF;ITF5;17;Basilicata;40.63947052;15.80514834;124;13;137;3795;3932;17;141;12889;385;17206;268805;156939
2021-03-12;FVG;4257;1786;2471;2834;1397;26;0;ITH;ITH4;6;Friuli-Venezia Giulia;45.6494354;13.76813649;498;65;563;13178;13741;567;971;67864;2985;84590;1449956;518821
2021-03-12;SAR;6030;2635;3395;4554;1318;158;0;ITG;ITG2;20;Sardegna;39.21531192;9.110616306;177;22;199;12561;12760;-5;106;28306;1192;42258;839588;555208
2021-03-12;UMB;2695;1082;1613;2191;496;8;0;ITI;ITI2;10;Umbria;43.10675841;12.38824698;431;79;510;6360;6870;-85;232;38726;1117;46713;863325;320767
2021-03-12;PIE;14242;5414;8828;10999;2950;293;0;ITC;ITC1;1;Piemonte;45.0732745;7.680687483;2684;247;2931;24708;27639;1634;2929;232519;9632;269790;2851854;1356275
2021-03-12;CAM;14586;7416;7170;8132;6089;365;0;ITF;ITF3;15;Campania;40.83956555;14.25084984;1502;149;1651;93253;94904;1197;2644;198697;4632;298233;3201486;2200125
2021-03-12;LOM;35349;12995;22354;24465;10263;621;0;ITC;ITC4;3;Lombardia;45.46679409;9.190347404;5909;667;6576;86149;92725;4057;6262;535077;29093;656895;7229002;3280523
2021-03-12;SIC;12896;5576;7320;10663;2071;162;0;ITG;ITG1;19;Sicilia;38.11569725;13.362356699999998;671;101;772;13024;13796;274;679;141430;4318;159544;2727332;1186468
2021-03-12;VEN;18664;8196;10468;11327;6752;585;0;ITH;ITH3;5;Veneto;45.43490485;12.33845213;1106;154;1260;31290;32550;876;1932;307421;10074;350045;5469375;1450815
2021-03-12;TOS;17047;6646;10401;13320;3532;195;0;ITI;ITI1;9;Toscana;43.76923077;11.25588885;1292;218;1510;21684;23194;297;1304;142255;4902;170351;2999126;1585470
2021-03-12;EMR;18328;7712;10616;11310;6721;297;0;ITH;ITH5;8;Emilia-Romagna;44.49436681;11.341720800000001;3197;350;3547;59070;62617;1951;3477;219789;10994;293400;4278613;1585015
2021-03-12;LIG;6226;2875;3351;3691;2477;58;0;ITC;ITC3;7;Liguria;44.41149315;8.9326992;512;64;576;5615;6191;131;406;72105;3720;82016;1113258;471127
2021-03-12;CAL;5165;2474;2691;4074;1067;24;0;ITF;ITF6;18;Calabria;38.90597598;16.59440194;245;34;279;6941;7220;132;305;32671;719;40610;614209;578898
2021-03-13;VDA;149;88;61;142;0;7;0;ITC;ITC2;2;Valle d'Aosta / Vallée d'Aoste;45.73750286;7.320149366;12;2;14;216;230;22;33;7565;417;8212;82090;46037
2021-03-13;BAS;1812;896;916;740;1050;22;0;ITF;ITF5;17;Basilicata;40.63947052;15.80514834;122;14;136;3892;4028;96;137;12929;386;17343;270303;157618
2021-03-13;LAZ;21867;8765;13102;15701;5922;244;0;ITI;ITI4;12;Lazio;41.89277044;12.48366722;2172;278;2450;39055;41505;1191;1998;206306;6173;253984;4567128;3090317
2021-03-13;SAR;2777;1086;1691;2452;281;44;0;ITG;ITG2;20;Sardegna;39.21531192;9.110616306;173;26;199;12590;12789;29;103;28377;1195;42361;842079;557286
2021-03-13;SIC;12227;5396;6831;7635;4499;93;0;ITG;ITG1;19;Sicilia;38.11569725;13.362356699999998;684;99;783;13087;13870;74;650;141993;4331;160194;2753838;1191491
2021-03-13;EMR;16147;6366;9781;10593;5314;240;0;ITH;ITH5;8;Emilia-Romagna;44.49436681;11.341720800000001;3254;354;3608;60879;64487;1870;2950;220812;11025;296324;4317841;1592539
2021-03-13;CAL;7044;3052;3992;5948;1058;38;0;ITF;ITF6;18;Calabria;38.90597598;16.59440194;244;32;276;7135;7411;191;275;32750;724;40885;616909;581330
2021-03-13;PIE;13060;4729;8331;11354;1432;274;0;ITC;ITC1;1;Piemonte;45.0732745;7.680687483;2790;251;3041;25636;28677;1038;2159;233612;9660;271949;2883525;1366697
2021-03-13;MAR;5811;2681;3130;1764;4003;44;0;ITI;ITI3;11;Marche;43.61675973;13.5188753;695;118;813;10250;11063;205;1000;64101;2395;77559;912707;557484
2021-03-13;FVG;2949;1124;1825;1662;1274;13;0;ITH;ITH4;6;Friuli-Venezia Giulia;45.6494354;13.76813649;504;65;569;13606;14175;434;953;68368;3000;85543;1460244;522935
2021-03-13;CAM;14526;7044;7482;8943;5283;300;0;ITF;ITF3;15;Campania;40.83956555;14.25084984;1547;150;1697;94435;96132;1228;2940;200386;4655;301173;3228749;2216654
2021-03-13;LOM;27241;9797;17444;20558;6124;559;0;ITC;ITC4;3;Lombardia;45.46679409;9.190347404;6068;694;6762;87731;94493;1768;5809;539052;29159;662704;7288380;3296269
2021-03-13;VEN;17243;7313;9930;13738;3132;373;0;ITH;ITH3;5;Veneto;45.43490485;12.33845213;1111;170;1281;32781;34062;1512;2682;308567;10098;352727;5521174;1458362
2021-03-13;PAT;965;496;469;841;48;76;0;ITH;ITH2;4;Provincia Autonoma Trento;46.06893511;11.12123097;194;46;240;3899;4139;12;281;31905;1234;37278;648801;176835
2021-03-13;PAB;2886;1460;1426;2747;101;38;0;ITH;ITH1;4;Provincia Autonoma Bolzano / Bozen;46.49933453;11.35662422;178;40;218;4517;4735;-98;213;49907;1070;55712;909426;199950
2021-03-13;TOS;9313;3317;5996;5189;3969;155;0;ITI;ITI1;9;Toscana;43.76923077;11.25588885;1332;217;1549;22180;23729;535;1326;143026;4922;171677;3022670;1597260
2021-03-13;LIG;3853;1638;2215;2964;859;30;0;ITC;ITC3;7;Liguria;44.41149315;8.9326992;512;64;576;5653;6229;38;307;72366;3728;82323;1120022;473756
2021-03-13;ABR;4122;1420;2702;3016;1043;63;0;ITF;ITF1;13;Abruzzo;42.35122196;13.39843823;652;92;744;12166;12910;12;515;44653;1883;59446;1112423;541838
2021-03-13;PUG;10489;4141;6348;8573;1817;99;0;ITF;ITF4;16;Puglia;41.12559576;16.86736689;1442;175;1617;36750;38367;1061;1700;121389;4260;164016;1682730;925360
2021-03-13;MOL;1196;600;596;184;991;21;0;ITF;ITF2;14;Molise;41.55774754;14.65916051;99;24;123;1450;1573;-11;80;9360;381;11314;170315;154301
2021-03-13;UMB;1735;524;1211;1486;249;0;0;ITI;ITI2;10;Umbria;43.10675841;12.38824698;413;80;493;6147;6640;-230;296;39243;1126;47009;870154;321924
2021-03-14;PIE;8222;3343;4879;5177;2903;142;0;ITC;ITC1;1;Piemonte;45.0732745;7.680687483;2886;267;3153;26499;29652;975;1530;234164;9663;273479;2898813;1373229
2021-03-14;SAR;613;379;234;602;1;10;0;ITG;ITG2;20;Sardegna;39.21531192;9.110616306;171;27;198;12682;12880;91;118;28404;1195;42479;844277;559128
2021-03-14;LIG;1659;752;907;1043;604;12;0;ITC;ITC3;7;Liguria;44.41149315;8.9326992;535;63;598;5666;6264;35;321;72644;3736;82644;1125189;475801
2021-03-14;SIC;8785;3932;4853;4896;3837;52;0;ITG;ITG1;19;Sicilia;38.11569725;13.362356699999998;691;100;791;13532;14323;453;613;142140;4344;160807;2775652;1195760
2021-03-14;LOM;14886;5351;9535;11217;3290;379;0;ITC;ITC4;3;Lombardia;45.46679409;9.190347404;6077;714;6791;90696;97487;2994;4334;540331;29220;667038;7333393;3309332
2021-03-14;PAT;110;67;43;19;89;2;0;ITH;ITH2;4;Provincia Autonoma Trento;46.06893511;11.12123097;192;45;237;3948;4185;46;239;32096;1236;37517;652495;177169
2021-03-14;FVG;1404;555;849;1125;252;27;0;ITH;ITH4;6;Friuli-Venezia Giulia;45.6494354;13.76813649;528;67;595;13746;14341;166;604;68796;3010;86147;1467421;526212
2021-03-14;VEN;15187;5945;9242;13842;894;451;0;ITH;ITH3;5;Veneto;45.43490485;12.33845213;1107;181;1288;33718;35006;944;1587;309202;10106;354314;5548069;1462987
2021-03-14;PAB;758;336;422;24;733;1;0;ITH;ITH1;4;Provincia Autonoma Bolzano / Bozen;46.49933453;11.35662422;169;38;207;4445;4652;-83;203;50192;1071;55915;921107;200257
2021-03-14;ABR;1886;732;1154;1204;669;13;0;ITF;ITF1;13;Abruzzo;42.35122196;13.39843823;649;94;743;11893;12636;-274;320;45235;1894;59765;1119402;543997
2021-03-14;BAS;1016;481;535;532;471;13;0;ITF;ITF5;17;Basilicata;40.63947052;15.80514834;144;16;160;3931;4091;63;106;12971;387;17449;271582;158193
2021-03-14;MAR;2499;1032;1467;1896;592;11;0;ITI;ITI3;11;Marche;43.61675973;13.5188753;703;131;834;10076;10910;-153;616;64854;2411;78175;918705;561112
2021-03-14;PUG;3385;1466;1919;2474;868;43;0;ITF;ITF4;16;Puglia;41.12559576;16.86736689;1458;174;1632;37510;39142;775;1542;122147;4269;165558;1691681;928007
2021-03-14;VDA;394;202;192;376;0;18;0;ITC;ITC2;2;Valle d'Aosta / Vallée d'Aoste;45.73750286;7.320149366;12;2;14;233;247;17;28;7576;417;8240;82395;46155
2021-03-14;UMB;66;48;18;66;0;0;0;ITI;ITI2;10;Umbria;43.10675841;12.38824698;407;80;487;6110;6597;-43;283;39565;1130;47292;876405;322906
2021-03-14;LAZ;17317;6784;10533;11855;5184;278;0;ITI;ITI4;12;Lazio;41.89277044;12.48366722;2214;279;2493;40094;42587;1082;1812;207026;6183;255796;4605971;3111867
2021-03-14;CAM;8620;3829;4791;4356;4142;122;0;ITF;ITF3;15;Campania;40.83956555;14.25084984;1529;161;1690;95305;96995;863;2449;201943;4684;303622;3251075;2229592
2021-03-14;CAL;2777;1073;1704;2283;487;7;0;ITF;ITF6;18;Calabria;38.90597598;16.59440194;246;30;276;7281;7557;146;300;32896;732;41185;619309;583366
2021-03-14;TOS;7191;2577;4614;3163;3935;93;0;ITI;ITI1;9;Toscana;43.76923077;11.25588885;1363;236;1599;22666;24265;536;1305;143776;4941;172982;3043910;1608201
2021-03-14;MOL;601;242;359;18;583;0;0;ITF;ITF2;14;Molise;41.55774754;14.65916051;105;20;125;1424;1549;-24;84;9462;387;11398;171059;154997
2021-03-14;EMR;8809;3841;4968;4944;3801;64;0;ITH;ITH5;8;Emilia-Romagna;44.49436681;11.341720800000001;3321;364;3685;62883;66568;2081;3023;221695;11076;299339;4342750;1600466
2021-03-15;VDA;387;141;246;175;203;9;0;ITC;ITC2;2;Valle d'Aosta / Vallée d'Aoste;45.73750286;7.320149366;15;2;17;255;272;25;31;7582;417;8271;83088;46415
2021-03-15;BAS;2393;999;1394;522;1852;19;0;ITF;ITF5;17;Basilicata;40.63947052;15.80514834;157;17;174;3947;4121;30;67;13008;387;17516;272257;158614
2021-03-15;ABR;3679;1444;2235;1840;1807;32;0;ITF;ITF1;13;Abruzzo;42.35122196;13.39843823;673;93;766;12074;12840;204;323;45347;1901;60088;1128280;546436
2021-03-15;MOL;855;350;505;577;245;33;0;ITF;ITF2;14;Molise;41.55774754;14.65916051;102;18;120;1440;1560;11;73;9516;395;11471;172010;155857
2021-03-15;TOS;8704;3648;5056;4079;4449;176;0;ITI;ITI1;9;Toscana;43.76923077;11.25588885;1402;241;1643;22923;24566;301;1106;144570;4952;174088;3056620;1614523
2021-03-15;CAL;3671;1774;1897;2167;1492;12;0;ITF;ITF6;18;Calabria;38.90597598;16.59440194;258;28;286;7350;7636;79;213;33026;736;41398;621131;585008
2021-03-15;VEN;16673;7330;9343;10954;5213;506;0;ITH;ITH3;5;Veneto;45.43490485;12.33845213;1141;186;1327;33997;35324;318;841;309715;10116;355155;5559802;1466126
2021-03-15;EMR;13468;6256;7212;6856;6508;104;0;ITH;ITH5;8;Emilia-Romagna;44.49436681;11.341720800000001;3464;373;3837;64456;68293;1725;2822;222718;11137;302148;4358517;1604554
2021-03-15;SAR;2828;1328;1500;2409;377;42;0;ITG;ITG2;20;Sardegna;39.21531192;9.110616306;176;27;203;12632;12835;-45;74;28521;1197;42553;864765;560159
2021-03-15;UMB;4600;1941;2659;2826;1770;4;0;ITI;ITI2;10;Umbria;43.10675841;12.38824698;403;79;482;5879;6361;-236;219;40013;1137;47511;882935;323934
2021-03-15;LOM;31644;11365;20279;22427;8590;627;0;ITC;ITC4;3;Lombardia;45.46679409;9.190347404;6198;728;6926;86237;93163;-4324;2185;546761;29299;669223;7354998;3316622
2021-03-15;CAM;13357;6501;6856;8303;4749;305;0;ITF;ITF3;15;Campania;40.83956555;14.25084984;1543;161;1704;95342;97046;51;1823;203680;4719;305445;3263727;2236777
2021-03-15;LAZ;21068;9897;11171;14012;6779;277;0;ITI;ITI4;12;Lazio;41.89277044;12.48366722;2297;293;2590;40849;43439;852;1536;207690;6203;257332;4624111;3121821
2021-03-15;SIC;10693;4737;5956;5658;4955;80;0;ITG;ITG1;19;Sicilia;38.11569725;13.362356699999998;718;107;825;13931;14756;433;523;142216;4358;161330;2797107;1200327
2021-03-15;LIG;7371;3123;4248;4501;2822;48;0;ITC;ITC3;7;Liguria;44.41149315;8.9326992;568;64;632;5705;6337;73;242;72800;3749;82886;1128547;477095
2021-03-15;MAR;4452;2061;2391;1291;3140;21;0;ITI;ITI3;11;Marche;43.61675973;13.5188753;722;132;854;9588;10442;-468;415;65726;2422;78590;921358;562363
2021-03-15;PAB;1196;452;744;697;484;15;0;ITH;ITH1;4;Provincia Autonoma Bolzano / Bozen;46.49933453;11.35662422;166;38;204;4149;4353;-299;147;50632;1077;56062;931798;200526
2021-03-15;PUG;12368;6164;6204;5742;6519;107;0;ITF;ITF4;16;Puglia;41.12559576;16.86736689;1512;189;1701;37422;39123;-19;715;122847;4303;166273;1696388;930891
2021-03-15;PAT;1453;573;880;929;469;55;0;ITH;ITH2;4;Provincia Autonoma Trento;46.06893511;11.12123097;200;47;247;4065;4312;127;273;32241;1237;37790;655199;177613
2021-03-15;FVG;3973;1820;2153;1616;2332;25;0;ITH;ITH4;6;Friuli-Venezia Giulia;45.6494354;13.76813649;532;70;602;13836;14438;97;398;69080;3027;86545;1471079;527746
2021-03-15;PIE;10712;4201;6511;4940;5615;157;0;ITC;ITC1;1;Piemonte;45.0732745;7.680687483;3070;276;3346;26854;30200;548;1742;235339;9682;275221;2912976;1377915
2021-03-16;FVG;3197;1304;1893;1027;2085;85;0;ITH;ITH4;6;Friuli-Venezia Giulia;45.6494354;13.76813649;530;77;607;14167;14774;336;672;69401;3042;87217;1481351;530744
2021-03-16;CAM;8090;3519;4571;3695;4317;78;0;ITF;ITF3;15;Campania;40.83956555;14.25084984;1560;165;1725;96348;98073;1027;2656;205244;4784;308101;3286183;2251349
2021-03-16;LAZ;13649;5784;7865;7046;6519;84;0;ITI;ITI4;12;Lazio;41.89277044;12.48366722;2399;294;2693;41601;44294;855;1497;208300;6235;258829;4663006;3143184
2021-03-16;LOM;25545;10134;15411;16309;9113;123;0;ITC;ITC4;3;Lombardia;45.46679409;9.190347404;6474;765;7239;88537;95776;2613;4235;548302;29380;673458;7404066;3327916
2021-03-16;PIE;10549;4285;6264;4378;6076;95;0;ITC;ITC1;1;Piemonte;45.0732745;7.680687483;3169;299;3468;27316;30784;584;2074;236786;9725;277295;2940674;1388528
2021-03-16;CAL;3876;1901;1975;2182;1681;13;0;ITF;ITF6;18;Calabria;38.90597598;16.59440194;277;29;306;7428;7734;98;311;33235;740;41709;623952;587641
2021-03-16;UMB;3538;1454;2084;1909;1627;2;0;ITI;ITI2;10;Umbria;43.10675841;12.38824698;391;80;471;5681;6152;-209;196;40408;1147;47707;889113;324742
2021-03-16;EMR;12256;5028;7228;4875;7316;65;0;ITH;ITH5;8;Emilia-Romagna;44.49436681;11.341720800000001;3516;378;3894;65098;68992;699;2184;224138;11184;304314;4399542;1609388
2021-03-16;VEN;12539;5358;7181;6634;5626;279;0;ITH;ITH3;5;Veneto;45.43490485;12.33845213;1282;186;1468;34245;35713;389;1901;311143;10200;357056;5620569;1472876
2021-03-16;SAR;4450;1968;2482;3473;930;47;0;ITG;ITG2;20;Sardegna;39.21531192;9.110616306;172;29;201;12615;12816;-19;79;28618;1198;42632;873937;562448
2021-03-16;MAR;3522;1523;1999;284;3232;6;0;ITI;ITI3;11;Marche;43.61675973;13.5188753;735;133;868;9284;10152;-290;529;66530;2437;79119;926935;565765
2021-03-16;PAT;1407;514;893;581;792;34;0;ITH;ITH2;4;Provincia Autonoma Trento;46.06893511;11.12123097;213;48;261;3795;4056;-256;104;32597;1241;37894;656446;177981
2021-03-16;SIC;9643;4334;5309;3568;6003;72;0;ITG;ITG1;19;Sicilia;38.11569725;13.362356699999998;725;113;838;13938;14776;20;598;142781;4371;161928;2821658;1205091
2021-03-16;LIG;6093;2733;3360;2318;3736;39;0;ITC;ITC3;7;Liguria;44.41149315;8.9326992;570;65;635;5483;6118;-219;343;73350;3761;83229;1136081;479721
2021-03-16;PUG;9898;4699;5199;3454;6385;59;0;ITF;ITF4;16;Puglia;41.12559576;16.86736689;1554;196;1750;37464;39214;91;1126;123852;4333;167399;1707351;937016
2021-03-16;TOS;4923;1888;3035;2583;2259;81;0;ITI;ITI1;9;Toscana;43.76923077;11.25588885;1430;239;1669;23226;24895;329;1247;145470;4970;175335;3080090;1623906
2021-03-16;PAB;1290;532;758;116;1166;8;0;ITH;ITH1;4;Provincia Autonoma Bolzano / Bozen;46.49933453;11.35662422;155;36;191;4028;4219;-134;183;50943;1079;56241;944072;200838
2021-03-16;VDA;186;37;149;109;68;9;0;ITC;ITC2;2;Valle d'Aosta / Vallée d'Aoste;45.73750286;7.320149366;14;2;16;286;302;30;34;7586;417;8305;83510;46596
2021-03-16;MOL;618;230;388;266;348;4;0;ITF;ITF2;14;Molise;41.55774754;14.65916051;101;18;119;1461;1580;20;104;9598;397;11575;172869;156640
2021-03-16;ABR;3487;1453;2034;1804;1655;28;0;ITF;ITF1;13;Abruzzo;42.35122196;13.39843823;685;87;772;12034;12806;-34;329;45699;1911;60416;1136202;548134
2021-03-16;BAS;1928;810;1118;227;1698;3;0;ITF;ITF5;17;Basilicata;40.63947052;15.80514834;163;16;179;3972;4151;30;166;13138;393;17682;274148;159562
2021-03-17;MAR;3477;1525;1952;105;3370;2;0;ITI;ITI3;11;Marche;43.61675973;13.5188753;747;133;880;9237;10117;-35;856;67406;2452;79975;934546;570398
2021-03-17;MOL;977;407;570;526;333;118;0;ITF;ITF2;14;Molise;41.55774754;14.65916051;96;18;114;1446;1560;-20;52;9668;399;11627;173775;157468
2021-03-17;PAB;582;213;369;546;1;35;0;ITH;ITH1;4;Provincia Autonoma Bolzano / Bozen;46.49933453;11.35662422;160;33;193;3892;4085;-134;103;51174;1082;56341;950162;201034
2021-03-17;VDA;438;185;253;259;165;14;0;ITC;ITC2;2;Valle d'Aosta / Vallée d'Aoste;45.73750286;7.320149366;15;3;18;315;333;31;36;7591;417;8341;83660;46651
2021-03-17;ABR;4539;1872;2667;2776;1740;23;0;ITF;ITF1;13;Abruzzo;42.35122196;13.39843823;675;87;762;11610;12372;-434;212;46330;1924;60626;1142531;549987
2021-03-17;UMB;3331;1313;2018;1855;1474;2;0;ITI;ITI2;10;Umbria;43.10675841;12.38824698;402;79;481;5618;6099;-53;270;40726;1152;47977;894581;325614
2021-03-17;SIC;15057;7445;7612;9077;5853;127;0;ITG;ITG1;19;Sicilia;38.11569725;13.362356699999998;734;116;850;14115;14965;189;782;143362;4383;162710;2848185;1210951
2021-03-17;BAS;1475;615;860;24;1447;4;0;ITF;ITF5;17;Basilicata;40.63947052;15.80514834;159;14;173;4012;4185;34;126;13226;397;17808;275626;160279
2021-03-17;EMR;13731;5699;8032;5817;7855;59;0;ITH;ITH5;8;Emilia-Romagna;44.49436681;11.341720800000001;3542;381;3923;65692;69615;623;2026;225473;11236;306324;4436998;1615543
2021-03-17;VEN;14646;5991;8655;7534;6797;315;0;ITH;ITH3;5;Veneto;45.43490485;12.33845213;1337;191;1528;34914;36442;729;2191;312546;10259;359247;5662414;1478907
2021-03-17;LAZ;13892;5955;7937;7460;6308;124;0;ITI;ITI4;12;Lazio;41.89277044;12.48366722;2408;296;2704;41575;44279;-15;1728;210023;6255;260557;4702106;3165435
2021-03-17;SAR;6631;2872;3759;4958;1633;40;0;ITG;ITG2;20;Sardegna;39.21531192;9.110616306;163;29;192;12627;12819;3;92;28705;1200;42724;886127;564522
2021-03-17;PIE;12542;5066;7476;5044;7309;189;0;ITC;ITC1;1;Piemonte;45.0732745;7.680687483;3281;315;3596;27798;31394;610;2374;238509;9766;279669;2967126;1398404
2021-03-17;TOS;11447;4603;6844;6821;4531;95;0;ITI;ITI1;9;Toscana;43.76923077;11.25588885;1453;241;1694;23213;24907;12;1275;146712;4991;176610;3105028;1634285
2021-03-17;LOM;26383;10545;15838;15159;11063;161;0;ITC;ITC4;3;Lombardia;45.46679409;9.190347404;6641;781;7422;88343;95765;-11;4490;552724;29459;677948;7463075;3341526
2021-03-17;CAM;11599;5103;6496;4845;6591;163;0;ITF;ITF3;15;Campania;40.83956555;14.25084984;1541;161;1702;96945;98647;574;2665;207302;4817;310766;3308575;2264594
2021-03-17;CAL;4208;1884;2324;2191;2006;11;0;ITF;ITF6;18;Calabria;38.90597598;16.59440194;283;28;311;7483;7794;60;216;33385;746;41925;627062;590565
2021-03-17;LIG;5561;2371;3190;2456;3086;19;0;ITC;ITC3;7;Liguria;44.41149315;8.9326992;574;63;637;5530;6167;49;321;73614;3769;83550;1143852;482547
2021-03-17;FVG;3244;1272;1972;737;2497;10;0;ITH;ITH4;6;Friuli-Venezia Giulia;45.6494354;13.76813649;538;76;614;14388;15002;228;986;70144;3057;88203;1495255;535476
2021-03-17;PAT;2131;813;1318;1130;907;94;0;ITH;ITH2;4;Provincia Autonoma Trento;46.06893511;11.12123097;207;52;259;3693;3952;-104;190;32889;1243;38084;660017;178446
2021-03-17;PUG;10362;4709;5653;4107;6192;63;0;ITF;ITF4;16;Puglia;41.12559576;16.86736689;1592;218;1810;38008;39818;604;1734;124948;4367;169133;1719822;944225
2021-03-18;UMB;2987;1179;1808;1713;1266;8;0;ITI;ITI2;10;Umbria;43.10675841;12.38824698;407;74;481;5506;5987;-112;66;40895;1161;48043;895537;325765
2021-03-18;TOS;9995;3989;6006;5864;3992;139;0;ITI;ITI1;9;Toscana;43.76923077;11.25588885;1454;246;1700;23638;25338;431;1513;147769;5016;178123;3129792;1645747
2021-03-18;PAT;2336;964;1372;1222;1089;25;0;ITH;ITH2;4;Provincia Autonoma Trento;46.06893511;11.12123097;199;54;253;3718;3971;19;285;33152;1246;38369;663363;178825
2021-03-18;FVG;3383;1427;1956;1689;1686;8;0;ITH;ITH4;6;Friuli-Venezia Giulia;45.6494354;13.76813649;545;77;622;14904;15526;524;1058;70659;3076;89261;1507695;539823
2021-03-18;PIE;11789;4819;6970;3844;7750;195;0;ITC;ITC1;1;Piemonte;45.0732745;7.680687483;3279;315;3594;28566;32160;766;2357;240055;9811;282026;2993495;1407590
2021-03-18;VEN;12626;5145;7481;7037;5236;353;0;ITH;ITH3;5;Veneto;45.43490485;12.33845213;1352;193;1545;35393;36938;496;1761;313775;10295;361008;5704636;1485190
2021-03-18;CAL;4520;2116;2404;2346;2148;26;0;ITF;ITF6;18;Calabria;38.90597598;16.59440194;294;33;327;7659;7986;192;404;33591;752;42329;630293;593571
2021-03-18;MOL;1220;495;725;637;465;118;0;ITF;ITF2;14;Molise;41.55774754;14.65916051;101;20;121;1402;1523;-37;17;9721;400;11644;173946;157630
2021-03-18;LAZ;14324;6120;8204;7779;6450;95;0;ITI;ITI4;12;Lazio;41.89277044;12.48366722;2422;299;2721;42198;44919;640;1963;211323;6278;262520;4738397;3187092
2021-03-18;LOM;27476;10987;16489;15943;11306;227;0;ITC;ITC4;3;Lombardia;45.46679409;9.190347404;6744;786;7530;91539;99069;3304;5641;554969;29551;683589;7526272;3358604
2021-03-18;CAM;12180;5382;6798;5755;6193;232;0;ITF;ITF3;15;Campania;40.83956555;14.25084984;1562;153;1715;97844;99559;912;2223;208600;4830;312989;3329255;2280825
2021-03-18;MAR;3440;1507;1933;149;3279;12;0;ITI;ITI3;11;Marche;43.61675973;13.5188753;752;139;891;9252;10143;26;820;68188;2464;80795;940714;573891
2021-03-18;SIC;15419;7759;7660;9739;5625;55;0;ITG;ITG1;19;Sicilia;38.11569725;13.362356699999998;731;117;848;14613;15461;496;789;143641;4397;163499;2874348;1216838
2021-03-18;SAR;7319;3096;4223;5601;1641;77;0;ITG;ITG2;20;Sardegna;39.21531192;9.110616306;170;28;198;12615;12813;-6;121;28831;1201;42845;889758;566286
2021-03-18;PAB;1302;531;771;216;1076;10;0;ITH;ITH1;4;Provincia Autonoma Bolzano / Bozen;46.49933453;11.35662422;159;33;192;3741;3933;-152;13;51338;1082;56353;953145;201092
2021-03-18;PUG;9638;4379;5259;3347;6225;66;0;ITF;ITF4;16;Puglia;41.12559576;16.86736689;1582;219;1801;38706;40507;689;2082;126314;4394;171215;1731033;949416
2021-03-18;LIG;4993;2126;2867;1978;2985;30;0;ITC;ITC3;7;Liguria;44.41149315;8.9326992;567;64;631;5381;6012;-155;324;74082;3780;83874;1150892;485376
2021-03-18;VDA;136;43;93;96;37;3;0;ITC;ITC2;2;Valle d'Aosta / Vallée d'Aoste;45.73750286;7.320149366;14;3;17;328;345;12;24;7602;418;8365;84393;46940
2021-03-18;ABR;3901;1653;2248;2038;1836;27;0;ITF;ITF1;13;Abruzzo;42.35122196;13.39843823;667;89;756;10922;11678;-694;304;47316;1934;60928;1151007;552013
2021-03-18;BAS;1365;571;794;17;1339;9;0;ITF;ITF5;17;Basilicata;40.63947052;15.80514834;164;12;176;4141;4317;132;179;13269;401;17987;277011;160969
2021-03-18;EMR;13783;5852;7931;5682;8009;92;0;ITH;ITH5;8;Emilia-Romagna;44.49436681;11.341720800000001;3551;385;3936;66502;70438;823;2531;227087;11301;308826;4474763;1621942
2021-03-19;MAR;3881;1621;2260;325;3544;12;0;ITI;ITI3;11;Marche;43.61675973;13.5188753;749;141;890;9145;10035;-108;822;69109;2473;81617;946689;577354
2021-03-19;PUG;8000;3672;4328;3368;4596;36;0;ITF;ITF4;16;Puglia;41.12559576;16.86736689;1630;214;1844;39326;41170;663;1785;127409;4421;173000;1742669;955759
2021-03-19;LIG;5304;2237;3067;2100;3153;51;0;ITC;ITC3;7;Liguria;44.41149315;8.9326992;578;63;641;5152;5793;-219;427;74723;3785;84301;1158435;488169
2021-03-19;TOS;10174;4476;5698;7133;2893;148;0;ITI;ITI1;9;Toscana;43.76923077;11.25588885;1448;246;1694;23945;25639;301;1365;148808;5041;179488;3153257;1656862
2021-03-19;PAB;1921;777;1144;754;1120;47;0;ITH;ITH1;4;Provincia Autonoma Bolzano / Bozen;46.49933453;11.35662422;154;33;187;3599;3786;-147;175;51652;1090;56528;968112;201350
2021-03-19;ABR;5799;2586;3213;2731;3025;43;0;ITF;ITF1;13;Abruzzo;42.35122196;13.39843823;667;89;756;10346;11102;-576;462;48342;1943;61387;1161077;554774
2021-03-19;MOL;1210;489;721;748;430;32;0;ITF;ITF2;14;Molise;41.55774754;14.65916051;90;19;109;1384;1493;-30;18;9767;402;11662;174490;158135
2021-03-19;BAS;2319;1005;1314;261;2051;7;0;ITF;ITF5;17;Basilicata;40.63947052;15.80514834;167;13;180;4161;4341;24;116;13356;406;18103;278404;161680
2021-03-19;CAM;11153;4979;6174;7069;3877;207;0;ITF;ITF3;15;Campania;40.83956555;14.25084984;1569;155;1724;98614;100338;779;1997;209805;4843;314986;3356617;2296307
2021-03-19;LOM;32521;12958;19563;18920;13277;324;0;ITC;ITC4;3;Lombardia;45.46679409;9.190347404;6796;788;7584;93320;100904;1835;5518;558572;29631;689107;7591271;3376026
2021-03-19;SAR;7328;3065;4263;5017;2244;67;0;ITG;ITG2;20;Sardegna;39.21531192;9.110616306;176;25;201;12666;12867;54;134;28909;1203;42979;893924;568509
2021-03-19;CAL;4277;2002;2275;1885;2385;7;0;ITF;ITF6;18;Calabria;38.90597598;16.59440194;300;36;336;7820;8156;170;376;33791;758;42705;632930;596040
2021-03-19;FVG;3310;1395;1915;1337;1958;15;0;ITH;ITH4;6;Friuli-Venezia Giulia;45.6494354;13.76813649;547;77;624;15239;15863;337;910;71211;3097;90171;1519614;543981
2021-03-19;SIC;16325;8061;8264;10648;5579;98;0;ITG;ITG1;19;Sicilia;38.11569725;13.362356699999998;726;121;847;14937;15784;323;859;144162;4412;164358;2898109;1222708
2021-03-19;EMR;15924;6969;8955;7791;7971;162;0;ITH;ITH5;8;Emilia-Romagna;44.49436681;11.341720800000001;3549;386;3935;68852;72787;2349;3188;227858;11343;311988;4510779;1627949
2021-03-19;PIE;11049;4526;6523;4227;6612;210;0;ITC;ITC1;1;Piemonte;45.0732745;7.680687483;3332;326;3658;29797;33455;1295;2997;241724;9844;285023;3027647;1418191
2021-03-19;UMB;1744;566;1178;1083;656;5;0;ITI;ITI2;10;Umbria;43.10675841;12.38824698;402;78;480;5425;5905;-82;159;41126;1171;48202;902608;326669
2021-03-19;LAZ;17551;7617;9934;11000;6380;171;0;ITI;ITI4;12;Lazio;41.89277044;12.48366722;2439;308;2747;43248;45995;1076;2188;212397;6316;264708;4774934;3207408
2021-03-19;VDA;322;85;237;285;35;2;0;ITC;ITC2;2;Valle d'Aosta / Vallée d'Aoste;45.73750286;7.320149366;15;2;17;352;369;24;49;7626;419;8414;85295;47398
2021-03-19;VEN;13805;5672;8133;7402;6106;297;0;ITH;ITH3;5;Veneto;45.43490485;12.33845213;1353;199;1552;36061;37613;675;1917;314994;10318;362925;5748890;1489217
2021-03-19;PAT;2467;925;1542;1503;881;83;0;ITH;ITH2;4;Provincia Autonoma Trento;46.06893511;11.12123097;204;55;259;3688;3947;-24;256;33429;1249;38625;666633;179180
2021-03-20;ABR;4796;2201;2595;2564;2172;60;0;ITF;ITF1;13;Abruzzo;42.35122196;13.39843823;672;88;760;10203;10963;-139;417;48868;1972;61803;1167634;556690
2021-03-20;VDA;209;87;122;168;36;5;0;ITC;ITC2;2;Valle d'Aosta / Vallée d'Aoste;45.73750286;7.320149366;22;2;24;374;398;29;37;7634;419;8451;85831;47591
2021-03-20;BAS;1309;579;730;278;1024;7;0;ITF;ITF5;17;Basilicata;40.63947052;15.80514834;166;14;180;4237;4417;76;147;13427;406;18250;279962;162308
2021-03-20;EMR;16093;6833;9260;8958;6966;169;0;ITH;ITH5;8;Emilia-Romagna;44.49436681;11.341720800000001;3519;401;3920;69519;73439;652;2560;229697;11390;314526;4547328;1633925
2021-03-20;CAM;13990;6531;7459;9968;3739;283;0;ITF;ITF3;15;Campania;40.83956555;14.25084984;1575;161;1736;99159;100895;557;2196;211416;4871;317182;3378707;2309828
2021-03-20;SAR;5223;2080;3143;2909;2286;28;0;ITG;ITG2;20;Sardegna;39.21531192;9.110616306;175;22;197;12701;12898;31;102;28978;1205;43081;896813;570934
2021-03-20;LOM;32697;12188;20509;22312;9864;521;0;ITC;ITC4;3;Lombardia;45.46679409;9.190347404;6891;791;7682;96769;104451;3547;4810;559757;29709;693917;7647654;3391168
2021-03-20;FVG;3414;1417;1997;1302;2098;14;0;ITH;ITH4;6;Friuli-Venezia Giulia;45.6494354;13.76813649;564;80;644;15540;16184;321;906;71782;3111;91077;1530951;548238
2021-03-20;PIE;11960;4908;7052;5787;5921;252;0;ITC;ITC1;1;Piemonte;45.0732745;7.680687483;3361;332;3693;30304;33997;542;2141;243271;9896;287164;3058664;1427645
2021-03-20;PAT;888;409;479;663;211;14;0;ITH;ITH2;4;Provincia Autonoma Trento;46.06893511;11.12123097;203;55;258;3559;3817;-130;306;33862;1252;38931;670371;179708
2021-03-20;CAL;6808;3117;3691;4186;2604;18;0;ITF;ITF6;18;Calabria;38.90597598;16.59440194;305;37;342;8131;8473;317;394;33864;762;43099;636346;599138
2021-03-20;LIG;2318;995;1323;1130;1175;13;0;ITC;ITC3;7;Liguria;44.41149315;8.9326992;585;65;650;5266;5916;123;458;75053;3790;84759;1165664;490923
2021-03-20;LAZ;19296;7683;11613;13091;5924;281;0;ITI;ITI4;12;Lazio;41.89277044;12.48366722;2484;309;2793;44261;47054;1059;1821;213135;6340;266529;4812353;3228571
2021-03-20;TOS;6594;2980;3614;5364;1139;91;0;ITI;ITI1;9;Toscana;43.76923077;11.25588885;1424;240;1664;24387;26051;412;1510;149888;5059;180998;3178301;1667979
2021-03-20;PUG;8448;3895;4553;3767;4633;48;0;ITF;ITF4;16;Puglia;41.12559576;16.86736689;1668;209;1877;40195;42072;902;1983;128464;4447;174983;1753965;961174
2021-03-20;VEN;13035;5393;7642;10657;2083;295;0;ITH;ITH3;5;Veneto;45.43490485;12.33845213;1372;205;1577;36756;38333;720;2044;316298;10338;364969;5794287;1497373
2021-03-20;MAR;4178;1759;2419;1034;3129;15;0;ITI;ITI3;11;Marche;43.61675973;13.5188753;755;140;895;9131;10026;-9;856;69954;2493;82473;953305;581213
2021-03-20;MOL;2355;988;1367;1012;1325;18;0;ITF;ITF2;14;Molise;41.55774754;14.65916051;96;17;113;1343;1456;-37;77;9877;406;11739;175614;159159
2021-03-20;PAB;1760;851;909;1111;625;24;0;ITH;ITH1;4;Provincia Autonoma Bolzano / Bozen;46.49933453;11.35662422;141;33;174;3540;3714;-72;158;51879;1092;56685;980545;201697
2021-03-20;SIC;18607;8987;9620;13366;5146;95;0;ITG;ITG1;19;Sicilia;38.11569725;13.362356699999998;731;122;853;14880;15733;-51;782;144985;4422;165140;2925797;1228369
2021-03-20;UMB;2320;845;1475;2290;25;5;0;ITI;ITI2;10;Umbria;43.10675841;12.38824698;406;79;485;5419;5904;-1;324;41441;1181;48526;909157;327622
2021-03-21;PAT;136;74;62;131;0;5;0;ITH;ITH2;4;Provincia Autonoma Trento;46.06893511;11.12123097;203;52;255;3440;3695;-122;307;34289;1254;39238;674191;180161
2021-03-21;VEN;11991;4755;7236;8283;3466;242;0;ITH;ITH3;5;Veneto;45.43490485;12.33845213;1409;215;1624;37330;38954;621;1586;317253;10348;366555;5824260;1502812
2021-03-21;TOS;3297;1630;1667;1819;1434;44;0;ITI;ITI1;9;Toscana;43.76923077;11.25588885;1408;245;1653;24695;26348;297;1358;150913;5095;182356;3199230;1677908
2021-03-21;FVG;2677;1004;1673;2215;410;52;0;ITH;ITH4;6;Friuli-Venezia Giulia;45.6494354;13.76813649;596;81;677;15468;16145;-39;578;72384;3126;91655;1537913;551050
2021-03-21;SIC;15228;7347;7881;11184;3971;73;0;ITG;ITG1;19;Sicilia;38.11569725;13.362356699999998;751;125;876;15316;16192;459;699;145217;4430;165839;2949870;1233396
2021-03-21;LAZ;18310;7214;11096;13028;5071;211;0;ITI;ITI4;12;Lazio;41.89277044;12.48366722;2583;321;2904;44786;47690;636;1793;214277;6355;268322;4843609;3246734
2021-03-21;LIG;551;220;331;69;482;0;0;ITC;ITC3;7;Liguria;44.41149315;8.9326992;586;59;645;5306;5951;35;380;75393;3795;85139;1170837;493040
2021-03-21;CAM;10079;4680;5399;7480;2391;208;0;ITF;ITF3;15;Campania;40.83956555;14.25084984;1613;173;1786;98890;100676;-219;1810;213419;4897;318992;3401489;2321249
2021-03-21;PIE;10754;4748;6006;4038;6544;172;0;ITC;ITC1;1;Piemonte;45.0732745;7.680687483;3455;346;3801;30730;34531;534;1751;244476;9908;288915;3074217;1433699
2021-03-21;PAB;769;286;483;14;754;1;0;ITH;ITH1;4;Provincia Autonoma Bolzano / Bozen;46.49933453;11.35662422;135;31;166;3491;3657;-57;165;52092;1099;56848;991900;202008
2021-03-21;PUG;2697;1227;1470;577;2108;12;0;ITF;ITF4;16;Puglia;41.12559576;16.86736689;1683;212;1895;41184;43079;1007;1546;128993;4457;176529;1763594;964372
2021-03-21;VDA;361;170;191;352;0;9;0;ITC;ITC2;2;Valle d'Aosta / Vallée d'Aoste;45.73750286;7.320149366;24;2;26;427;453;55;63;7642;419;8514;86323;47805
2021-03-21;SAR;4054;1815;2239;2586;1441;27;0;ITG;ITG2;20;Sardegna;39.21531192;9.110616306;178;21;199;12817;13016;118;176;29032;1209;43257;913093;573242
2021-03-21;LOM;23525;8500;15025;17721;5199;605;0;ITC;ITC4;3;Lombardia;45.46679409;9.190347404;6926;806;7732;98043;105775;1324;4003;562346;29799;697920;7693804;3403800
2021-03-21;MAR;4506;1873;2633;1612;2877;17;0;ITI;ITI3;11;Marche;43.61675973;13.5188753;761;146;907;9158;10065;39;700;70607;2501;83173;958511;584106
2021-03-21;EMR;11962;5296;6666;7265;4603;94;0;ITH;ITH5;8;Emilia-Romagna;44.49436681;11.341720800000001;3566;396;3962;70502;74464;1025;2448;231079;11424;316967;4564438;1639007
2021-03-21;ABR;2134;914;1220;839;1291;4;0;ITF;ITF1;13;Abruzzo;42.35122196;13.39843823;668;83;751;10122;10873;-90;370;49292;2007;62172;1173952;558382
2021-03-21;BAS;1179;548;631;476;700;3;0;ITF;ITF5;17;Basilicata;40.63947052;15.80514834;162;13;175;4295;4470;53;108;13476;412;18358;281095;162863
2021-03-21;UMB;676;338;338;673;0;3;0;ITI;ITI2;10;Umbria;43.10675841;12.38824698;404;76;480;5331;5811;-93;168;41696;1187;48694;914514;328443
2021-03-21;CAL;4472;1932;2540;2725;1734;13;0;ITF;ITF6;18;Calabria;38.90597598;16.59440194;311;32;343;8384;8727;254;412;34015;769;43511;639292;601706
2021-03-21;MOL;1254;546;708;481;770;3;0;ITF;ITF2;14;Molise;41.55774754;14.65916051;93;14;107;1302;1409;-47;81;10000;411;11820;176206;159725
2021-03-22;PAB;1159;527;632;1112;17;30;0;ITH;ITH1;4;Provincia Autonoma Bolzano / Bozen;46.49933453;11.35662422;122;32;154;3331;3485;-172;127;52390;1099;56974;1003482;202220
2021-03-22;MOL;1172;450;722;897;245;30;0;ITF;ITF2;14;Molise;41.55774754;14.65916051;93;14;107;1293;1400;-9;41;10046;415;11861;176779;160236
2021-03-22;ABR;4347;1911;2436;2309;1971;67;0;ITF;ITF1;13;Abruzzo;42.35122196;13.39843823;671;85;756;10426;11182;309;353;49327;2016;62525;1181856;560309
2021-03-22;BAS;1224;549;675;642;574;8;0;ITF;ITF5;17;Basilicata;40.63947052;15.80514834;158;14;172;4287;4459;-11;24;13504;419;18382;281491;163079
2021-03-22;EMR;17660;7821;9839;10616;6872;172;0;ITH;ITH5;8;Emilia-Romagna;44.49436681;11.341720800000001;3702;390;4092;70679;74771;307;2118;232841;11468;319080;4584340;1642090
2021-03-22;CAM;13190;6354;6836;10807;2046;337;0;ITF;ITF3;15;Campania;40.83956555;14.25084984;1620;171;1791;97538;99329;-1347;1313;216036;4940;320305;3412719;2324817
2021-03-22;SIC;16695;7922;8773;11167;5432;96;0;ITG;ITG1;19;Sicilia;38.11569725;13.362356699999998;783;123;906;15712;16618;426;666;145436;4451;166505;2965847;1237853
2021-03-22;VDA;561;205;356;326;229;6;0;ITC;ITC2;2;Valle d'Aosta / Vallée d'Aoste;45.73750286;7.320149366;25;2;27;476;503;50;61;7653;419;8575;87061;48137
2021-03-22;VEN;18158;8186;9972;12584;5050;524;0;ITH;ITH3;5;Veneto;45.43490485;12.33845213;1452;219;1671;37503;39174;220;981;318000;10362;367536;5840541;1507163
2021-03-22;CAL;5012;2355;2657;3184;1805;23;0;ITF;ITF6;18;Calabria;38.90597598;16.59440194;315;33;348;8363;8711;-16;156;34181;775;43667;641087;603400
2021-03-22;LAZ;23461;10590;12871;16360;6751;350;0;ITI;ITI4;12;Lazio;41.89277044;12.48366722;2678;341;3019;45483;48502;812;1407;214853;6374;269729;4858403;3255283
2021-03-22;MAR;5705;2414;3291;2479;3179;47;0;ITI;ITI3;11;Marche;43.61675973;13.5188753;768;152;920;9042;9962;-103;265;70964;2512;83438;960343;584939
2021-03-22;LIG;7765;3480;4285;4747;2944;74;0;ITC;ITC3;7;Liguria;44.41149315;8.9326992;602;58;660;5364;6024;73;294;75606;3803;85433;1174589;494419
2021-03-22;LOM;40387;14326;26061;28959;10583;845;0;ITC;ITC4;3;Lombardia;45.46679409;9.190347404;6952;822;7774;90789;98563;-7212;2105;571586;29876;700025;7715536;3410522
2021-03-22;SAR;3745;1518;2227;3132;526;87;0;ITG;ITG2;20;Sardegna;39.21531192;9.110616306;185;22;207;12877;13084;68;161;29120;1214;43418;927268;574573
2021-03-22;TOS;5263;2773;2490;4676;448;139;0;ITI;ITI1;9;Toscana;43.76923077;11.25588885;1461;245;1706;25073;26779;431;1140;151599;5118;183496;3212689;1684490
2021-03-22;UMB;3562;1657;1905;2306;1246;10;0;ITI;ITI2;10;Umbria;43.10675841;12.38824698;385;75;460;5221;5681;-130;182;42002;1193;48876;920579;329363
2021-03-22;PUG;9997;5147;4850;4253;5672;72;0;ITF;ITF4;16;Puglia;41.12559576;16.86736689;1712;223;1935;41055;42990;-89;844;129898;4485;177373;1768460;966489
2021-03-22;FVG;3674;1457;2217;1674;1960;40;0;ITH;ITH4;6;Friuli-Venezia Giulia;45.6494354;13.76813649;611;82;693;15676;16369;224;405;72547;3144;92060;1541489;552430
2021-03-22;PIE;11547;4899;6648;3720;7609;218;0;ITC;ITC1;1;Piemonte;45.0732745;7.680687483;3536;349;3885;30998;34883;352;1521;245605;9948;290436;3089502;1438498
2021-03-22;PAT;2350;995;1355;1406;885;59;0;ITH;ITH2;4;Provincia Autonoma Trento;46.06893511;11.12123097;214;52;266;3440;3706;11;155;34432;1255;39393;676520;180460
2021-03-23;UMB;3828;1714;2114;2159;1632;37;0;ITI;ITI2;10;Umbria;43.10675841;12.38824698;372;74;446;5133;5579;-102;206;42298;1205;49082;925972;330080
2021-03-23;SAR;6503;2906;3597;5229;1090;184;0;ITG;ITG2;20;Sardegna;39.21531192;9.110616306;172;24;196;12971;13167;83;159;29194;1216;43577;935778;576681
2021-03-23;PIE;13238;5586;7652;6652;6254;332;0;ITC;ITC1;1;Piemonte;45.0732745;7.680687483;3572;347;3919;30964;34883;0;2080;247610;10023;292516;3112426;1447827
2021-03-23;SIC;20975;10090;10885;15231;5567;177;0;ITG;ITG1;19;Sicilia;38.11569725;13.362356699999998;814;121;935;15554;16489;-129;751;146296;4471;167256;2990826;1243440
2021-03-23;LAZ;25512;11984;13528;18474;6654;384;0;ITI;ITI4;12;Lazio;41.89277044;12.48366722;2683;346;3029;45797;48826;324;1491;215994;6400;271220;4893244;3272480
2021-03-23;EMR;18805;8150;10655;11948;6691;166;0;ITH;ITH5;8;Emilia-Romagna;44.49436681;11.341720800000001;3659;395;4054;69542;73596;-1175;1578;235512;11524;320632;4620268;1645785
2021-03-23;FVG;3921;1703;2218;1749;2151;21;0;ITH;ITH4;6;Friuli-Venezia Giulia;45.6494354;13.76813649;620;83;703;15577;16280;-89;548;73162;3166;92608;1551667;555461
2021-03-23;CAM;15751;7451;8300;12843;2516;392;0;ITF;ITF3;15;Campania;40.83956555;14.25084984;1598;178;1776;96359;98135;-1194;1862;219030;5002;322167;3435472;2337229
2021-03-23;VEN;22240;10253;11987;16880;4718;642;0;ITH;ITH3;5;Veneto;45.43490485;12.33845213;1505;236;1741;37342;39083;-91;1966;320005;10414;369502;5883916;1513040
2021-03-23;TOS;9449;4415;5034;6960;2289;200;0;ITI;ITI1;9;Toscana;43.76923077;11.25588885;1486;243;1729;24909;26638;-141;1062;152771;5149;184558;3235366;1693329
2021-03-23;PAT;2484;962;1522;1629;755;100;0;ITH;ITH2;4;Provincia Autonoma Trento;46.06893511;11.12123097;211;53;264;3244;3508;-198;80;34704;1261;39473;677757;180773
2021-03-23;PUG;11166;5667;5499;4530;6539;97;0;ITF;ITF4;16;Puglia;41.12559576;16.86736689;1787;224;2011;41583;43594;604;1664;130912;4531;179037;1781850;974345
2021-03-23;BAS;1646;635;1011;1454;172;20;0;ITF;ITF5;17;Basilicata;40.63947052;15.80514834;159;13;172;4330;4502;43;121;13581;420;18503;282987;163657
2021-03-23;PAB;1558;762;796;1518;1;39;0;ITH;ITH1;4;Provincia Autonoma Bolzano / Bozen;46.49933453;11.35662422;121;32;153;3364;3517;32;116;52576;1101;57194;1014934;202471
2021-03-23;VDA;382;150;232;231;135;16;0;ITC;ITC2;2;Valle d'Aosta / Vallée d'Aoste;45.73750286;7.320149366;22;2;24;506;530;27;28;7654;419;8603;87670;48377
2021-03-23;MOL;1686;711;975;1428;211;47;0;ITF;ITF2;14;Molise;41.55774754;14.65916051;97;16;113;1234;1347;-53;62;10159;417;11923;177610;160998
2021-03-23;CAL;5273;2473;2800;3422;1827;24;0;ITF;ITF6;18;Calabria;38.90597598;16.59440194;323;33;356;8557;8913;202;317;34294;777;43984;644229;606325
2021-03-23;LIG;9297;4235;5062;5993;3219;85;0;ITC;ITC3;7;Liguria;44.41149315;8.9326992;604;65;669;5286;5955;-69;360;76029;3809;85793;1182172;497143
2021-03-23;LOM;42684;15506;27178;28895;12916;873;0;ITC;ITC4;3;Lombardia;45.46679409;9.190347404;7165;836;8001;90255;98256;-307;3643;575437;29975;703668;7762711;3421944
2021-03-23;MAR;5838;2556;3282;2223;3576;39;0;ITI;ITI3;11;Marche;43.61675973;13.5188753;799;146;945;9011;9956;-6;405;71366;2521;83843;964865;587597
2021-03-23;ABR;4834;2191;2643;2208;2567;59;0;ITF;ITF1;13;Abruzzo;42.35122196;13.39843823;670;89;759;10309;11068;-114;190;49623;2023;62714;1186010;561173
2021-03-24;MOL;1657;662;995;1221;402;34;0;ITF;ITF2;14;Molise;41.55774754;14.65916051;100;16;116;1231;1347;0;57;10216;417;11980;178401;161699
2021-03-24;MAR;7098;3019;4079;3309;3716;73;0;ITI;ITI3;11;Marche;43.61675973;13.5188753;803;156;959;9137;10096;140;632;71845;2534;84475;971267;590847
2021-03-24;PAB;2070;1003;1067;2005;13;52;0;ITH;ITH1;4;Provincia Autonoma Bolzano / Bozen;46.49933453;11.35662422;123;30;153;3155;3308;-209;76;52754;1101;57163;1020176;202644
2021-03-24;PUG;13634;6543;7091;6048;7465;121;0;ITF;ITF4;16;Puglia;41.12559576;16.86736689;1761;227;1988;42169;44157;563;1709;132020;4569;180746;1792769;980205
2021-03-24;CAL;8037;3674;4363;4588;3423;26;0;ITF;ITF6;18;Calabria;38.90597598;16.59440194;326;33;359;8709;9068;155;365;34499;782;44349;647503;609312
2021-03-24;TOS;20047;8317;11730;10413;9489;145;0;ITI;ITI1;9;Toscana;43.76923077;11.25588885;1488;253;1741;24770;26511;-127;1197;154068;5176;185755;3261425;1703780
2021-03-24;ABR;6388;2787;3601;3992;2253;143;0;ITF;ITF1;13;Abruzzo;42.35122196;13.39843823;657;87;744;10151;10895;-173;188;49966;2041;62902;1191532;562696
2021-03-24;BAS;2055;796;1259;1481;548;26;0;ITF;ITF5;17;Basilicata;40.63947052;15.80514834;148;14;162;4336;4498;-4;115;13690;430;18618;284432;164233
2021-03-24;EMR;21244;9415;11829;13635;7386;223;0;ITH;ITH5;8;Emilia-Romagna;44.49436681;11.341720800000001;3614;397;4011;67845;71856;-1740;1725;238912;11569;322337;4654431;1650638
2021-03-24;UMB;4108;1794;2314;2746;1323;39;0;ITI;ITI2;10;Umbria;43.10675841;12.38824698;366;72;438;5078;5516;-63;142;42499;1209;49224;931028;330695
2021-03-24;LAZ;28019;13163;14856;21315;6279;425;0;ITI;ITI4;12;Lazio;41.89277044;12.48366722;2724;350;3074;45717;48791;-35;1709;217708;6430;272929;4930415;3293442
2021-03-24;LIG;9193;4040;5153;5817;3293;83;0;ITC;ITC3;7;Liguria;44.41149315;8.9326992;597;63;660;5133;5793;-162;420;76603;3817;86213;1189773;499823
2021-03-24;SAR;7506;3135;4371;5994;1360;152;0;ITG;ITG2;20;Sardegna;39.21531192;9.110616306;173;26;199;13030;13229;62;153;29283;1218;43730;940336;579174
2021-03-24;VEN;22127;9581;12546;14663;6807;657;0;ITH;ITH3;5;Veneto;45.43490485;12.33845213;1529;246;1775;37353;39128;45;2042;321974;10442;371544;5931351;1519990
2021-03-24;CAM;17924;8371;9553;14566;2959;399;0;ITF;ITF3;15;Campania;40.83956555;14.25084984;1587;179;1766;96282;98048;-87;2045;221110;5054;324212;3459825;2354049
2021-03-24;LOM;43522;15711;27811;30534;12084;904;0;ITC;ITC4;3;Lombardia;45.46679409;9.190347404;7178;845;8023;92149;100172;1916;4282;577693;30085;707950;7822337;3435033
2021-03-24;SIC;20987;9880;11107;15038;5745;204;0;ITG;ITG1;19;Sicilia;38.11569725;13.362356699999998;812;119;931;15456;16387;-102;765;147141;4493;168021;3016803;1249413
2021-03-24;PAT;2417;963;1454;1467;827;123;0;ITH;ITH2;4;Provincia Autonoma Trento;46.06893511;11.12123097;205;52;257;3193;3450;-58;191;34949;1265;39664;680427;181186
2021-03-24;FVG;3990;1729;2261;2465;1485;40;0;ITH;ITH4;6;Friuli-Venezia Giulia;45.6494354;13.76813649;634;80;714;16026;16740;460;762;73444;3186;93370;1564663;559646
2021-03-24;PIE;15632;6420;9212;6125;9141;366;0;ITC;ITC1;1;Piemonte;45.0732745;7.680687483;3608;354;3962;30986;34948;65;2223;249738;10053;294739;3141157;1455511
2021-03-24;VDA;518;230;288;256;259;3;0;ITC;ITC2;2;Valle d'Aosta / Vallée d'Aoste;45.73750286;7.320149366;23;2;25;540;565;35;52;7671;419;8655;87957;48508
2021-03-25;BAS;1889;606;1283;1512;351;26;0;ITF;ITF5;17;Basilicata;40.63947052;15.80514834;156;15;171;4381;4552;54;106;13742;430;18724;285626;164804
2021-03-25;CAM;20331;9659;10672;16318;3507;506;0;ITF;ITF3;15;Campania;40.83956555;14.25084984;1576;184;1760;95480;97240;-808;2068;223924;5116;326280;3484081;2368570
2021-03-25;SIC;20478;9536;10942;14746;5550;182;0;ITG;ITG1;19;Sicilia;38.11569725;13.362356699999998;813;118;931;15063;15994;-393;895;148409;4513;168916;3042029;1255948
2021-03-25;UMB;3937;1728;2209;2826;1064;47;0;ITI;ITI2;10;Umbria;43.10675841;12.38824698;388;73;461;4942;5403;-113;71;42679;1213;49295;932394;330831
2021-03-25;VEN;25979;11065;14914;18971;6106;902;0;ITH;ITH3;5;Veneto;45.43490485;12.33845213;1556;256;1812;37371;39183;55;1861;323755;10467;373405;5976984;1526831
2021-03-25;PIE;17182;7289;9893;8100;8638;444;0;ITC;ITC1;1;Piemonte;45.0732745;7.680687483;3677;357;4034;31258;35292;344;2582;251936;10093;297321;3165732;1466122
2021-03-25;VDA;389;154;235;364;10;15;0;ITC;ITC2;2;Valle d'Aosta / Vallée d'Aoste;45.73750286;7.320149366;26;3;29;540;569;4;30;7697;419;8685;88888;48912
2021-03-25;FVG;5550;2437;3113;3333;2140;77;0;ITH;ITH4;6;Friuli-Venezia Giulia;45.6494354;13.76813649;645;78;723;15245;15968;-772;842;75045;3199;94212;1573489;563322
2021-03-25;LOM;43068;16105;26963;29253;12891;924;0;ITC;ITC4;3;Lombardia;45.46679409;9.190347404;7132;845;7977;94101;102078;1906;5046;580733;30185;712996;7882033;3449180
2021-03-25;TOS;23996;10412;13584;15320;8413;263;0;ITI;ITI1;9;Toscana;43.76923077;11.25588885;1470;257;1727;25137;26864;353;1620;155313;5198;187375;3286164;1715126
2021-03-25;PAT;2919;1129;1790;1744;1062;113;0;ITH;ITH2;4;Provincia Autonoma Trento;46.06893511;11.12123097;208;47;255;3121;3376;-74;308;35328;1268;39972;683887;181668
2021-03-25;SAR;9283;4022;5261;7821;1309;153;0;ITG;ITG2;20;Sardegna;39.21531192;9.110616306;173;27;200;13160;13360;131;211;29362;1219;43941;943882;582144
2021-03-25;CAL;7532;3559;3973;4548;2944;40;0;ITF;ITF6;18;Calabria;38.90597598;16.59440194;331;34;365;9046;9411;343;475;34627;786;44824;650863;612428
2021-03-25;LIG;9787;4237;5550;6246;3397;144;0;ITC;ITC3;7;Liguria;44.41149315;8.9326992;589;65;654;5501;6155;362;494;76725;3827;86707;1197494;502866
2021-03-25;LAZ;29573;13741;15832;22378;6698;497;0;ITI;ITI4;12;Lazio;41.89277044;12.48366722;2763;355;3118;45943;49061;270;2055;219460;6463;274984;4968957;3314976
2021-03-25;PUG;11796;6051;5745;5263;6428;105;0;ITF;ITF4;16;Puglia;41.12559576;16.86736689;1762;231;1993;42184;44177;20;2033;133996;4606;182779;1805576;985300
2021-03-25;MOL;1839;742;1097;1291;499;49;0;ITF;ITF2;14;Molise;41.55774754;14.65916051;94;19;113;1193;1306;-41;18;10270;422;11998;178606;161884
2021-03-25;MAR;6706;2796;3910;3186;3458;62;0;ITI;ITI3;11;Marche;43.61675973;13.5188753;804;157;961;9215;10176;80;621;72371;2549;85096;976964;594009
2021-03-25;PAB;2173;1080;1093;1661;444;68;0;ITH;ITH1;4;Provincia Autonoma Bolzano / Bozen;46.49933453;11.35662422;128;30;158;841;999;-2309;35;65759;1101;67859;1023071;347901
2021-03-25;ABR;5802;2666;3136;3064;2625;113;0;ITF;ITF1;13;Abruzzo;42.35122196;13.39843823;635;82;717;9934;10651;-244;329;50528;2052;63231;1201419;565014
2021-03-25;EMR;21490;9420;12070;14239;6990;261;0;ITH;ITH5;8;Emilia-Romagna;44.49436681;11.341720800000001;3557;402;3959;67876;71835;-21;2070;240932;11627;324394;4689356;1655616
2021-03-26;VEN;29620;13165;16455;23276;5471;873;0;ITH;ITH3;5;Veneto;45.43490485;12.33845213;1548;257;1805;37551;39356;173;2095;325644;10500;375500;6019629;1533645
2021-03-26;LIG;9362;4043;5319;6094;3161;107;0;ITC;ITC3;7;Liguria;44.41149315;8.9326992;605;67;672;5654;6326;171;487;77035;3833;87194;1204780;505596
2021-03-26;TOS;20748;9434;11314;14707;5829;212;0;ITI;ITI1;9;Toscana;43.76923077;11.25588885;1473;257;1730;25496;27226;362;1425;156354;5220;188800;3312214;1725391
2021-03-26;LOM;41397;15742;25655;27512;13198;687;0;ITC;ITC4;3;Lombardia;45.46679409;9.190347404;7111;848;7959;96696;104655;2577;5077;583133;30285;718073;7942837;3463092
2021-03-26;PAT;3278;1282;1996;2519;612;147;0;ITH;ITH2;4;Provincia Autonoma Trento;46.06893511;11.12123097;203;45;248;3094;3342;-34;177;35539;1268;40149;686728;181929
2021-03-26;PUG;12051;5868;6183;7223;4686;142;0;ITF;ITF4;16;Puglia;41.12559576;16.86736689;1766;231;1997;42799;44796;619;2162;135498;4647;184941;1817711;990780
2021-03-26;MAR;6393;2626;3767;3474;2860;59;0;ITI;ITI3;11;Marche;43.61675973;13.5188753;807;152;959;9153;10112;-64;674;73092;2566;85770;982389;596994
2021-03-26;MOL;2641;1064;1577;1908;648;85;0;ITF;ITF2;14;Molise;41.55774754;14.65916051;91;17;108;1064;1172;-134;27;10429;424;12025;179419;162305
2021-03-26;VDA;498;204;294;482;7;9;0;ITC;ITC2;2;Valle d'Aosta / Vallée d'Aoste;45.73750286;7.320149366;27;3;30;597;627;58;70;7709;419;8755;89684;49238
2021-03-26;PAB;1663;737;926;506;1136;21;0;ITH;ITH1;4;Provincia Autonoma Bolzano / Bozen;46.49933453;11.35662422;120;30;150;762;912;-87;148;65990;1105;68007;1037326;349778
2021-03-26;BAS;1957;702;1255;1667;262;28;0;ITF;ITF5;17;Basilicata;40.63947052;15.80514834;157;15;172;4446;4618;66;143;13818;431;18867;287018;165467
2021-03-26;ABR;5361;2314;3047;3172;2081;108;0;ITF;ITF1;13;Abruzzo;42.35122196;13.39843823;621;79;700;9787;10487;-164;310;50987;2067;63541;1210893;567262
2021-03-26;FVG;6111;2670;3441;3893;2039;179;0;ITH;ITH4;6;Friuli-Venezia Giulia;45.6494354;13.76813649;650;78;728;15292;16020;52;768;75733;3227;94980;1583938;566752
2021-03-26;SAR;8641;3552;5089;6965;1533;143;0;ITG;ITG2;20;Sardegna;39.21531192;9.110616306;170;30;200;13272;13472;112;178;29426;1221;44119;949634;584274
2021-03-26;UMB;4604;1721;2883;4345;175;84;0;ITI;ITI2;10;Umbria;43.10675841;12.38824698;383;67;450;4933;5383;-20;174;42859;1227;49469;939919;331998
2021-03-26;CAL;8122;3854;4268;4948;3140;34;0;ITF;ITF6;18;Calabria;38.90597598;16.59440194;340;35;375;9248;9623;212;412;34824;789;45236;653967;615272
2021-03-26;CAM;19873;9328;10545;15588;3819;466;0;ITF;ITF3;15;Campania;40.83956555;14.25084984;1586;181;1767;94484;96251;-989;1947;226818;5158;328227;3506074;2381784
2021-03-26;SIC;17994;8361;9633;12338;5502;154;0;ITG;ITG1;19;Sicilia;38.11569725;13.362356699999998;799;121;920;15483;16403;409;892;148870;4535;169808;3069858;1262606
2021-03-26;LAZ;30428;14106;16322;23008;6931;489;0;ITI;ITI4;12;Lazio;41.89277044;12.48366722;2792;360;3152;46067;49219;158;2006;221271;6500;276990;5004575;3336402
2021-03-26;PIE;17965;7144;10821;8543;8889;533;0;ITC;ITC1;1;Piemonte;45.0732745;7.680687483;3759;358;4117;31018;35135;-157;2117;254172;10131;299438;3197847;1474130
2021-03-26;EMR;23745;10127;13618;17027;6442;276;0;ITH;ITH5;8;Emilia-Romagna;44.49436681;11.341720800000001;3515;399;3914;67945;71859;24;2391;243244;11673;326776;4721424;1660353
2021-03-27;VDA;337;166;171;292;31;14;0;ITC;ITC2;2;Valle d'Aosta / Vallée d'Aoste;45.73750286;7.320149366;28;5;33;616;649;22;61;7748;419;8816;90571;49532
2021-03-27;ABR;6127;2621;3506;3561;2493;73;0;ITF;ITF1;13;Abruzzo;42.35122196;13.39843823;615;85;700;9750;10450;-37;392;51411;2072;63933;1217120;568934
2021-03-27;UMB;4253;1515;2738;3857;340;56;0;ITI;ITI2;10;Umbria;43.10675841;12.38824698;382;66;448;4796;5244;-139;225;43221;1229;49694;945971;332990
2021-03-27;CAL;8869;4035;4834;4671;4153;45;0;ITF;ITF6;18;Calabria;38.90597598;16.59440194;361;37;398;9629;10027;404;508;34922;795;45744;657338;618358
2021-03-27;EMR;21685;9075;12610;14526;6910;249;0;ITH;ITH5;8;Emilia-Romagna;44.49436681;11.341720800000001;3467;400;3867;68194;72061;202;2269;245274;11706;329041;4754658;1665159
2021-03-27;MAR;7428;3098;4330;4957;2396;75;0;ITI;ITI3;11;Marche;43.61675973;13.5188753;812;148;960;9050;10010;-102;660;73841;2579;86430;987960;600108
2021-03-27;PAB;3053;1554;1499;1479;1508;66;0;ITH;ITH1;4;Provincia Autonoma Bolzano / Bozen;46.49933453;11.35662422;115;31;146;724;870;-42;162;66191;1107;68168;1049536;351455
2021-03-27;VEN;32094;14019;18075;25382;5807;905;0;ITH;ITH3;5;Veneto;45.43490485;12.33845213;1545;254;1799;37432;39231;-125;1759;327511;10517;377259;6061958;1539227
2021-03-27;TOS;8867;4157;4710;8513;216;138;0;ITI;ITI1;9;Toscana;43.76923077;11.25588885;1496;264;1760;25543;27303;77;1467;157725;5239;190267;3339047;1736259
2021-03-27;LIG;3936;1550;2386;2515;1398;23;0;ITC;ITC3;7;Liguria;44.41149315;8.9326992;619;66;685;5974;6659;333;529;77223;3841;87723;1212021;508298
2021-03-27;CAM;21521;10246;11275;17197;3869;455;0;ITF;ITF3;15;Campania;40.83956555;14.25084984;1594;168;1762;94339;96101;-150;2209;229146;5189;330436;3530176;2397196
2021-03-27;LOM;32537;12419;20118;23118;8778;641;0;ITC;ITC4;3;Lombardia;45.46679409;9.190347404;7124;852;7976;98651;106627;1972;4884;585943;30387;722957;8004306;3476591
2021-03-27;MOL;2767;1284;1483;1304;1434;29;0;ITF;ITF2;14;Molise;41.55774754;14.65916051;89;17;106;1012;1118;-54;29;10510;426;12054;180071;162908
2021-03-27;FVG;5387;2926;2461;3927;1412;48;0;ITH;ITH4;6;Friuli-Venezia Giulia;45.6494354;13.76813649;645;82;727;15124;15851;-169;672;76560;3241;95652;1595003;570496
2021-03-27;PIE;18437;7843;10594;9145;8836;456;0;ITC;ITC1;1;Piemonte;45.0732745;7.680687483;3767;360;4127;31458;35585;450;2636;256309;10180;302074;3231331;1484100
2021-03-27;PAT;1673;747;926;1322;263;88;0;ITH;ITH2;4;Provincia Autonoma Trento;46.06893511;11.12123097;194;44;238;3042;3280;-62;238;35834;1273;40387;689885;182356
2021-03-27;PUG;12187;5726;6461;6881;5193;113;0;ITF;ITF4;16;Puglia;41.12559576;16.86736689;1774;231;2005;43632;45637;841;2008;136633;4679;186949;1830453;995606
2021-03-27;BAS;2256;866;1390;1808;434;14;0;ITF;ITF5;17;Basilicata;40.63947052;15.80514834;157;14;171;4550;4721;103;133;13846;433;19000;288548;166151
2021-03-27;LAZ;26578;10819;15759;19484;6528;566;0;ITI;ITI4;12;Lazio;41.89277044;12.48366722;2872;364;3236;47055;50291;1072;1825;222009;6515;278815;5038994;3355878
2021-03-27;SAR;5837;2217;3620;5312;423;102;0;ITG;ITG2;20;Sardegna;39.21531192;9.110616306;177;32;209;13463;13672;200;287;29511;1223;44406;952409;586584
2021-03-27;SIC;15702;7406;8296;10685;4890;127;0;ITG;ITG1;19;Sicilia;38.11569725;13.362356699999998;813;127;940;15472;16412;9;890;149728;4558;170698;3098896;1268315
2021-03-28;SAR;4636;1828;2808;4482;79;75;0;ITG;ITG2;20;Sardegna;39.21531192;9.110616306;189;30;219;13686;13905;233;284;29559;1226;44690;973870;589550
2021-03-28;LOM;20644;7884;12760;13971;6288;385;0;ITC;ITC4;3;Lombardia;45.46679409;9.190347404;7069;868;7937;94754;102691;-3936;3520;593324;30462;726477;8047640;3487241
2021-03-28;CAM;15565;7510;8055;13556;1625;384;0;ITF;ITF3;15;Campania;40.83956555;14.25084984;1592;165;1757;94905;96662;561;2095;230662;5207;332531;3552320;2411319
2021-03-28;EMR;13556;6062;7494;9547;3888;121;0;ITH;ITH5;8;Emilia-Romagna;44.49436681;11.341720800000001;3442;401;3843;68911;72754;693;2137;246682;11737;331173;4773714;1669287
2021-03-28;UMB;1097;441;656;1042;24;31;0;ITI;ITI2;10;Umbria;43.10675841;12.38824698;375;63;438;4729;5167;-77;113;43408;1232;49807;950265;333491
2021-03-28;SIC;10990;5152;5838;6907;4013;70;0;ITG;ITG1;19;Sicilia;38.11569725;13.362356699999998;844;129;973;16027;17000;588;953;150068;4583;171651;3124143;1274187
2021-03-28;FVG;4948;2356;2592;4691;158;99;0;ITH;ITH4;6;Friuli-Venezia Giulia;45.6494354;13.76813649;662;84;746;14880;15626;-225;446;77208;3264;96098;1601770;573080
2021-03-28;PIE;16099;6909;9190;8133;7624;342;0;ITC;ITC1;1;Piemonte;45.0732745;7.680687483;3776;369;4145;31430;35575;-10;1543;257852;10190;303617;3247201;1490014
2021-03-28;VEN;31315;13610;17705;26881;3615;819;0;ITH;ITH3;5;Veneto;45.43490485;12.33845213;1576;267;1843;37806;39649;418;1404;328486;10528;378663;6084751;1543276
2021-03-28;CAL;2694;1234;1460;1561;1126;7;0;ITF;ITF6;18;Calabria;38.90597598;16.59440194;377;36;413;9889;10302;275;366;35008;800;46110;659830;620481
2021-03-28;PAT;768;304;464;717;2;49;0;ITH;ITH2;4;Provincia Autonoma Trento;46.06893511;11.12123097;203;44;247;3061;3308;28;215;36018;1276;40602;693130;182754
2021-03-28;TOS;6211;2807;3404;5875;253;83;0;ITI;ITI1;9;Toscana;43.76923077;11.25588885;1505;264;1769;25792;27561;258;1368;158808;5266;191635;3361490;1745957
2021-03-28;LAZ;19217;7844;11373;13529;5327;361;0;ITI;ITI4;12;Lazio;41.89277044;12.48366722;2881;370;3251;48185;51436;1145;1836;222686;6529;280651;5069809;3372654
2021-03-28;LIG;1141;510;631;381;752;8;0;ITC;ITC3;7;Liguria;44.41149315;8.9326992;636;67;703;6048;6751;92;392;77517;3847;88115;1216828;510214
2021-03-28;PUG;3552;1660;1892;1179;2337;36;0;ITF;ITF4;16;Puglia;41.12559576;16.86736689;1800;238;2038;44842;46880;1243;1788;137164;4693;188737;1839926;997633
2021-03-28;PAB;569;212;357;11;558;0;0;ITH;ITH1;4;Provincia Autonoma Bolzano / Bozen;46.49933453;11.35662422;106;31;137;772;909;39;137;66286;1108;68303;1060036;353068
2021-03-28;MAR;4128;1741;2387;2396;1693;39;0;ITI;ITI3;11;Marche;43.61675973;13.5188753;806;147;953;8988;9941;-69;505;74403;2591;86935;992694;602724
2021-03-28;VDA;524;213;311;497;0;27;0;ITC;ITC2;2;Valle d'Aosta / Vallée d'Aoste;45.73750286;7.320149366;24;7;31;659;690;41;57;7763;420;8873;91388;49847
2021-03-28;ABR;2433;1019;1414;1995;387;51;0;ITF;ITF1;13;Abruzzo;42.35122196;13.39843823;623;83;706;9707;10413;-37;348;51794;2074;64281;1223572;570616
2021-03-28;BAS;2147;746;1401;2110;20;17;0;ITF;ITF5;17;Basilicata;40.63947052;15.80514834;158;13;171;4637;4808;87;148;13904;436;19148;289750;166753
2021-03-28;MOL;1640;757;883;523;1103;14;0;ITF;ITF2;14;Molise;41.55774754;14.65916051;87;16;103;955;1058;-60;21;10590;427;12075;180804;163542
2021-03-29;PUG;13592;6634;6958;6621;6772;199;0;ITF;ITF4;16;Puglia;41.12559576;16.86736689;1852;248;2100;44394;46494;-386;786;138303;4726;189523;1845068;1001111
2021-03-29;MAR;5898;2583;3315;3391;2458;49;0;ITI;ITI3;11;Marche;43.61675973;13.5188753;807;151;958;8451;9409;-532;232;75160;2598;87167;994197;603471
2021-03-29;MOL;2072;846;1226;1524;489;59;0;ITF;ITF2;14;Molise;41.55774754;14.65916051;77;17;94;945;1039;-19;53;10661;428;12128;182226;164280
2021-03-29;BAS;2482;898;1584;2141;288;53;0;ITF;ITF5;17;Basilicata;40.63947052;15.80514834;168;12;180;4607;4787;-21;33;13955;439;19181;290187;166975
2021-03-29;VDA;494;233;261;450;40;4;0;ITC;ITC2;2;Valle d'Aosta / Vallée d'Aoste;45.73750286;7.320149366;32;8;40;751;791;101;125;7787;420;8998;92060;50137
2021-03-29;PAB;1173;500;673;391;761;21;0;ITH;ITH1;4;Provincia Autonoma Bolzano / Bozen;46.49933453;11.35662422;108;29;137;794;931;22;153;66411;1110;68452;1071227;354499
2021-03-29;ABR;5711;2600;3111;3021;2640;50;0;ITF;ITF1;13;Abruzzo;42.35122196;13.39843823;613;77;690;9976;10666;253;269;51801;2083;64550;1228779;571979
2021-03-29;SAR;4863;1887;2976;4169;595;99;0;ITG;ITG2;20;Sardegna;39.21531192;9.110616306;200;31;231;13747;13978;73;164;29647;1229;44854;983595;590859
2021-03-29;FVG;7047;3136;3911;5374;1596;77;0;ITH;ITH4;6;Friuli-Venezia Giulia;45.6494354;13.76813649;680;86;766;14740;15506;-120;301;77618;3275;96399;1605290;574269
2021-03-29;EMR;21454;9632;11822;16544;4665;245;0;ITH;ITH5;8;Emilia-Romagna;44.49436681;11.341720800000001;3540;398;3938;69952;73890;1136;2011;247487;11792;333169;4785678;1671791
2021-03-29;PIE;15279;6488;8791;8394;6615;270;0;ITC;ITC1;1;Piemonte;45.0732745;7.680687483;3837;364;4201;31584;35785;210;1504;259128;10208;305121;3261398;1494794
2021-03-29;PAT;2573;1011;1562;1699;743;131;0;ITH;ITH2;4;Provincia Autonoma Trento;46.06893511;11.12123097;206;45;251;2934;3185;-123;162;36302;1277;40764;695720;183138
2021-03-29;CAL;5789;2504;3285;3975;1778;36;0;ITF;ITF6;18;Calabria;38.90597598;16.59440194;389;36;425;9907;10332;30;201;35177;802;46311;661274;621909
2021-03-29;CAM;19413;9581;9832;17405;1551;457;0;ITF;ITF3;15;Campania;40.83956555;14.25084984;1601;169;1770;93763;95533;-1129;1169;232906;5261;333700;3563733;2417856
2021-03-29;TOS;9688;4845;4843;9204;347;137;0;ITI;ITI1;9;Toscana;43.76923077;11.25588885;1532;262;1794;26096;27890;329;1021;159469;5297;192656;3373577;1751478
2021-03-29;VEN;31482;13709;17773;26648;3830;1004;0;ITH;ITH3;5;Veneto;45.43490485;12.33845213;1616;278;1894;37750;39644;-5;728;329209;10538;379391;6097170;1547483
2021-03-29;LAZ;25629;12182;13447;18197;7093;339;0;ITI;ITI4;12;Lazio;41.89277044;12.48366722;3013;380;3393;47840;51233;-203;1403;224247;6574;282054;5084630;3382522
2021-03-29;LOM;40101;15568;24533;24550;14871;680;0;ITC;ITC4;3;Lombardia;45.46679409;9.190347404;6994;870;7864;87941;95805;-6886;1793;601915;30550;728270;8068777;3493056
2021-03-29;LIG;10595;4629;5966;7365;3135;95;0;ITC;ITC3;7;Liguria;44.41149315;8.9326992;641;72;713;6286;6999;248;337;77602;3851;88452;1220793;510464
2021-03-29;UMB;3639;1605;2034;2153;1424;62;0;ITI;ITI2;10;Umbria;43.10675841;12.38824698;376;57;433;4817;5250;83;320;43640;1237;50127;957768;334692
2021-03-29;SIC;15050;7086;7964;10398;4501;151;0;ITG;ITG1;19;Sicilia;38.11569725;13.362356699999998;876;133;1009;16408;17417;417;799;150426;4607;172450;3147423;1279237
2021-03-30;LAZ;27177;13223;13954;19541;7234;402;0;ITI;ITI4;12;Lazio;41.89277044;12.48366722;3029;379;3408;47690;51098;-135;1593;225943;6606;283647;5122508;3402679
2021-03-30;EMR;23354;10342;13012;17994;5044;316;0;ITH;ITH5;8;Emilia-Romagna;44.49436681;11.341720800000001;3486;392;3878;69202;73080;-810;1187;249404;11859;334343;4819016;1675028
2021-03-30;CAL;6531;2854;3677;3656;2851;24;0;ITF;ITF6;18;Calabria;38.90597598;16.59440194;383;37;420;9982;10402;70;300;35394;815;46611;664356;624561
2021-03-30;UMB;3991;1738;2253;2407;1546;38;0;ITI;ITI2;10;Umbria;43.10675841;12.38824698;372;57;429;4758;5187;-63;222;43919;1243;50349;963064;335511
2021-03-30;SAR;8929;3624;5305;6483;2287;159;0;ITG;ITG2;20;Sardegna;39.21531192;9.110616306;210;33;243;13788;14031;53;205;29795;1233;45059;986641;593387
2021-03-30;SIC;14589;6774;7815;9714;4771;104;0;ITG;ITG1;19;Sicilia;38.11569725;13.362356699999998;876;133;1009;16408;17417;0;0;150426;4607;172450;3147423;1279237
2021-03-30;LOM;39761;15648;24113;24264;14878;619;0;ITC;ITC4;3;Lombardia;45.46679409;9.190347404;7109;862;7971;88551;96522;717;3271;604384;30635;731541;8113066;3500365
2021-03-30;FVG;7627;3410;4217;6288;1202;137;0;ITH;ITH4;6;Friuli-Venezia Giulia;45.6494354;13.76813649;671;80;751;14622;15373;-133;447;78183;3290;96846;1612590;576666
2021-03-30;PIE;17019;7129;9890;8746;7875;398;0;ITC;ITC1;1;Piemonte;45.0732745;7.680687483;3855;369;4224;31193;35417;-368;1861;261296;10269;306982;3284837;1502937
2021-03-30;TOS;17042;7647;9395;13268;3575;199;0;ITI;ITI1;9;Toscana;43.76923077;11.25588885;1542;265;1807;26083;27890;0;1180;160617;5329;193836;3398670;1760000
2021-03-30;PAT;2467;999;1468;1672;693;102;0;ITH;ITH2;4;Provincia Autonoma Trento;46.06893511;11.12123097;217;46;263;2830;3093;-92;84;36477;1278;40848;696625;183344
2021-03-30;PUG;12464;5977;6487;6205;6104;155;0;ITF;ITF4;16;Puglia;41.12559576;16.86736689;1863;264;2127;44649;46776;282;1527;139513;4761;191050;1857302;1007345
2021-03-30;VEN;36011;15320;20691;29735;5253;1023;0;ITH;ITH3;5;Veneto;45.43490485;12.33845213;1629;285;1914;36753;38667;-977;1130;331264;10590;380521;6140454;1553101
2021-03-30;PAB;1303;533;770;205;1083;15;0;ITH;ITH1;4;Provincia Autonoma Bolzano / Bozen;46.49933453;11.35662422;94;27;121;785;906;-25;99;66534;1110;68550;1083140;356179
2021-03-30;ABR;5128;2262;2866;3141;1825;162;0;ITF;ITF1;13;Abruzzo;42.35122196;13.39843823;620;78;698;9864;10562;-104;224;52112;2100;64774;1232453;573030
2021-03-30;VDA;402;223;179;364;20;18;0;ITC;ITC2;2;Valle d'Aosta / Vallée d'Aoste;45.73750286;7.320149366;37;8;45;775;820;29;77;7835;420;9075;92746;50419
2021-03-30;MOL;2037;874;1163;1487;514;36;0;ITF;ITF2;14;Molise;41.55774754;14.65916051;74;17;91;931;1022;-17;31;10706;431;12159;182521;164557
2021-03-30;BAS;2884;1225;1659;2502;366;16;0;ITF;ITF5;17;Basilicata;40.63947052;15.80514834;155;13;168;4550;4718;-69;128;14150;441;19309;291538;167543
2021-03-30;LIG;12231;5432;6799;8752;3395;84;0;ITC;ITC3;7;Liguria;44.41149315;8.9326992;639;70;709;6278;6987;-12;489;78089;3865;88941;1228081;514365
2021-03-30;CAM;22062;10585;11477;18538;2959;565;0;ITF;ITF3;15;Campania;40.83956555;14.25084984;1587;163;1750;92455;94205;-1328;1573;235743;5325;335273;3584308;2427417
2021-03-30;MAR;7489;3082;4407;4576;2837;76;0;ITI;ITI3;11;Marche;43.61675973;13.5188753;807;150;957;8360;9317;-92;329;75568;2611;87496;999527;606587
2021-03-31;MAR;7375;3088;4287;4262;3025;88;0;ITI;ITI3;11;Marche;43.61675973;13.5188753;803;146;949;8194;9143;-174;650;76382;2621;88146;1005511;609883
2021-03-31;LIG;11958;5293;6665;9072;2780;106;0;ITC;ITC3;7;Liguria;44.41149315;8.9326992;642;68;710;6385;7095;108;383;78350;3879;89324;1235904;517132
2021-03-31;PAB;1836;696;1140;729;1014;93;0;ITH;ITH1;4;Provincia Autonoma Bolzano / Bozen;46.49933453;11.35662422;94;25;119;751;870;-36;79;66644;1113;68627;1089209;357219
2021-03-31;ABR;6723;2947;3776;4557;2070;96;0;ITF;ITF1;13;Abruzzo;42.35122196;13.39843823;622;69;691;9569;10260;-302;153;52539;2125;64924;1238648;574823
2021-03-31;MOL;2273;938;1335;1323;821;129;0;ITF;ITF2;14;Molise;41.55774754;14.65916051;73;16;89;938;1027;5;77;10775;434;12236;183522;165470
2021-03-31;BAS;3143;1287;1856;2301;812;30;0;ITF;ITF5;17;Basilicata;40.63947052;15.80514834;170;14;184;4590;4774;56;149;14241;443;19458;292913;168149
2021-03-31;SIC;14527;6710;7817;9441;4937;149;0;ITG;ITG1;19;Sicilia;38.11569725;13.362356699999998;891;140;1031;17658;18689;1272;1673;150806;4628;174123;3162046;1282141
2021-03-31;CAM;23210;11385;11825;19301;3444;465;0;ITF;ITF3;15;Campania;40.83956555;14.25084984;1587;160;1747;91370;93117;-1088;2016;238809;5363;337289;3607514;2438913
2021-03-31;SAR;10637;4235;6402;8065;2438;134;0;ITG;ITG2;20;Sardegna;39.21531192;9.110616306;222;34;256;14141;14397;366;444;29872;1234;45503;1005266;596976
2021-03-31;LOM;42285;17154;25131;26200;15393;692;0;ITC;ITC4;3;Lombardia;45.46679409;9.190347404;7033;863;7896;87959;95855;-667;3943;608894;30735;735484;8169813;3511485
2021-03-31;TOS;32812;13297;19515;20212;12257;343;0;ITI;ITI1;9;Toscana;43.76923077;11.25588885;1560;265;1825;26282;28107;217;1538;161919;5348;195374;3427730;1770281
2021-03-31;CAL;9170;4184;4986;5067;4064;39;0;ITF;ITF6;18;Calabria;38.90597598;16.59440194;389;36;425;9900;10325;-77;347;35814;819;46958;667473;627407
2021-03-31;LAZ;27939;13520;14419;20388;7167;384;0;ITI;ITI4;12;Lazio;41.89277044;12.48366722;3044;371;3415;47636;51051;-47;1800;227752;6644;285447;5156986;3421823
2021-03-31;VEN;38995;16466;22529;30435;7507;1053;0;ITH;ITH3;5;Veneto;45.43490485;12.33845213;1676;282;1958;36739;38697;30;2317;333516;10625;382838;6184340;1558375
2021-03-31;EMR;25306;11067;14239;19506;5474;326;0;ITH;ITH5;8;Emilia-Romagna;44.49436681;11.341720800000001;3427;390;3817;68618;72435;-645;1490;251468;11917;335820;4850208;1679293
2021-03-31;PIE;19156;8135;11021;10115;8700;341;0;ITC;ITC1;1;Piemonte;45.0732745;7.680687483;3873;376;4249;30810;35059;-358;2298;263913;10308;309280;3310922;1512067
2021-03-31;PAT;2627;1002;1625;1659;868;100;0;ITH;ITH2;4;Provincia Autonoma Trento;46.06893511;11.12123097;204;48;252;2754;3006;-87;196;36756;1282;41044;699232;183780
2021-03-31;FVG;8152;3574;4578;7176;850;126;0;ITH;ITH4;6;Friuli-Venezia Giulia;45.6494354;13.76813649;664;82;746;14451;15197;-176;644;78986;3307;97490;1623445;580139
2021-03-31;PUG;14593;6840;7753;8848;5594;151;0;ITF;ITF4;16;Puglia;41.12559576;16.86736689;1840;260;2100;44757;46857;81;1962;141343;4812;193012;1871149;1012722
2021-03-31;VDA;555;302;253;511;26;18;0;ITC;ITC2;2;Valle d'Aosta / Vallée d'Aoste;45.73750286;7.320149366;38;9;47;795;842;22;27;7839;421;9102;92907;50480
2021-03-31;UMB;3901;1731;2170;2184;1686;31;0;ITI;ITI2;10;Umbria;43.10675841;12.38824698;365;60;425;4638;5063;-124;162;44201;1247;50511;967576;336148
2021-04-01;VDA;778;394;384;747;12;19;0;ITC;ITC2;2;Valle d'Aosta / Vallée d'Aoste;45.73750286;7.320149366;45;8;53;849;902;60;76;7910;424;9236;94244;51040
2021-04-01;BAS;2754;1127;1627;1967;755;32;0;ITF;ITF5;17;Basilicata;40.63947052;15.80514834;180;13;193;4669;4862;88;181;14332;445;19639;294451;168803
2021-04-01;PAT;2947;1252;1695;1745;1107;95;0;ITH;ITH2;4;Provincia Autonoma Trento;46.06893511;11.12123097;201;51;252;2611;2863;-143;187;37086;1282;41231;702081;184137
2021-04-01;CAL;8711;3965;4746;4155;4517;39;0;ITF;ITF6;18;Calabria;38.90597598;16.59440194;408;34;442;10194;10636;311;522;36021;823;47480;671400;631063
2021-04-01;TOS;27172;11270;15902;16195;10735;242;0;ITI;ITI1;9;Toscana;43.76923077;11.25588885;1584;265;1849;26579;28428;321;1631;163197;5380;197005;3456566;1781360
2021-04-01;CAM;24699;12027;12672;20024;4137;538;0;ITF;ITF3;15;Campania;40.83956555;14.25084984;1586;160;1746;91003;92749;-368;2258;241380;5418;339547;3631249;2453547
2021-04-01;FVG;6440;3078;3362;5330;1019;91;0;ITH;ITH4;6;Friuli-Venezia Giulia;45.6494354;13.76813649;652;81;733;14083;14816;-381;720;80072;3322;98210;1635068;583929
2021-04-01;PIE;19456;8167;11289;10993;8144;319;0;ITC;ITC1;1;Piemonte;45.0732745;7.680687483;3887;376;4263;30484;34747;-312;2584;266781;10336;311864;3354256;1521421
2021-04-01;LAZ;29842;14166;15676;22209;7188;445;0;ITI;ITI4;12;Lazio;41.89277044;12.48366722;3044;362;3406;47642;51048;-3;1838;229560;6677;287285;5194646;3441009
2021-04-01;UMB;4474;1911;2563;2326;2110;38;0;ITI;ITI2;10;Umbria;43.10675841;12.38824698;372;60;432;4548;4980;-83;49;44333;1247;50560;968402;336274
2021-04-01;SIC;14331;6627;7704;9515;4671;145;0;ITG;ITG1;19;Sicilia;38.11569725;13.362356699999998;896;143;1039;18831;19870;1181;1282;150888;4647;175405;3172351;1284261
2021-04-01;SAR;10301;4109;6192;7120;3026;155;0;ITG;ITG2;20;Sardegna;39.21531192;9.110616306;236;34;270;14384;14654;257;351;29962;1238;45854;1012513;600773
2021-04-01;MOL;1500;677;823;742;730;28;0;ITF;ITF2;14;Molise;41.55774754;14.65916051;72;15;87;895;982;-45;15;10833;436;12251;183679;165624
2021-04-01;PAB;2791;1409;1382;2506;146;139;0;ITH;ITH1;4;Provincia Autonoma Bolzano / Bozen;46.49933453;11.35662422;98;23;121;648;769;-101;35;66771;1121;68661;1093129;357472
2021-04-01;LIG;12443;5521;6922;9588;2776;79;0;ITC;ITC3;7;Liguria;44.41149315;8.9326992;648;71;719;6559;7278;183;710;78867;3889;90034;1244354;520369
2021-04-01;PUG;13995;6578;7417;7385;6390;220;0;ITF;ITF4;16;Puglia;41.12559576;16.86736689;1855;260;2115;45917;48032;1175;2369;142501;4848;195381;1884442;1017836
2021-04-01;LOM;43210;17330;25880;26087;16408;715;0;ITC;ITC4;3;Lombardia;45.46679409;9.190347404;6823;860;7683;88351;96034;179;4483;613071;30862;739967;8228701;3524343
2021-04-01;MAR;7578;3185;4393;4064;3419;95;0;ITI;ITI3;11;Marche;43.61675973;13.5188753;796;143;939;8150;9089;-54;487;76904;2640;88633;1011119;612808
2021-04-01;ABR;5628;2520;3108;3428;2120;80;0;ITF;ITF1;13;Abruzzo;42.35122196;13.39843823;607;68;675;9457;10132;-128;314;52969;2136;65237;1245216;576469
2021-04-01;EMR;23980;10787;13193;19072;4561;347;0;ITH;ITH5;8;Emilia-Romagna;44.49436681;11.341720800000001;3337;381;3718;68641;72359;-76;1809;253277;11984;337620;4881387;1683128
2021-04-01;VEN;25409;11200;14209;18216;6414;779;0;ITH;ITH3;5;Veneto;45.43490485;12.33845213;1677;281;1958;36660;38618;-79;1633;335200;10653;384471;6226952;1562487
2021-04-02;FVG;6615;2941;3674;4641;1843;131;0;ITH;ITH4;6;Friuli-Venezia Giulia;45.6494354;13.76813649;634;81;715;13589;14304;-512;513;81081;3338;98723;1645295;587088
2021-04-02;TOS;32021;13581;18440;23683;8083;255;0;ITI;ITI1;9;Toscana;43.76923077;11.25588885;1587;274;1861;26815;28676;248;1640;164563;5406;198645;3487033;1792652
2021-04-02;SAR;9330;3624;5706;5923;3253;154;0;ITG;ITG2;20;Sardegna;39.21531192;9.110616306;244;35;279;14752;15031;377;473;30056;1240;46327;1019142;604610
2021-04-02;LIG;11796;5223;6573;9221;2489;86;0;ITC;ITC3;7;Liguria;44.41149315;8.9326992;650;72;722;6671;7393;115;472;79216;3897;90506;1251172;522953
2021-04-02;LOM;41425;16957;24468;26209;14655;561;0;ITC;ITC4;3;Lombardia;45.46679409;9.190347404;6703;857;7560;89096;96656;622;3941;616293;30959;743908;8286122;3535618
2021-04-02;PIE;20185;8334;11851;11344;8434;407;0;ITC;ITC1;1;Piemonte;45.0732745;7.680687483;3864;378;4242;30127;34369;-378;1942;269038;10399;313806;3369140;1529383
2021-04-02;PAT;2894;1180;1714;2045;684;165;0;ITH;ITH2;4;Provincia Autonoma Trento;46.06893511;11.12123097;202;47;249;2615;2864;1;140;37221;1286;41371;704495;184396
2021-04-02;MAR;6893;2987;3906;6042;739;112;0;ITI;ITI3;11;Marche;43.61675973;13.5188753;793;142;935;7932;8867;-222;651;77762;2655;89284;1016839;615827
2021-04-02;PUG;12877;6015;6862;8194;4532;151;0;ITF;ITF4;16;Puglia;41.12559576;16.86736689;1879;263;2142;46605;48747;715;2044;143805;4873;197425;1899147;1023338
2021-04-02;VEN;24125;10637;13488;17150;6332;643;0;ITH;ITH3;5;Veneto;45.43490485;12.33845213;1666;284;1950;36049;37999;-619;1567;337357;10682;386038;6266877;1566736
2021-04-02;SIC;13906;6561;7345;9045;4739;122;0;ITG;ITG1;19;Sicilia;38.11569725;13.362356699999998;898;150;1048;19963;21011;1141;1222;150954;4662;176627;3193495;1286168
2021-04-02;CAL;8564;3923;4641;4586;3944;34;0;ITF;ITF6;18;Calabria;38.90597598;16.59440194;406;36;442;10359;10801;165;465;36309;835;47945;675137;634571
2021-04-02;PAB;2090;841;1249;590;1357;143;0;ITH;ITH1;4;Provincia Autonoma Bolzano / Bozen;46.49933453;11.35662422;99;20;119;600;719;-50;180;66995;1123;68837;1109853;359376
2021-04-02;MOL;1487;727;760;669;784;34;0;ITF;ITF2;14;Molise;41.55774754;14.65916051;66;16;82;851;933;-49;2;10883;437;12253;183911;165848
2021-04-02;BAS;2347;1060;1287;1716;606;25;0;ITF;ITF5;17;Basilicata;40.63947052;15.80514834;178;12;190;4766;4956;94;166;14401;448;19805;296138;169502
2021-04-02;ABR;6697;3104;3593;5110;1489;98;0;ITF;ITF1;13;Abruzzo;42.35122196;13.39843823;606;69;675;9466;10141;9;272;53222;2145;65508;1250212;577849
2021-04-02;LAZ;29592;14199;15393;21733;7412;447;0;ITI;ITI4;12;Lazio;41.89277044;12.48366722;3068;376;3444;47697;51141;93;1918;231342;6720;289203;5229538;3459173
2021-04-02;EMR;23418;10561;12857;18559;4490;369;0;ITH;ITH5;8;Emilia-Romagna;44.49436681;11.341720800000001;3299;371;3670;69579;73249;890;1830;254151;12040;339440;4911635;1686958
2021-04-02;CAM;21872;10528;11344;19035;2324;513;0;ITF;ITF3;15;Campania;40.83956555;14.25084984;1558;155;1713;90057;91770;-979;2057;244359;5475;341604;3653837;2467068
2021-04-02;VDA;875;345;530;626;226;23;0;ITC;ITC2;2;Valle d'Aosta / Vallée d'Aoste;45.73750286;7.320149366;49;8;57;845;902;0;62;7971;425;9298;95322;51514
2021-04-02;UMB;4349;1782;2567;3547;757;45;0;ITI;ITI2;10;Umbria;43.10675841;12.38824698;354;60;414;4631;5045;65;186;44449;1252;50746;975227;337207
2021-04-03;VDA;676;341;335;649;15;12;0;ITC;ITC2;2;Valle d'Aosta / Vallée d'Aoste;45.73750286;7.320149366;49;9;58;871;929;27;52;7996;425;9350;96248;51980
2021-04-03;ABR;5165;2259;2906;3485;1598;82;0;ITF;ITF1;13;Abruzzo;42.35122196;13.39843823;577;69;646;9694;10340;199;424;53440;2151;65931;1257775;579809
2021-04-03;BAS;1815;754;1061;1464;338;13;0;ITF;ITF5;17;Basilicata;40.63947052;15.80514834;175;12;187;4799;4986;30;94;14463;450;19899;297874;170100
2021-04-03;UMB;2099;712;1387;1035;1054;10;0;ITI;ITI2;10;Umbria;43.10675841;12.38824698;349;60;409;4397;4806;-239;162;44846;1256;50908;980871;337974
2021-04-03;CAM;21120;10316;10804;18223;2383;514;0;ITF;ITF3;15;Campania;40.83956555;14.25084984;1567;152;1719;90363;92082;312;2314;246327;5509;343918;3678377;2481597
2021-04-03;CAL;9470;4097;5373;4534;4870;66;0;ITF;ITF6;18;Calabria;38.90597598;16.59440194;420;38;458;10598;11056;255;448;36500;837;48393;679005;638174
2021-04-03;LIG;5410;2500;2910;4436;944;30;0;ITC;ITC3;7;Liguria;44.41149315;8.9326992;652;78;730;6882;7612;219;460;79456;3898;90966;1257817;525496
2021-04-03;TOS;15023;6649;8374;13684;1123;216;0;ITI;ITI1;9;Toscana;43.76923077;11.25588885;1603;278;1881;26828;28709;33;1473;165981;5428;200118;3517381;1802952
2021-04-03;PIE;19533;8231;11302;10634;8582;317;0;ITC;ITC1;1;Piemonte;45.0732745;7.680687483;3819;369;4188;29848;34036;-333;2127;271475;10422;315933;3411465;1538563
2021-04-03;PAT;1183;487;696;936;178;69;0;ITH;ITH2;4;Provincia Autonoma Trento;46.06893511;11.12123097;189;51;240;2494;2734;-130;114;37462;1289;41485;706890;184663
2021-04-03;FVG;4027;1997;2030;2624;1341;62;0;ITH;ITH4;6;Friuli-Venezia Giulia;45.6494354;13.76813649;596;78;674;13358;14032;-272;452;81785;3358;99175;1654219;590115
2021-04-03;VEN;22001;9650;12351;13870;7725;406;0;ITH;ITH3;5;Veneto;45.43490485;12.33845213;1652;286;1938;35565;37503;-496;1563;339384;10714;387601;6307654;1572606
2021-04-03;PUG;10589;4661;5928;6817;3578;194;0;ITF;ITF4;16;Puglia;41.12559576;16.86736689;1897;256;2153;48013;50166;1419;2142;144505;4896;199567;1912783;1027316
2021-04-03;MAR;7575;3204;4371;6735;667;173;0;ITI;ITI3;11;Marche;43.61675973;13.5188753;785;140;925;7907;8832;-35;579;78365;2666;89863;1022624;618804
2021-04-03;PAB;833;366;467;22;811;0;0;ITH;ITH1;4;Provincia Autonoma Bolzano / Bozen;46.49933453;11.35662422;90;20;110;576;686;-33;120;67142;1126;68954;1123271;360849
2021-04-03;MOL;1807;867;940;1731;37;39;0;ITF;ITF2;14;Molise;41.55774754;14.65916051;63;16;79;787;866;-67;17;10966;438;12270;184516;166401
2021-04-03;EMR;20005;8788;11217;15958;3801;246;0;ITH;ITH5;8;Emilia-Romagna;44.49436681;11.341720800000001;3181;366;3547;68933;72480;-769;1789;256660;12078;341218;4943483;1690474
2021-04-03;SAR;4731;1825;2906;2673;1987;71;0;ITG;ITG2;20;Sardegna;39.21531192;9.110616306;255;38;293;14996;15289;258;328;30125;1241;46655;1023789;608371
2021-04-03;SIC;16422;7819;8603;13419;2838;165;0;ITG;ITG1;19;Sicilia;38.11569725;13.362356699999998;902;152;1054;20871;21925;914;1014;151040;4676;177641;3213434;1287921
2021-04-03;LOM;36354;14906;21448;25788;10180;386;0;ITC;ITC4;3;Lombardia;45.46679409;9.190347404;6660;862;7522;86603;94125;-2531;4132;622859;31056;748040;8344076;3546660
2021-04-03;LAZ;24880;11238;13642;17877;6749;254;0;ITI;ITI4;12;Lazio;41.89277044;12.48366722;3077;392;3469;48483;51952;811;1631;232135;6747;290834;5269077;3480326
2021-04-04;VEN;7789;3535;4254;6512;1148;129;0;ITH;ITH3;5;Veneto;45.43490485;12.33845213;1680;282;1962;35505;37467;-36;1185;340581;10738;388786;6332236;1576279
2021-04-04;CAL;1573;788;785;1140;422;11;0;ITF;ITF6;18;Calabria;38.90597598;16.59440194;429;37;466;11017;11483;427;511;36574;847;48904;682022;640714
2021-04-04;FVG;5;3;2;2;3;0;0;ITH;ITH4;6;Friuli-Venezia Giulia;45.6494354;13.76813649;582;82;664;13096;13760;-272;342;82381;3376;99517;1660335;592298
2021-04-04;EMR;9888;4721;5167;7532;2273;83;0;ITH;ITH5;8;Emilia-Romagna;44.49436681;11.341720800000001;3117;360;3477;68711;72188;-292;1700;258614;12113;342915;4963261;1694312
2021-04-04;PIE;9270;4060;5210;6399;2714;157;0;ITC;ITC1;1;Piemonte;45.0732745;7.680687483;3837;370;4207;29748;33955;-81;1425;272953;10450;317358;3425010;1544230
2021-04-04;UMB;57;20;37;22;35;0;0;ITI;ITI2;10;Umbria;43.10675841;12.38824698;335;57;392;4420;4812;6;174;45011;1259;51082;986508;338733
2021-04-04;LAZ;17676;8206;9470;12251;5294;131;0;ITI;ITI4;12;Lazio;41.89277044;12.48366722;3071;391;3462;49185;52647;695;1523;232937;6773;292357;5306915;3499855
2021-04-04;LOM;7616;3232;4384;3683;3899;34;0;ITC;ITC4;3;Lombardia;45.46679409;9.190347404;6622;864;7486;86478;93964;-161;3003;625949;31130;751043;8385613;3555096
2021-04-04;SIC;6800;3323;3477;5433;1295;72;0;ITG;ITG1;19;Sicilia;38.11569725;13.362356699999998;974;153;1127;21725;22852;927;1015;151107;4697;178656;3231527;1289522
2021-04-04;CAM;7965;4016;3949;6669;1046;250;0;ITF;ITF3;15;Campania;40.83956555;14.25084984;1509;153;1662;91302;92964;882;1908;247346;5516;345826;3696627;2495049
2021-04-04;SAR;2;1;1;0;2;0;0;ITG;ITG2;20;Sardegna;39.21531192;9.110616306;257;41;298;15258;15556;267;323;30180;1242;46978;1028036;611926
2021-04-04;PUG;6002;2979;3023;5913;7;82;0;ITF;ITF4;16;Puglia;41.12559576;16.86736689;1896;252;2148;49023;51171;1005;1628;145113;4911;201195;1923001;1029714
2021-04-04;TOS;13930;6613;7317;13510;255;165;0;ITI;ITI1;9;Toscana;43.76923077;11.25588885;1614;274;1888;27340;29228;519;1626;167062;5454;201744;3541771;1811673
2021-04-04;MAR;3836;1797;2039;2614;1170;52;0;ITI;ITI3;11;Marche;43.61675973;13.5188753;744;142;886;7845;8731;-101;323;78773;2682;90186;1026304;620653
2021-04-04;MOL;258;142;116;231;15;12;0;ITF;ITF2;14;Molise;41.55774754;14.65916051;63;16;79;753;832;-34;36;11034;440;12306;185074;166915
2021-04-04;LIG;764;369;395;508;251;5;0;ITC;ITC3;7;Liguria;44.41149315;8.9326992;680;76;756;6801;7557;-55;412;79917;3904;91378;1263817;527679
2021-04-04;VDA;573;254;319;562;0;11;0;ITC;ITC2;2;Valle d'Aosta / Vallée d'Aoste;45.73750286;7.320149366;56;10;66;932;998;69;115;8041;426;9465;97294;52455
2021-04-04;ABR;1633;769;864;1458;129;46;0;ITF;ITF1;13;Abruzzo;42.35122196;13.39843823;573;71;644;9655;10299;-41;225;53691;2166;66156;1264278;581586
2021-04-04;BAS;611;227;384;187;418;6;0;ITF;ITF5;17;Basilicata;40.63947052;15.80514834;173;12;185;4837;5022;36;119;14544;452;20018;299131;170604
2021-04-05;MAR;5703;2367;3336;4352;1269;82;0;ITI;ITI3;11;Marche;43.61675973;13.5188753;764;142;906;7796;8702;-29;182;78975;2691;90368;1028766;622383
2021-04-05;PAB;305;147;158;23;281;1;0;ITH;ITH1;4;Provincia Autonoma Bolzano / Bozen;46.49933453;11.35662422;85;19;104;577;681;-5;117;67260;1130;69071;1136750;362396
2021-04-05;PUG;12791;6214;6577;12111;536;144;0;ITF;ITF4;16;Puglia;41.12559576;16.86736689;1910;248;2158;49062;51220;49;677;145721;4931;201872;1926979;1031836
2021-04-05;MOL;392;190;202;293;99;0;0;ITF;ITF2;14;Molise;41.55774754;14.65916051;57;16;73;761;834;2;55;11087;440;12361;185671;167481
2021-04-05;BAS;726;235;491;411;305;10;0;ITF;ITF5;17;Basilicata;40.63947052;15.80514834;171;12;183;4733;4916;-106;16;14664;454;20034;299505;170777
2021-04-05;ABR;2692;1147;1545;1729;880;83;0;ITF;ITF1;13;Abruzzo;42.35122196;13.39843823;585;69;654;10074;10728;429;438;53697;2169;66594;1270263;583212
2021-04-05;FVG;2913;1449;1464;2832;17;64;0;ITH;ITH4;6;Friuli-Venezia Giulia;45.6494354;13.76813649;592;86;678;12732;13410;-350;150;82871;3386;99667;1663316;593264
2021-04-05;EMR;14862;6812;8050;11788;2895;179;0;ITH;ITH5;8;Emilia-Romagna;44.49436681;11.341720800000001;3149;366;3515;68691;72206;18;1493;260051;12151;344408;4969490;1696096
2021-04-05;LAZ;19998;9160;10838;13601;6221;176;0;ITI;ITI4;12;Lazio;41.89277044;12.48366722;3095;396;3491;49737;53228;581;1419;233743;6805;293776;5318382;3505692
2021-04-05;VDA;465;223;242;445;6;14;0;ITC;ITC2;2;Valle d'Aosta / Vallée d'Aoste;45.73750286;7.320149366;55;12;67;978;1045;47;79;8072;427;9544;98181;52855
2021-04-05;LIG;3985;1757;2228;2313;1651;21;0;ITC;ITC3;7;Liguria;44.41149315;8.9326992;683;78;761;6969;7730;173;402;80145;3905;91780;1267718;529221
2021-04-05;CAM;11641;5541;6100;8888;2424;329;0;ITF;ITF3;15;Campania;40.83956555;14.25084984;1599;159;1758;90740;92498;-466;929;248732;5525;346755;3707152;2498954
2021-04-05;CAL;3648;1731;1917;2675;960;13;0;ITF;ITF6;18;Calabria;38.90597598;16.59440194;429;39;468;11089;11557;74;197;36690;854;49101;683364;641915
2021-04-05;VEN;19165;8376;10789;13423;5439;303;0;ITH;ITH3;5;Veneto;45.43490485;12.33845213;1679;287;1966;35506;37472;5;649;341208;10755;389435;6342099;1578286
2021-04-05;PIE;14779;6250;8529;11963;2563;253;0;ITC;ITC1;1;Piemonte;45.0732745;7.680687483;3851;365;4216;29537;33753;-202;804;273946;10463;318162;3433168;1546447
2021-04-05;TOS;15288;6826;8462;14371;737;180;0;ITI;ITI1;9;Toscana;43.76923077;11.25588885;1666;282;1948;27276;29224;-4;981;168023;5478;202725;3552288;1816143
2021-04-05;LOM;27397;11702;15695;19029;8113;255;0;ITC;ITC4;3;Lombardia;45.46679409;9.190347404;6626;858;7484;86947;94431;467;1358;626759;31211;752401;8402953;3560052
2021-04-05;SAR;2097;798;1299;2048;1;48;0;ITG;ITG2;20;Sardegna;39.21531192;9.110616306;278;45;323;15445;15768;212;261;30227;1244;47239;1030218;613758
2021-04-05;UMB;4251;1729;2522;2182;2057;12;0;ITI;ITI2;10;Umbria;43.10675841;12.38824698;326;54;380;4374;4754;-58;189;45257;1260;51271;993574;339544
2021-04-05;SIC;8025;3959;4066;6510;1443;72;0;ITG;ITG1;19;Sicilia;38.11569725;13.362356699999998;1025;158;1183;22522;23705;853;909;151143;4717;179565;3239088;1291172
2021-04-05;PAT;35;17;18;30;2;3;0;ITH;ITH2;4;Provincia Autonoma Trento;46.06893511;11.12123097;179;51;230;2410;2640;-94;127;37677;1295;41612;709794;184990
2021-04-06;UMB;5294;2167;3127;2865;2392;37;0;ITI;ITI2;10;Umbria;43.10675841;12.38824698;317;53;370;4257;4627;-127;106;45489;1261;51377;999930;340239
2021-04-06;PIE;20839;9089;11750;15159;5218;462;0;ITC;ITC1;1;Piemonte;45.0732745;7.680687483;3882;370;4252;28536;32788;-965;852;275745;10481;319014;3445699;1549624
2021-04-06;PAT;2288;969;1319;1459;770;59;0;ITH;ITH2;4;Provincia Autonoma Trento;46.06893511;11.12123097;183;51;234;2489;2723;83;169;37761;1297;41781;711753;185348
2021-04-06;EMR;24775;11182;13593;19730;4752;293;0;ITH;ITH5;8;Emilia-Romagna;44.49436681;11.341720800000001;3206;367;3573;67317;70890;-1316;791;262117;12189;345196;4982493;1697399
2021-04-06;SAR;7583;3160;4423;5063;2440;80;0;ITG;ITG2;20;Sardegna;39.21531192;9.110616306;297;47;344;15493;15837;69;128;30285;1245;47367;1036300;615275
2021-04-06;CAM;24535;11572;12963;19448;4527;560;0;ITF;ITF3;15;Campania;40.83956555;14.25084984;1603;160;1763;90139;91902;-596;846;250112;5587;347601;3714529;2503245
2021-04-06;LOM;43108;17601;25507;24448;17962;698;0;ITC;ITC4;3;Lombardia;45.46679409;9.190347404;6643;845;7488;76211;83699;-10732;841;638279;31264;753242;8413420;3562362
2021-04-06;LAZ;24681;11304;13377;17104;7197;380;0;ITI;ITI4;12;Lazio;41.89277044;12.48366722;3240;396;3636;49942;53578;350;1120;234470;6848;294896;5330821;3511129
2021-04-06;TOS;22255;9845;12410;18093;3743;419;0;ITI;ITI1;9;Toscana;43.76923077;11.25588885;1712;279;1991;27088;29079;-145;685;168821;5510;203410;3561041;1819321
2021-04-06;FVG;6715;3158;3557;5428;1178;109;0;ITH;ITH4;6;Friuli-Venezia Giulia;45.6494354;13.76813649;604;81;685;12637;13322;-88;63;83006;3402;99730;1665109;593752
2021-04-06;ABR;7683;3581;4102;5230;2322;131;0;ITF;ITF1;13;Abruzzo;42.35122196;13.39843823;596;70;666;10050;10716;-12;19;53724;2173;66613;1270606;583307
2021-04-06;SIC;17767;8487;9280;13254;4299;214;0;ITG;ITG1;19;Sicilia;38.11569725;13.362356699999998;1082;160;1242;23210;24452;747;783;151166;4730;180348;3250857;1292597
2021-04-06;VEN;29037;13369;15668;23263;5046;728;0;ITH;ITH3;5;Veneto;45.43490485;12.33845213;1710;296;2006;34980;36986;-486;507;342186;10770;389942;6351987;1580323
2021-04-06;BAS;1274;465;809;1072;184;18;0;ITF;ITF5;17;Basilicata;40.63947052;15.80514834;174;13;187;4728;4915;-1;21;14678;462;20055;299864;170974
2021-04-06;PAB;2254;1120;1134;1949;102;203;0;ITH;ITH1;4;Provincia Autonoma Bolzano / Bozen;46.49933453;11.35662422;72;18;90;575;665;-16;134;67403;1133;69201;1148145;363867
2021-04-06;PUG;13874;6266;7608;6924;6775;175;0;ITF;ITF4;16;Puglia;41.12559576;16.86736689;1988;252;2240;48214;50454;-766;475;146892;5001;202347;1932738;1033397
2021-04-06;VDA;743;382;361;598;112;33;0;ITC;ITC2;2;Valle d'Aosta / Vallée d'Aoste;45.73750286;7.320149366;52;13;65;1041;1106;61;102;8112;428;9646;98611;53139
2021-04-06;MOL;1530;715;815;1144;346;40;0;ITF;ITF2;14;Molise;41.55774754;14.65916051;55;14;69;749;818;-16;33;11132;444;12394;186272;168043
2021-04-06;CAL;8198;3738;4460;4465;3696;37;0;ITF;ITF6;18;Calabria;38.90597598;16.59440194;439;37;476;11020;11496;-61;203;36944;864;49304;684728;643229
2021-04-06;LIG;13268;5905;7363;10895;2266;107;0;ITC;ITC3;7;Liguria;44.41149315;8.9326992;691;80;771;7217;7988;258;174;80056;3910;91954;1270878;530235
2021-04-06;MAR;8876;3693;5183;7928;810;138;0;ITI;ITI3;11;Marche;43.61675973;13.5188753;783;141;924;7507;8431;-271;66;79302;2701;90434;1029610;622700
2021-04-07;TOS;35859;15486;20373;28159;7276;424;0;ITI;ITI1;9;Toscana;43.76923077;11.25588885;1724;275;1999;26353;28352;-727;937;170444;5551;204347;3588310;1826980
2021-04-07;PUG;15757;7155;8602;8842;6716;199;0;ITF;ITF4;16;Puglia;41.12559576;16.86736689;2029;268;2297;48432;50729;275;1255;147829;5044;203602;1948468;1039651
2021-04-07;LIG;13697;6116;7581;11311;2294;92;0;ITC;ITC3;7;Liguria;44.41149315;8.9326992;672;81;753;7219;7972;-16;425;80485;3922;92379;1280616;534062
2021-04-07;MAR;8875;3933;4942;8356;369;150;0;ITI;ITI3;11;Marche;43.61675973;13.5188753;758;139;897;7429;8326;-105;286;79677;2717;90720;1035069;625890
2021-04-07;PAB;1804;826;978;1171;541;92;0;ITH;ITH1;4;Provincia Autonoma Bolzano / Bozen;46.49933453;11.35662422;69;16;85;556;641;-24;145;67567;1135;69343;1157597;365149
2021-04-07;ABR;8562;3968;4594;5204;3219;139;0;ITF;ITF1;13;Abruzzo;42.35122196;13.39843823;603;70;673;9898;10571;-145;47;53902;2187;66660;1272084;583700
2021-04-07;BAS;1212;552;660;1157;36;19;0;ITF;ITF5;17;Basilicata;40.63947052;15.80514834;176;12;188;4731;4919;4;142;14808;470;20197;301556;171649
2021-04-07;MOL;1740;882;858;1376;276;88;0;ITF;ITF2;14;Molise;41.55774754;14.65916051;49;15;64;728;792;-26;40;11195;447;12434;186874;168594
2021-04-07;CAL;9209;4184;5025;5072;4077;60;0;ITF;ITF6;18;Calabria;38.90597598;16.59440194;452;39;491;10952;11443;-53;292;37281;872;49596;687923;646152
2021-04-07;PAT;2656;1029;1627;1577;955;124;0;ITH;ITH2;4;Provincia Autonoma Trento;46.06893511;11.12123097;183;53;236;2363;2599;-124;40;37925;1297;41821;712419;185514
2021-04-07;LAZ;26074;12209;13865;18330;7339;405;0;ITI;ITI4;12;Lazio;41.89277044;12.48366722;3265;382;3647;49164;52811;-767;1081;236271;6895;295977;5368195;3531572
2021-04-07;VEN;36070;16209;19861;27611;7342;1117;0;ITH;ITH3;5;Veneto;45.43490485;12.33845213;1720;303;2023;33514;35537;-1449;1111;344679;10837;391053;6395953;1585744
2021-04-07;CAM;24979;11992;12987;19635;4726;618;0;ITF;ITF3;15;Campania;40.83956555;14.25084984;1606;149;1755;89352;91107;-795;1358;252199;5653;348959;3730599;2514674
2021-04-07;SAR;13738;6109;7629;7908;5743;87;0;ITG;ITG2;20;Sardegna;39.21531192;9.110616306;294;47;341;15649;15990;153;263;30390;1250;47630;1042899;618146
2021-04-07;LOM;50669;20954;29715;34086;15869;714;0;ITC;ITC4;3;Lombardia;45.46679409;9.190347404;6595;834;7429;74864;82293;-1406;2569;642145;31373;755811;8460138;3568955
2021-04-07;FVG;7863;3647;4216;6953;789;121;0;ITH;ITH4;6;Friuli-Venezia Giulia;45.6494354;13.76813649;584;79;663;12299;12962;-360;286;83630;3424;100016;1672375;595991
2021-04-07;EMR;26895;12309;14586;20462;6081;352;0;ITH;ITH5;8;Emilia-Romagna;44.49436681;11.341720800000001;3160;356;3516;65459;68975;-1915;576;264532;12246;345753;5014353;1700203
2021-04-07;PIE;23723;10047;13676;17717;5463;543;0;ITC;ITC1;1;Piemonte;45.0732745;7.680687483;3889;357;4246;27276;31522;-1266;1464;278396;10560;320478;3469796;1557310
2021-04-07;VDA;910;474;436;655;229;26;0;ITC;ITC2;2;Valle d'Aosta / Vallée d'Aoste;45.73750286;7.320149366;52;14;66;1107;1173;67;75;8120;428;9721;99147;53228
2021-04-07;SIC;18457;9069;9388;9737;8518;202;0;ITG;ITG1;19;Sicilia;38.11569725;13.362356699999998;1125;157;1282;24064;25346;894;998;151254;4746;181346;3275815;1294528
2021-04-07;UMB;5626;2305;3321;3533;2006;87;0;ITI;ITI2;10;Umbria;43.10675841;12.38824698;302;50;352;4189;4541;-86;152;45722;1266;51529;1005133;340837
2021-04-08;BAS;788;361;427;760;10;18;0;ITF;ITF5;17;Basilicata;40.63947052;15.80514834;169;10;179;4807;4986;67;163;14899;475;20360;303078;172219
2021-04-08;ABR;7395;3335;4060;4933;2332;130;0;ITF;ITF1;13;Abruzzo;42.35122196;13.39843823;592;72;664;9733;10397;-174;219;54281;2200;66878;1280660;585916
2021-04-08;SIC;19023;9347;9676;9280;9542;201;0;ITG;ITG1;19;Sicilia;38.11569725;13.362356699999998;1119;164;1283;25244;26527;1181;1287;151349;4757;182633;3302985;1304623
2021-04-08;VDA;585;282;303;420;144;21;0;ITC;ITC2;2;Valle d'Aosta / Vallée d'Aoste;45.73750286;7.320149366;55;15;70;1127;1197;24;34;8129;429;9755;99381;53321
2021-04-08;FVG;7476;3238;4238;5408;1931;137;0;ITH;ITH4;6;Friuli-Venezia Giulia;45.6494354;13.76813649;554;77;631;11609;12240;-722;457;84780;3453;100473;1685439;599265
2021-04-08;CAM;28525;13841;14684;22027;5848;650;0;ITF;ITF3;15;Campania;40.83956555;14.25084984;1605;148;1753;89258;91011;-96;1933;254178;5703;350892;3758573;2529371
2021-04-08;CAL;9381;4445;4936;5835;3492;54;0;ITF;ITF6;18;Calabria;38.90597598;16.59440194;448;38;486;11303;11789;346;503;37427;883;50099;691819;648897
2021-04-08;UMB;5904;2525;3379;4024;1807;73;0;ITI;ITI2;10;Umbria;43.10675841;12.38824698;303;47;350;4096;4446;-95;53;45866;1270;51582;1005988;340942
2021-04-08;PIE;25372;11042;14330;20070;4732;570;0;ITC;ITC1;1;Piemonte;45.0732745;7.680687483;3800;346;4146;26247;30393;-1129;1661;281158;10588;322139;3494607;1564691
2021-04-08;LAZ;26929;12342;14587;18768;7737;424;0;ITI;ITI4;12;Lazio;41.89277044;12.48366722;3228;382;3610;48570;52180;-631;1240;238105;6932;297217;5406870;3552678
2021-04-08;PAT;3182;1336;1846;1954;1133;95;0;ITH;ITH2;4;Provincia Autonoma Trento;46.06893511;11.12123097;175;53;228;2183;2411;-188;26;38135;1301;41847;713437;185710
2021-04-08;PAB;2799;1362;1437;2503;204;92;0;ITH;ITH1;4;Provincia Autonoma Bolzano / Bozen;46.49933453;11.35662422;76;16;92;508;600;-41;81;67681;1138;69419;1161803;365945
2021-04-08;PUG;17542;7620;9922;11124;6204;214;0;ITF;ITF4;16;Puglia;41.12559576;16.86736689;2020;256;2276;48479;50755;26;1974;149726;5095;205576;1963363;1043395
2021-04-08;LOM;52484;21804;30680;35308;16504;672;0;ITC;ITC4;3;Lombardia;45.46679409;9.190347404;6501;830;7331;74664;81995;-298;2537;644850;31503;758348;8514418;3578375
2021-04-08;SAR;13610;5972;7638;8333;5156;121;0;ITG;ITG2;20;Sardegna;39.21531192;9.110616306;302;49;351;15848;16199;209;305;30481;1255;47935;1049497;622693
2021-04-08;LIG;13801;6186;7615;11616;2049;136;0;ITC;ITC3;7;Liguria;44.41149315;8.9326992;676;79;755;6973;7728;-244;387;81103;3935;92766;1289581;536947
2021-04-08;MAR;9492;4158;5334;8959;370;163;0;ITI;ITI3;11;Marche;43.61675973;13.5188753;755;138;893;7441;8334;8;490;80139;2737;91210;1040658;628718
2021-04-08;EMR;31409;14422;16987;25329;5337;743;0;ITH;ITH5;8;Emilia-Romagna;44.49436681;11.341720800000001;3051;352;3403;65452;68855;-120;1075;265694;12271;346820;5044615;1704348
2021-04-08;TOS;29821;12617;17204;23004;6448;369;0;ITI;ITI1;9;Toscana;43.76923077;11.25588885;1707;285;1992;26211;28203;-149;1153;171726;5571;205500;3616539;1836475
2021-04-08;VEN;32419;14390;18029;23354;7889;1176;0;ITH;ITH3;5;Veneto;45.43490485;12.33845213;1693;305;1998;32141;34139;-1398;1241;347294;10861;392294;6440831;1590929
2021-04-08;MOL;1808;929;879;1556;203;49;0;ITF;ITF2;14;Molise;41.55774754;14.65916051;51;15;66;692;758;-34;18;11247;447;12452;187196;168892
2021-04-09;SAR;12490;5530;6960;7935;4404;151;0;ITG;ITG2;20;Sardegna;39.21531192;9.110616306;321;50;371;16078;16449;250;380;30607;1259;48315;1057452;626980
2021-04-09;VEN;31207;13769;17438;21916;8350;941;0;ITH;ITH3;5;Veneto;45.43490485;12.33845213;1637;295;1932;30986;32918;-1221;988;349465;10899;393282;6476929;1593739
2021-04-09;LIG;12487;5570;6917;10565;1787;135;0;ITC;ITC3;7;Liguria;44.41149315;8.9326992;645;74;719;6896;7615;-113;421;81622;3950;93187;1297694;539733
2021-04-09;LOM;52477;22408;30069;35603;16028;846;0;ITC;ITC4;3;Lombardia;45.46679409;9.190347404;6252;828;7080;74499;81579;-416;3289;648463;31595;761637;8570894;3589306
2021-04-09;TOS;24612;10589;14023;20720;3442;450;0;ITI;ITI1;9;Toscana;43.76923077;11.25588885;1704;284;1988;26172;28160;-43;1309;173045;5604;206809;3642633;1845570
2021-04-09;PIE;25935;11417;14518;20845;4508;582;0;ITC;ITC1;1;Piemonte;45.0732745;7.680687483;3706;329;4035;25648;29683;-710;1798;283629;10625;323937;3523825;1572352
2021-04-09;PAT;2807;1195;1612;1529;1209;69;0;ITH;ITH2;4;Provincia Autonoma Trento;46.06893511;11.12123097;166;48;214;2063;2277;-134;103;38367;1306;41950;715746;185978
2021-04-09;SIC;20236;9845;10391;10919;9050;267;0;ITG;ITG1;19;Sicilia;38.11569725;13.362356699999998;1149;168;1317;20435;21752;-4775;1505;157371;5015;184138;3335167;1315421
2021-04-09;LAZ;27774;12652;15122;19141;8292;341;0;ITI;ITI4;12;Lazio;41.89277044;12.48366722;3173;368;3541;48400;51941;-239;1363;239660;6979;298580;5444501;3572422
2021-04-09;CAM;29950;14084;15866;23143;6139;668;0;ITF;ITF3;15;Campania;40.83956555;14.25084984;1558;148;1706;89532;91238;227;2225;256145;5734;353117;3784494;2545943
2021-04-09;PUG;22196;9567;12629;17096;4709;391;0;ITF;ITF4;16;Puglia;41.12559576;16.86736689;1980;260;2240;48807;51047;292;1791;151177;5143;207367;1977644;1048357
2021-04-09;MAR;9569;4190;5379;9147;200;222;0;ITI;ITI3;11;Marche;43.61675973;13.5188753;746;134;880;7379;8259;-75;452;80651;2752;91662;1045780;631379
2021-04-09;ABR;8994;4264;4730;6243;2603;148;0;ITF;ITF1;13;Abruzzo;42.35122196;13.39843823;585;71;656;9631;10287;-110;277;54656;2212;67155;1286718;587769
2021-04-09;BAS;1152;350;802;1062;63;27;0;ITF;ITF5;17;Basilicata;40.63947052;15.80514834;169;10;179;4844;5023;37;204;15062;479;20564;304894;172967
2021-04-09;MOL;2369;1272;1097;2118;192;59;0;ITF;ITF2;14;Molise;41.55774754;14.65916051;53;16;69;634;703;-55;0;11302;447;12452;187296;168991
2021-04-09;PAB;2944;1304;1640;1948;730;266;0;ITH;ITH1;4;Provincia Autonoma Bolzano / Bozen;46.49933453;11.35662422;83;17;100;484;584;-16;48;67742;1141;69467;1162996;366272
2021-04-09;UMB;6751;3130;3621;6412;216;123;0;ITI;ITI2;10;Umbria;43.10675841;12.38824698;312;48;360;4118;4478;32;70;45901;1273;51652;1007997;341245
2021-04-09;EMR;25804;11695;14109;19527;5760;517;0;ITH;ITH5;8;Emilia-Romagna;44.49436681;11.341720800000001;2917;343;3260;64958;68218;-637;1488;267780;12307;348305;5071297;1707662
2021-04-09;CAL;8051;3778;4273;5063;2896;92;0;ITF;ITF6;18;Calabria;38.90597598;16.59440194;465;39;504;11543;12047;258;512;37674;890;50611;695764;652367
2021-04-09;VDA;238;111;127;201;33;4;0;ITC;ITC2;2;Valle d'Aosta / Vallée d'Aoste;45.73750286;7.320149366;59;13;72;1101;1173;-24;61;8212;431;9816;100485;53728
2021-04-09;FVG;8075;3746;4329;6587;1311;177;0;ITH;ITH4;6;Friuli-Venezia Giulia;45.6494354;13.76813649;529;77;606;11125;11731;-509;336;85596;3482;100809;1694663;601866
2021-04-10;PAB;5417;2673;2744;4659;590;168;0;ITH;ITH1;4;Provincia Autonoma Bolzano / Bozen;46.49933453;11.35662422;85;17;102;426;528;-56;35;67827;1146;69501;1165531;366764
2021-04-10;MOL;2686;1279;1407;2467;154;65;0;ITF;ITF2;14;Molise;41.55774754;14.65916051;55;15;70;603;673;-30;4;11333;450;12456;187615;169289
2021-04-10;ABR;8778;4059;4719;6121;2510;147;0;ITF;ITF1;13;Abruzzo;42.35122196;13.39843823;571;68;639;9564;10203;-84;351;55076;2227;67506;1293696;589518
2021-04-10;VDA;405;191;214;389;5;11;0;ITC;ITC2;2;Valle d'Aosta / Vallée d'Aoste;45.73750286;7.320149366;59;12;71;1041;1112;-61;54;8324;434;9870;101443;53998
2021-04-10;CAL;11751;5317;6434;6831;4875;45;0;ITF;ITF6;18;Calabria;38.90597598;16.59440194;472;38;510;11899;12409;362;477;37782;897;51088;699381;655464
2021-04-10;MAR;10930;4625;6305;10368;314;248;0;ITI;ITI3;11;Marche;43.61675973;13.5188753;725;132;857;7321;8178;-81;414;81138;2760;92076;1050533;633829
2021-04-10;PAT;2879;1352;1527;1996;804;79;0;ITH;ITH2;4;Provincia Autonoma Trento;46.06893511;11.12123097;157;46;203;1846;2049;-228;164;38758;1307;42114;719223;186387
2021-04-10;FVG;5062;2218;2844;3752;1231;79;0;ITH;ITH4;6;Friuli-Venezia Giulia;45.6494354;13.76813649;516;75;591;10831;11422;-309;392;86285;3494;101201;1703020;604171
2021-04-10;VEN;27487;11990;15497;18376;8476;635;0;ITH;ITH3;5;Veneto;45.43490485;12.33845213;1629;296;1925;30610;32535;-383;1054;350888;10913;394336;6514430;1598679
2021-04-10;PIE;30224;13436;16788;25293;4270;661;0;ITC;ITC1;1;Piemonte;45.0732745;7.680687483;3633;324;3957;24716;28673;-1010;1267;285884;10647;325204;3552752;1579645
2021-04-10;UMB;7407;3483;3924;7187;86;134;0;ITI;ITI2;10;Umbria;43.10675841;12.38824698;315;42;357;4102;4459;-19;132;46046;1279;51784;1017522;342091
2021-04-10;SIC;20450;9979;10471;11300;8973;177;0;ITG;ITG1;19;Sicilia;38.11569725;13.362356699999998;1152;164;1316;20875;22191;439;1229;158147;5029;185367;3361396;1324261
2021-04-10;LIG;7896;3565;4331;6907;914;75;0;ITC;ITC3;7;Liguria;44.41149315;8.9326992;655;76;731;7071;7802;187;410;81824;3971;93597;1305215;542363
2021-04-10;PUG;30972;13137;17835;26116;4466;390;0;ITF;ITF4;16;Puglia;41.12559576;16.86736689;1978;252;2230;49328;51558;511;1804;152439;5174;209171;1991105;1052175
2021-04-10;TOS;11715;5345;6370;10735;742;238;0;ITI;ITI1;9;Toscana;43.76923077;11.25588885;1688;286;1974;25938;27912;-248;1177;174442;5632;207986;3668323;1854538
2021-04-10;EMR;20939;9305;11634;16457;4148;334;0;ITH;ITH5;8;Emilia-Romagna;44.49436681;11.341720800000001;2805;334;3139;64293;67432;-786;1525;270050;12340;349822;5099822;1711090
2021-04-10;BAS;1037;381;656;924;84;29;0;ITF;ITF5;17;Basilicata;40.63947052;15.80514834;172;10;182;4821;5003;-20;171;15250;482;20735;306553;173671
2021-04-10;LAZ;23965;10431;13534;16473;7213;279;0;ITI;ITI4;12;Lazio;41.89277044;12.48366722;3118;386;3504;48885;52389;448;1463;240640;7014;300043;5481593;3592066
2021-04-10;SAR;10605;4787;5818;8533;1964;108;0;ITG;ITG2;20;Sardegna;39.21531192;9.110616306;323;55;378;16416;16794;345;425;30685;1261;48740;1063256;630980
2021-04-10;CAM;28368;13502;14866;22755;4917;696;0;ITF;ITF3;15;Campania;40.83956555;14.25084984;1555;141;1696;89682;91378;140;2069;258061;5747;355186;3810352;2561337
2021-04-10;LOM;52861;21889;30972;40122;11987;752;0;ITC;ITC4;3;Lombardia;45.46679409;9.190347404;6059;824;6883;72155;79038;-2541;2974;653897;31676;764611;8624027;3599216
2021-04-11;CAM;17529;8610;8919;15020;2089;420;0;ITF;ITF3;15;Campania;40.83956555;14.25084984;1569;145;1714;89937;91651;273;1854;259615;5774;357040;3836168;2569773
2021-04-11;SAR;5417;2451;2966;4264;1124;29;0;ITG;ITG2;20;Sardegna;39.21531192;9.110616306;335;56;391;16690;17081;287;369;30763;1265;49109;1067676;634683
2021-04-11;SIC;15378;7595;7783;8225;7040;113;0;ITG;ITG1;19;Sicilia;38.11569725;13.362356699999998;1148;171;1319;21652;22971;780;1120;158478;5038;186487;3377937;1331451
2021-04-11;FVG;3435;1519;1916;2412;907;116;0;ITH;ITH4;6;Friuli-Venezia Giulia;45.6494354;13.76813649;519;75;594;10517;11111;-311;208;86792;3506;101409;1707929;605718
2021-04-11;EMR;15286;6940;8346;11984;3049;253;0;ITH;ITH5;8;Emilia-Romagna;44.49436681;11.341720800000001;2711;330;3041;63584;66625;-807;1170;271983;12380;350988;5117442;1714208
2021-04-11;PIE;20868;9332;11536;18242;2152;474;0;ITC;ITC1;1;Piemonte;45.0732745;7.680687483;3606;320;3926;24446;28372;-301;1372;287544;10660;326576;3568586;1585155
2021-04-11;CAL;4214;1916;2298;2243;1954;17;0;ITF;ITF6;18;Calabria;38.90597598;16.59440194;473;38;511;12045;12556;147;593;38222;903;51681;702593;658059
2021-04-11;LAZ;19250;8538;10712;13122;5938;190;0;ITI;ITI4;12;Lazio;41.89277044;12.48366722;3067;393;3460;48600;52060;-329;1675;242625;7033;301718;5514054;3611710
2021-04-11;UMB;3101;1506;1595;3035;49;17;0;ITI;ITI2;10;Umbria;43.10675841;12.38824698;294;44;338;3996;4334;-125;172;46336;1286;51956;1025924;343140
2021-04-11;VEN;21018;8881;12137;14229;6300;489;0;ITH;ITH3;5;Veneto;45.43490485;12.33845213;1542;289;1831;29976;31807;-728;871;352459;10941;395207;6540152;1602058
2021-04-11;LOM;32244;13951;18293;24330;7398;516;0;ITC;ITC4;3;Lombardia;45.46679409;9.190347404;5896;814;6710;72770;79480;442;2302;655680;31753;766913;8665330;3608226
2021-04-11;LIG;4251;1930;2321;3958;249;44;0;ITC;ITC3;7;Liguria;44.41149315;8.9326992;657;80;737;7039;7776;-26;335;82153;4003;93932;1311149;544428
2021-04-11;TOS;3641;1680;1961;3331;155;155;0;ITI;ITI1;9;Toscana;43.76923077;11.25588885;1668;284;1952;25806;27758;-154;1222;175788;5662;209208;3690837;1862640
2021-04-11;PAT;2393;1161;1232;2201;99;93;0;ITH;ITH2;4;Provincia Autonoma Trento;46.06893511;11.12123097;146;43;189;1717;1906;-143;107;39006;1309;42221;721707;186579
2021-04-11;MOL;1222;603;619;1179;14;29;0;ITF;ITF2;14;Molise;41.55774754;14.65916051;54;14;68;567;635;-38;24;11391;454;12480;188375;170000
2021-04-11;BAS;966;393;573;760;176;30;0;ITF;ITF5;17;Basilicata;40.63947052;15.80514834;179;12;191;4952;5143;140;249;15357;484;20984;308117;174414
2021-04-11;MAR;7117;3116;4001;6681;287;149;0;ITI;ITI3;11;Marche;43.61675973;13.5188753;728;129;857;7348;8205;27;406;81506;2771;92482;1054971;636245
2021-04-11;ABR;5380;2628;2752;4834;487;59;0;ITF;ITF1;13;Abruzzo;42.35122196;13.39843823;557;67;624;9602;10226;23;238;55277;2240;67743;1299635;590962
2021-04-11;VDA;481;208;273;464;0;17;0;ITC;ITC2;2;Valle d'Aosta / Vallée d'Aoste;45.73750286;7.320149366;66;12;78;1049;1127;15;65;8372;436;9935;102171;54238
2021-04-11;PUG;16494;7270;9224;14657;1650;187;0;ITF;ITF4;16;Puglia;41.12559576;16.86736689;1989;260;2249;49798;52047;489;1359;153294;5189;210530;2001590;1056069
2021-04-11;PAB;2735;1302;1433;2459;178;98;0;ITH;ITH1;4;Provincia Autonoma Bolzano / Bozen;46.49933453;11.35662422;80;15;95;479;574;46;146;67923;1148;69645;1181646;368802
2021-04-12;PUG;29512;13880;15632;26166;3029;317;0;ITF;ITF4;16;Puglia;41.12559576;16.86736689;1983;265;2248;49328;51576;-471;815;154541;5228;211345;2007810;1058928
2021-04-12;MAR;8573;3774;4799;7931;482;160;0;ITI;ITI3;11;Marche;43.61675973;13.5188753;733;129;862;7193;8055;-150;111;81757;2781;92593;1056368;637200
2021-04-12;MOL;1311;563;748;1041;252;18;0;ITF;ITF2;14;Molise;41.55774754;14.65916051;54;13;67;577;644;9;43;11424;455;12523;189001;170597
2021-04-12;VDA;489;188;301;306;165;18;0;ITC;ITC2;2;Valle d'Aosta / Vallée d'Aoste;45.73750286;7.320149366;65;12;77;1065;1142;15;78;8435;436;10013;102897;54461
2021-04-12;PAB;2110;948;1162;2030;6;74;0;ITH;ITH1;4;Provincia Autonoma Bolzano / Bozen;46.49933453;11.35662422;74;17;91;488;579;5;124;68037;1149;69765;1193345;370361
2021-04-12;PIE;22988;10377;12611;19464;2998;526;0;ITC;ITC1;1;Piemonte;45.0732745;7.680687483;3633;317;3950;23711;27661;-711;636;288861;10690;327212;3582169;1588176
2021-04-12;TOS;2631;1195;1436;1806;656;169;0;ITI;ITI1;9;Toscana;43.76923077;11.25588885;1698;286;1984;25647;27631;-127;715;176600;5692;209923;3701591;1866642
2021-04-12;BAS;2175;1054;1121;1651;494;30;0;ITF;ITF5;17;Basilicata;40.63947052;15.80514834;177;13;190;4970;5160;17;75;15410;489;21059;308657;174637
2021-04-12;CAL;7053;3430;3623;5355;1669;29;0;ITF;ITF6;18;Calabria;38.90597598;16.59440194;471;40;511;12059;12570;14;226;38431;906;51907;704480;659556
2021-04-12;UMB;7093;3081;4012;5316;1717;60;0;ITI;ITI2;10;Umbria;43.10675841;12.38824698;286;43;329;3941;4270;-64;201;46597;1290;52157;1032115;343894
2021-04-12;ABR;6239;2957;3282;4983;1173;83;0;ITF;ITF1;13;Abruzzo;42.35122196;13.39843823;557;65;622;9838;10460;234;259;55299;2243;68002;1305527;592449
2021-04-12;PAT;3158;1455;1703;2526;505;127;0;ITH;ITH2;4;Provincia Autonoma Trento;46.06893511;11.12123097;138;43;181;1559;1740;-166;107;39277;1311;42328;724635;186871
2021-04-12;VEN;14920;6346;8574;6399;8219;302;0;ITH;ITH3;5;Veneto;45.43490485;12.33845213;1568;286;1854;29833;31687;-120;587;353155;10952;395794;6551899;1604596
2021-04-12;LIG;12397;5481;6916;10277;2024;96;0;ITC;ITC3;7;Liguria;44.41149315;8.9326992;662;84;746;6987;7733;-43;306;82495;4010;94238;1316897;546566
2021-04-12;CAM;23312;10922;12390;19726;3038;548;0;ITF;ITF3;15;Campania;40.83956555;14.25084984;1594;136;1730;89436;91166;-485;1386;261443;5817;358426;3850249;2576365
2021-04-12;FVG;7292;3198;4094;5996;1138;158;0;ITH;ITH4;6;Friuli-Venezia Giulia;45.6494354;13.76813649;523;81;604;10383;10987;-124;82;86987;3517;101491;1709534;606187
2021-04-12;LAZ;23961;10806;13155;16656;6974;331;0;ITI;ITI4;12;Lazio;41.89277044;12.48366722;3050;396;3446;48622;52068;8;1057;243637;7070;302775;5528991;3619055
2021-04-12;SAR;7064;3206;3858;5258;1728;78;0;ITG;ITG2;20;Sardegna;39.21531192;9.110616306;341;55;396;16842;17238;157;307;30901;1277;49416;1099640;637267
2021-04-12;SIC;19023;9220;9803;11486;7277;260;0;ITG;ITG1;19;Sicilia;38.11569725;13.362356699999998;1191;174;1365;22344;23709;738;1110;158830;5058;187597;3415995;1339180
2021-04-12;LOM;47378;20634;26744;32295;14432;651;0;ITC;ITC4;3;Lombardia;45.46679409;9.190347404;5763;811;6574;66113;72687;-6793;997;663408;31815;767910;8684352;3612893
2021-04-12;EMR;19262;9017;10245;14453;4450;359;0;ITH;ITH5;8;Emilia-Romagna;44.49436681;11.341720800000001;2756;332;3088;63345;66433;-192;1151;273287;12411;352131;5130341;1716038
2021-04-13;VDA;373;171;202;312;44;17;0;ITC;ITC2;2;Valle d'Aosta / Vallée d'Aoste;45.73750286;7.320149366;64;12;76;1034;1110;-32;42;8509;436;10055;103485;54635
2021-04-13;BAS;2120;1054;1066;1278;823;19;0;ITF;ITF5;17;Basilicata;40.63947052;15.80514834;169;12;181;5076;5257;97;182;15492;492;21241;310219;175334
2021-04-13;CAL;6980;3429;3551;5615;1337;28;0;ITF;ITF6;18;Calabria;38.90597598;16.59440194;471;43;514;12393;12907;337;577;38667;910;52484;708566;663250
2021-04-13;LAZ;25853;11986;13867;17633;7757;463;0;ITI;ITI4;12;Lazio;41.89277044;12.48366722;3064;392;3456;48716;52172;104;1164;244661;7106;303939;5563688;3636734
2021-04-13;PAT;2618;1090;1528;2025;509;84;0;ITH;ITH2;4;Provincia Autonoma Trento;46.06893511;11.12123097;146;41;187;1466;1653;-87;93;39457;1311;42421;726842;187102
2021-04-13;FVG;7407;3300;4107;5665;1613;129;0;ITH;ITH4;6;Friuli-Venezia Giulia;45.6494354;13.76813649;493;75;568;9961;10529;-458;371;87799;3534;101862;1720725;609751
2021-04-13;PIE;26797;12048;14749;22632;3465;700;0;ITC;ITC1;1;Piemonte;45.0732745;7.680687483;3526;316;3842;22547;26389;-1272;1057;291115;10765;328269;3604839;1595062
2021-04-13;MAR;9838;4261;5577;9393;234;211;0;ITI;ITI3;11;Marche;43.61675973;13.5188753;713;127;840;7110;7950;-105;222;82073;2792;92815;1060551;639222
2021-04-13;EMR;23726;11132;12594;19029;4345;352;0;ITH;ITH5;8;Emilia-Romagna;44.49436681;11.341720800000001;2654;331;2985;61968;64953;-1480;785;275503;12452;352908;5156399;1718783
2021-04-13;UMB;7683;3402;4281;5924;1669;90;0;ITI;ITI2;10;Umbria;43.10675841;12.38824698;285;43;328;3779;4107;-163;152;46908;1294;52309;1038233;344655
2021-04-13;VEN;14043;6331;7712;8053;5483;507;0;ITH;ITH3;5;Veneto;45.43490485;12.33845213;1534;269;1803;28756;30559;-1128;883;355124;10994;396677;6587690;1608301
2021-04-13;TOS;8504;3512;4992;5739;2482;283;0;ITI;ITI1;9;Toscana;43.76923077;11.25588885;1664;283;1947;25467;27414;-217;934;177717;5726;210857;3725470;1874315
2021-04-13;SAR;7709;3624;4085;5787;1855;67;0;ITG;ITG2;20;Sardegna;39.21531192;9.110616306;340;56;396;16970;17366;128;327;31092;1285;49743;1103765;640720
2021-04-13;SIC;20269;9874;10395;11225;8843;201;0;ITG;ITG1;19;Sicilia;38.11569725;13.362356699999998;1214;176;1390;23281;24671;962;1384;159242;5068;188981;3443613;1349978
2021-04-13;CAM;26618;12690;13928;20522;5539;557;0;ITF;ITF3;15;Campania;40.83956555;14.25084984;1592;133;1725;89213;90938;-228;1627;263291;5824;360053;3871702;2585972
2021-04-13;LOM;47707;21292;26415;32930;14118;659;0;ITC;ITC4;3;Lombardia;45.46679409;9.190347404;5727;787;6514;64827;71341;-1346;1975;666635;31909;769885;8722842;3618520
2021-04-13;PUG;28806;13663;15143;24947;3545;314;0;ITF;ITF4;16;Puglia;41.12559576;16.86736689;1966;262;2228;49406;51634;58;1191;155620;5282;212536;2020917;1061575
2021-04-13;LIG;13090;5875;7215;10948;2030;112;0;ITC;ITC3;7;Liguria;44.41149315;8.9326992;658;87;745;6720;7465;-268;231;82986;4018;94469;1324219;548841
2021-04-13;MOL;1646;722;924;1043;589;14;0;ITF;ITF2;14;Molise;41.55774754;14.65916051;53;14;67;606;673;29;54;11449;455;12577;189583;171150
2021-04-13;ABR;5894;2756;3138;4557;1238;99;0;ITF;ITF1;13;Abruzzo;42.35122196;13.39843823;569;64;633;9777;10410;-50;90;55433;2248;68091;1308428;593163
2021-04-13;PAB;2400;1134;1266;2307;7;86;0;ITH;ITH1;4;Provincia Autonoma Bolzano / Bozen;46.49933453;11.35662422;72;17;89;462;551;-28;110;68164;1149;69864;1204583;371972
2021-04-14;LIG;13085;5675;7410;10750;2211;124;0;ITC;ITC3;7;Liguria;44.41149315;8.9326992;633;84;717;6477;7194;-271;410;83653;4032;94879;1332679;551608
2021-04-14;LOM;47245;21052;26193;33540;12991;714;0;ITC;ITC4;3;Lombardia;45.46679409;9.190347404;5589;781;6370;63694;70064;-1277;2153;669980;31994;772038;8773329;3627106
2021-04-14;VEN;15949;6918;9031;8773;6635;541;0;ITH;ITH3;5;Veneto;45.43490485;12.33845213;1461;260;1721;27721;29442;-1117;1081;357298;11018;397758;6628164;1612704
2021-04-14;PAT;3146;1480;1666;2253;738;155;0;ITH;ITH2;4;Provincia Autonoma Trento;46.06893511;11.12123097;151;42;193;1370;1563;-90;24;39571;1311;42445;727376;187189
2021-04-14;PUG;32102;15142;16960;28483;3311;308;0;ITF;ITF4;16;Puglia;41.12559576;16.86736689;1935;270;2205;49584;51789;155;1488;156914;5321;214024;2034564;1063934
2021-04-14;TOS;20207;8351;11856;14529;5129;549;0;ITI;ITI1;9;Toscana;43.76923077;11.25588885;1664;282;1946;25131;27077;-337;1168;179190;5758;212025;3751125;1882641
2021-04-14;MOL;1827;775;1052;1139;669;19;0;ITF;ITF2;14;Molise;41.55774754;14.65916051;49;15;64;587;651;-22;38;11508;456;12615;190280;171801
2021-04-14;PAB;3606;1652;1954;3235;96;275;0;ITH;ITH1;4;Provincia Autonoma Bolzano / Bozen;46.49933453;11.35662422;76;16;92;391;483;-68;87;68311;1150;69944;1215025;373547
2021-04-14;VDA;942;430;512;692;224;26;0;ITC;ITC2;2;Valle d'Aosta / Vallée d'Aoste;45.73750286;7.320149366;64;11;75;1054;1129;19;32;8522;436;10087;103671;54696
2021-04-14;MAR;10221;4567;5654;9652;369;200;0;ITI;ITI3;11;Marche;43.61675973;13.5188753;671;116;787;7069;7856;-94;415;82576;2798;93230;1065926;641913
2021-04-14;BAS;2047;1002;1045;1354;677;16;0;ITF;ITF5;17;Basilicata;40.63947052;15.80514834;169;12;181;5221;5402;145;211;15556;494;21452;311739;176048
2021-04-14;ABR;6599;2952;3647;4341;2123;135;0;ITF;ITF1;13;Abruzzo;42.35122196;13.39843823;553;59;612;9649;10261;-149;174;55735;2269;68265;1313653;594749
2021-04-14;CAM;27669;13340;14329;18611;8592;466;0;ITF;ITF3;15;Campania;40.83956555;14.25084984;1585;127;1712;89796;91508;570;2212;264906;5851;362265;3896640;2601395
2021-04-14;SAR;8370;3929;4441;7030;1276;64;0;ITG;ITG2;20;Sardegna;39.21531192;9.110616306;350;57;407;17273;17680;314;502;31272;1293;50245;1109115;645210
2021-04-14;CAL;8100;3912;4188;6588;1462;50;0;ITF;ITF6;18;Calabria;38.90597598;16.59440194;476;44;520;12504;13024;117;540;39084;916;53024;712351;666676
2021-04-14;FVG;7257;3136;4121;5410;1721;126;0;ITH;ITH4;6;Friuli-Venezia Giulia;45.6494354;13.76813649;471;72;543;9783;10326;-203;226;88216;3546;102088;1727870;611041
2021-04-14;PIE;28403;12856;15547;23076;4588;739;0;ITC;ITC1;1;Piemonte;45.0732745;7.680687483;3430;311;3741;21517;25258;-1131;1439;293615;10835;329708;3626825;1602089
2021-04-14;EMR;27065;12853;14212;20524;6113;428;0;ITH;ITH5;8;Emilia-Romagna;44.49436681;11.341720800000001;2590;317;2907;62210;65117;164;859;276162;12482;353761;5183846;1722577
2021-04-14;SIC;20583;9939;10644;11611;8775;197;0;ITG;ITG1;19;Sicilia;38.11569725;13.362356699999998;1230;185;1415;22717;24132;-539;1542;161290;5101;190523;3473116;1361557
2021-04-14;UMB;8159;3682;4477;6100;1980;79;0;ITI;ITI2;10;Umbria;43.10675841;12.38824698;272;41;313;3717;4030;-77;135;47118;1296;52444;1044275;345248
2021-04-14;LAZ;29412;13331;16081;18830;10225;357;0;ITI;ITI4;12;Lazio;41.89277044;12.48366722;2977;398;3375;47857;51232;-940;1230;246782;7155;305169;5602655;3656965
2021-04-15;VDA;814;378;436;643;140;31;0;ITC;ITC2;2;Valle d'Aosta / Vallée d'Aoste;45.73750286;7.320149366;68;12;80;1040;1120;-9;48;8579;436;10135;104333;54917
2021-04-15;BAS;3431;1679;1752;2586;799;46;0;ITF;ITF5;17;Basilicata;40.63947052;15.80514834;167;13;180;5360;5540;138;217;15633;496;21669;313367;176838
2021-04-15;ABR;7833;3688;4145;5825;1843;165;0;ITF;ITF1;13;Abruzzo;42.35122196;13.39843823;557;58;615;9651;10266;5;264;55968;2293;68527;1322258;596628
2021-04-15;CAL;7810;3822;3988;6004;1757;49;0;ITF;ITF6;18;Calabria;38.90597598;16.59440194;474;48;522;12813;13335;311;560;39328;921;53584;715966;669773
2021-04-15;EMR;29373;13987;15386;19243;9685;445;0;ITH;ITH5;8;Emilia-Romagna;44.49436681;11.341720800000001;2464;312;2776;62490;65266;149;1150;277120;12515;354901;5209542;1725567
2021-04-15;UMB;7665;3505;4160;5702;1889;74;0;ITI;ITI2;10;Umbria;43.10675841;12.38824698;276;41;317;3585;3902;-128;40;47284;1298;52484;1045331;345412
2021-04-15;SAR;11963;5578;6385;6817;5022;124;0;ITG;ITG2;20;Sardegna;39.21531192;9.110616306;350;54;404;17238;17642;-38;279;31580;1302;50524;1113378;648782
2021-04-15;SIC;21591;10496;11095;11994;9358;239;0;ITG;ITG1;19;Sicilia;38.11569725;13.362356699999998;1218;184;1402;23372;24774;642;1450;162092;5107;191973;3503543;1371728
2021-04-15;LIG;11857;5243;6614;9892;1859;106;0;ITC;ITC3;7;Liguria;44.41149315;8.9326992;616;84;700;6247;6947;-247;407;84293;4046;95286;1340921;554323
2021-04-15;LAZ;32075;14363;17712;20623;10942;510;0;ITI;ITI4;12;Lazio;41.89277044;12.48366722;2933;387;3320;47311;50631;-601;1330;248667;7201;306499;5636530;3676004
2021-04-15;PAB;4411;2315;2096;3924;267;220;0;ITH;ITH1;4;Provincia Autonoma Bolzano / Bozen;46.49933453;11.35662422;76;15;91;367;458;-25;74;68405;1150;70013;1219926;374460
2021-04-15;PIE;29679;13603;16076;23424;5558;697;0;ITC;ITC1;1;Piemonte;45.0732745;7.680687483;3312;311;3623;20718;24341;-917;1264;295770;10861;330972;3648404;1608390
2021-04-15;LOM;49497;21877;27620;34896;13841;760;0;ITC;ITC4;3;Lombardia;45.46679409;9.190347404;5387;739;6126;61792;67918;-2146;2722;674783;32059;774760;8825622;3636819
2021-04-15;PAT;3234;1459;1775;2830;156;248;0;ITH;ITH2;4;Provincia Autonoma Trento;46.06893511;11.12123097;147;37;184;1329;1513;-50;119;39737;1314;42564;729624;187466
2021-04-15;FVG;6530;2888;3642;5092;1277;161;0;ITH;ITH4;6;Friuli-Venezia Giulia;45.6494354;13.76813649;445;65;510;9735;10245;-81;267;88552;3558;102355;1734054;612343
2021-04-15;PUG;32810;15311;17499;28621;3788;401;0;ITF;ITF4;16;Puglia;41.12559576;16.86736689;1892;277;2169;49557;51726;-63;1867;158805;5360;215891;2047926;1067950
2021-04-15;CAM;34356;16667;17689;23753;9909;694;0;ITF;ITF3;15;Campania;40.83956555;14.25084984;1557;136;1693;89831;91524;16;2224;267074;5891;364489;3922611;2617686
2021-04-15;MAR;10379;4675;5704;9572;563;244;0;ITI;ITI3;11;Marche;43.61675973;13.5188753;638;112;750;6986;7736;-120;326;83003;2817;93556;1070698;644284
2021-04-15;TOS;24511;10243;14268;15360;8620;531;0;ITI;ITI1;9;Toscana;43.76923077;11.25588885;1633;286;1919;24867;26786;-291;1206;180661;5784;213231;3776227;1891751
2021-04-15;VEN;20948;8658;12290;9369;10833;746;0;ITH;ITH3;5;Veneto;45.43490485;12.33845213;1396;244;1640;26692;28332;-1110;1085;359470;11041;398843;6663524;1617052
2021-04-15;MOL;1961;808;1153;1101;851;9;0;ITF;ITF2;14;Molise;41.55774754;14.65916051;47;16;63;573;636;-15;28;11551;456;12643;190611;172126
2021-04-16;CAL;10360;5059;5301;8653;1646;61;0;ITF;ITF6;18;Calabria;38.90597598;16.59440194;474;45;519;13005;13524;189;433;39567;926;54017;719375;672656
2021-04-16;EMR;29243;13766;15477;20013;8843;387;0;ITH;ITH5;8;Emilia-Romagna;44.49436681;11.341720800000001;2365;313;2678;61442;64120;-1146;1275;279482;12557;356159;5234352;1728672
2021-04-16;LAZ;34601;15779;18822;21909;12250;442;0;ITI;ITI4;12;Lazio;41.89277044;12.48366722;2859;382;3241;47772;51013;382;1474;249720;7240;307973;5674208;3694828
2021-04-16;SAR;14612;6532;8080;9004;5426;182;0;ITG;ITG2;20;Sardegna;39.21531192;9.110616306;359;57;416;17325;17741;99;348;31824;1307;50872;1117735;652441
2021-04-16;TOS;29010;12903;16107;21440;6936;634;0;ITI;ITI1;9;Toscana;43.76923077;11.25588885;1557;278;1835;24721;26556;-230;1239;182110;5804;214470;3800976;1900629
2021-04-16;CAM;34455;16639;17816;23039;10670;746;0;ITF;ITF3;15;Campania;40.83956555;14.25084984;1507;131;1638;90329;91967;443;1994;268594;5922;366483;3947652;2634224
2021-04-16;LOM;53740;23939;29801;38420;14401;919;0;ITC;ITC4;3;Lombardia;45.46679409;9.190347404;5131;728;5859;61536;67395;-523;2431;677650;32146;777191;8872725;3645332
2021-04-16;UMB;8102;3745;4357;6085;1838;179;0;ITI;ITI2;10;Umbria;43.10675841;12.38824698;279;41;320;3536;3856;-46;109;47436;1301;52593;1052934;346247
2021-04-16;FVG;7054;3076;3978;4958;1960;136;0;ITH;ITH4;6;Friuli-Venezia Giulia;45.6494354;13.76813649;416;59;475;9410;9885;-360;392;89283;3579;102747;1746527;616339
2021-04-16;PIE;28492;13241;15251;22694;5019;779;0;ITC;ITC1;1;Piemonte;45.0732745;7.680687483;3193;292;3485;19887;23372;-969;1200;297901;10899;332172;3674948;1614832
2021-04-16;VEN;24475;10507;13968;11896;11895;684;0;ITH;ITH3;5;Veneto;45.43490485;12.33845213;1323;237;1560;25919;27479;-853;906;361206;11064;399749;6699224;1621094
2021-04-16;MAR;10086;4704;5382;9348;526;212;0;ITI;ITI3;11;Marche;43.61675973;13.5188753;610;108;718;6979;7697;-39;326;83355;2830;93882;1075551;647003
2021-04-16;SIC;28869;14503;14366;20239;8302;328;0;ITG;ITG1;19;Sicilia;38.11569725;13.362356699999998;1210;189;1399;23476;24875;101;1370;163340;5128;193343;3536843;1382044
2021-04-16;LIG;12026;5301;6725;10038;1833;155;0;ITC;ITC3;7;Liguria;44.41149315;8.9326992;595;83;678;6321;6999;52;323;84557;4053;95609;1348049;556738
2021-04-16;PUG;36176;17002;19174;32453;3294;429;0;ITF;ITF4;16;Puglia;41.12559576;16.86736689;1895;283;2178;49416;51594;-132;1537;160424;5410;217428;2061325;1071879
2021-04-16;MOL;2467;1050;1417;1191;1238;38;0;ITF;ITF2;14;Molise;41.55774754;14.65916051;46;15;61;551;612;-24;0;11572;459;12643;190818;172331
2021-04-16;ABR;7545;3492;4053;5497;1917;131;0;ITF;ITF1;13;Abruzzo;42.35122196;13.39843823;537;56;593;9639;10232;-34;215;56211;2298;68741;1329256;598191
2021-04-16;PAB;2959;1425;1534;2285;512;162;0;ITH;ITH1;4;Provincia Autonoma Bolzano / Bozen;46.49933453;11.35662422;79;14;93;323;416;-42;14;68461;1150;70027;1221111;374751
2021-04-16;VDA;600;261;339;566;2;32;0;ITC;ITC2;2;Valle d'Aosta / Vallée d'Aoste;45.73750286;7.320149366;66;12;78;1064;1142;22;60;8617;436;10195;105020;55066
2021-04-16;BAS;3326;1636;1690;2399;902;25;0;ITF;ITF5;17;Basilicata;40.63947052;15.80514834;171;15;186;5456;5642;102;176;15707;496;21845;315196;177878
2021-04-16;PAT;2907;1378;1529;2598;150;159;0;ITH;ITH2;4;Provincia Autonoma Trento;46.06893511;11.12123097;135;37;172;1309;1481;-32;133;39901;1315;42697;732074;187766
2021-04-17;MOL;3105;1529;1576;1555;1505;45;0;ITF;ITF2;14;Molise;41.55774754;14.65916051;44;17;61;557;618;6;45;11610;460;12688;191486;172960
2021-04-17;PAB;5255;2609;2646;4966;44;245;0;ITH;ITH1;4;Provincia Autonoma Bolzano / Bozen;46.49933453;11.35662422;74;13;87;226;313;-103;87;68649;1152;70114;1233924;376233
2021-04-17;PUG;40114;19010;21104;36089;3594;431;0;ITF;ITF4;16;Puglia;41.12559576;16.86736689;1906;285;2191;49324;51515;-79;1525;162017;5421;218953;2074260;1075154
2021-04-17;BAS;3462;1656;1806;2171;1262;29;0;ITF;ITF5;17;Basilicata;40.63947052;15.80514834;166;14;180;5555;5735;93;216;15829;497;22061;317007;178770
2021-04-17;VDA;638;407;231;596;2;40;0;ITC;ITC2;2;Valle d'Aosta / Vallée d'Aoste;45.73750286;7.320149366;61;12;73;1019;1092;-50;74;8740;437;10269;105816;55274
2021-04-17;SIC;26010;13154;12856;18660;7068;282;0;ITG;ITG1;19;Sicilia;38.11569725;13.362356699999998;1216;189;1405;24072;25477;602;1301;164015;5152;194644;3565770;1392635
2021-04-17;SAR;10189;4530;5659;5421;4677;91;0;ITG;ITG2;20;Sardegna;39.21531192;9.110616306;364;55;419;17425;17844;103;320;32035;1313;51192;1122148;656141
2021-04-17;LAZ;32509;14260;18249;19969;12074;466;0;ITI;ITI4;12;Lazio;41.89277044;12.48366722;2771;385;3156;47672;50828;-185;1378;251258;7265;309351;5707970;3713214
2021-04-17;FVG;7469;3240;4229;5818;1484;167;0;ITH;ITH4;6;Friuli-Venezia Giulia;45.6494354;13.76813649;396;57;453;9279;9732;-153;155;89582;3588;102902;1756269;619448
2021-04-17;UMB;6697;3077;3620;5187;1343;167;0;ITI;ITI2;10;Umbria;43.10675841;12.38824698;262;38;300;3488;3788;-68;137;47636;1306;52730;1060362;346925
2021-04-17;PIE;30537;14180;16357;26494;3315;728;0;ITC;ITC1;1;Piemonte;45.0732745;7.680687483;3125;290;3415;18988;22403;-969;865;299710;10924;333037;3698404;1620549
2021-04-17;TOS;20587;9233;11354;17950;2147;490;0;ITI;ITI1;9;Toscana;43.76923077;11.25588885;1537;278;1815;24555;26370;-186;1150;183426;5824;215620;3827841;1909441
2021-04-17;PAT;2254;1149;1105;2091;57;106;0;ITH;ITH2;4;Provincia Autonoma Trento;46.06893511;11.12123097;127;34;161;1290;1451;-30;117;40045;1318;42814;734513;188042
2021-04-17;EMR;27324;13087;14237;17578;9353;393;0;ITH;ITH5;8;Emilia-Romagna;44.49436681;11.341720800000001;2292;299;2591;61100;63691;-429;1076;280953;12587;357231;5264768;1732478
2021-04-17;VEN;22452;9099;13353;14376;7278;798;0;ITH;ITH3;5;Veneto;45.43490485;12.33845213;1244;234;1478;25165;26643;-836;940;362958;11088;400689;6735186;1624951
2021-04-17;ABR;7359;3402;3957;4210;3052;97;0;ITF;ITF1;13;Abruzzo;42.35122196;13.39843823;525;57;582;9314;9896;-336;210;56737;2315;68948;1336196;599819
2021-04-17;CAM;36203;17517;18686;23921;11518;764;0;ITF;ITF3;15;Campania;40.83956555;14.25084984;1532;145;1677;90573;92250;283;2232;270531;5934;368715;3977332;2651849
2021-04-17;CAL;10871;5082;5789;9031;1788;52;0;ITF;ITF6;18;Calabria;38.90597598;16.59440194;453;50;503;13189;13692;168;472;39865;932;54489;723359;676066
2021-04-17;LIG;7393;3219;4174;6581;755;57;0;ITC;ITC3;7;Liguria;44.41149315;8.9326992;579;78;657;6312;6969;-30;321;84894;4067;95930;1355270;559033
2021-04-17;MAR;11706;5317;6389;10393;1073;240;0;ITI;ITI3;11;Marche;43.61675973;13.5188753;577;101;678;6951;7629;-68;341;83758;2836;94223;1080064;649487
2021-04-17;LOM;48593;21331;27262;36982;10883;728;0;ITC;ITC4;3;Lombardia;45.46679409;9.190347404;4901;723;5624;62177;67801;406;2546;679716;32220;779737;8922895;3654320
2021-04-18;UMB;1532;681;851;578;931;23;0;ITI;ITI2;10;Umbria;43.10675841;12.38824698;258;35;293;3354;3647;-141;116;47889;1310;52846;1067252;347675
2021-04-18;LAZ;23876;10611;13265;15851;7706;319;0;ITI;ITI4;12;Lazio;41.89277044;12.48366722;2705;372;3077;47713;50790;-38;1127;252398;7290;310478;5735637;3727894
2021-04-18;CAL;5884;2808;3076;4938;921;25;0;ITF;ITF6;18;Calabria;38.90597598;16.59440194;455;50;505;13563;14068;376;500;39983;938;54989;727064;679431
2021-04-18;TOS;8373;4098;4275;7060;1037;276;0;ITI;ITI1;9;Toscana;43.76923077;11.25588885;1531;270;1801;24270;26071;-299;958;184655;5852;216578;3848248;1916048
2021-04-18;SIC;19836;9918;9918;15280;4364;192;0;ITG;ITG1;19;Sicilia;38.11569725;13.362356699999998;1212;187;1399;24359;25758;281;875;164599;5162;195519;3582328;1400540
2021-04-18;EMR;17533;8408;9125;12367;4937;229;0;ITH;ITH5;8;Emilia-Romagna;44.49436681;11.341720800000001;2226;297;2523;61362;63885;194;1104;281836;12608;358329;5283140;1735513
2021-04-18;SAR;5156;2237;2919;2239;2887;30;0;ITG;ITG2;20;Sardegna;39.21531192;9.110616306;366;58;424;17642;18066;222;351;32162;1315;51543;1125925;659304
2021-04-18;VEN;17531;7262;10269;9505;7567;459;0;ITH;ITH3;5;Veneto;45.43490485;12.33845213;1211;236;1447;24997;26444;-199;761;363902;11104;401450;6756501;1628297
2021-04-18;MOL;1093;486;607;144;939;10;0;ITF;ITF2;14;Molise;41.55774754;14.65916051;48;16;64;568;632;14;59;11655;460;12747;192216;173665
2021-04-18;CAM;27223;13287;13936;17760;8904;559;0;ITF;ITF3;15;Campania;40.83956555;14.25084984;1529;146;1675;90746;92421;171;1700;272042;5952;370415;4001132;2666757
2021-04-18;LOM;36441;16242;20199;30525;5248;668;0;ITC;ITC4;3;Lombardia;45.46679409;9.190347404;4716;722;5438;60939;66377;-1424;1782;682858;32284;781519;8957094;3661560
2021-04-18;PAT;1865;850;1015;1795;9;61;0;ITH;ITH2;4;Provincia Autonoma Trento;46.06893511;11.12123097;119;33;152;1295;1447;-4;63;40108;1322;42877;736479;188188
2021-04-18;FVG;6065;2814;3251;5420;410;235;0;ITH;ITH4;6;Friuli-Venezia Giulia;45.6494354;13.76813649;377;57;434;9064;9498;-234;221;90024;3601;103123;1764319;621977
2021-04-18;PIE;22979;10821;12158;19636;2756;587;0;ITC;ITC1;1;Piemonte;45.0732745;7.680687483;3100;288;3388;19208;22596;193;751;300265;10927;333788;3709581;1623408
2021-04-18;LIG;2619;1165;1454;2094;470;55;0;ITC;ITC3;7;Liguria;44.41149315;8.9326992;586;76;662;6266;6928;-41;259;85189;4072;96189;1360354;560685
2021-04-18;MAR;8824;4131;4693;7728;921;175;0;ITI;ITI3;11;Marche;43.61675973;13.5188753;562;96;658;6918;7576;-53;277;84076;2848;94500;1083555;651264
2021-04-18;BAS;3720;1843;1877;2326;1370;24;0;ITF;ITF5;17;Basilicata;40.63947052;15.80514834;170;13;183;5616;5799;64;146;15911;497;22207;318425;179332
2021-04-18;ABR;5819;2728;3091;4725;944;150;0;ITF;ITF1;13;Abruzzo;42.35122196;13.39843823;515;54;569;9302;9871;-25;180;56926;2329;69126;1342593;601338
2021-04-18;PUG;22692;10859;11833;21431;1058;203;0;ITF;ITF4;16;Puglia;41.12559576;16.86736689;1888;286;2174;49264;51438;-77;1278;163355;5438;220231;2084461;1078462
2021-04-18;PAB;3116;1611;1505;2008;1011;97;0;ITH;ITH1;4;Provincia Autonoma Bolzano / Bozen;46.49933453;11.35662422;74;12;86;178;264;-49;53;68750;1153;70167;1244113;377497
2021-04-18;VDA;523;255;268;495;2;26;0;ITC;ITC2;2;Valle d'Aosta / Vallée d'Aoste;45.73750286;7.320149366;62;14;76;970;1046;-46;30;8816;437;10299;106220;55406
2021-04-19;MAR;9609;4503;5106;7896;1588;125;0;ITI;ITI3;11;Marche;43.61675973;13.5188753;568;88;656;6730;7386;-190;137;84392;2859;94637;1085463;652275
2021-04-19;PUG;27773;12904;14869;24379;3053;341;0;ITF;ITF4;16;Puglia;41.12559576;16.86736689;1897;260;2157;48269;50426;-1012;584;164905;5484;220815;2090591;1082105
2021-04-19;PAB;1876;860;1016;1604;182;90;0;ITH;ITH1;4;Provincia Autonoma Bolzano / Bozen;46.49933453;11.35662422;74;12;86;140;226;-38;39;68825;1155;70206;1253524;378721
2021-04-19;LIG;12842;5622;7220;8917;3836;89;0;ITC;ITC3;7;Liguria;44.41149315;8.9326992;598;75;673;6026;6699;-229;202;85613;4079;96391;1364564;562059
2021-04-19;MOL;1902;865;1037;992;786;124;0;ITF;ITF2;14;Molise;41.55774754;14.65916051;51;15;66;582;648;16;42;11680;461;12789;192713;174147
2021-04-19;ABR;6235;2864;3371;3787;2375;73;0;ITF;ITF1;13;Abruzzo;42.35122196;13.39843823;506;56;562;9538;10100;229;258;56951;2333;69384;1348869;603016
2021-04-19;VDA;753;326;427;521;209;23;0;ITC;ITC2;2;Valle d'Aosta / Vallée d'Aoste;45.73750286;7.320149366;61;12;73;946;1019;-27;38;8879;439;10337;106685;55566
2021-04-19;BAS;4182;1920;2262;2394;1653;135;0;ITF;ITF5;17;Basilicata;40.63947052;15.80514834;168;13;181;5565;5746;-53;47;16011;497;22254;318834;179558
2021-04-19;PIE;22598;10787;11811;17675;4359;564;0;ITC;ITC1;1;Piemonte;45.0732745;7.680687483;3045;283;3328;18256;21584;-1012;687;301931;10960;334475;3720834;1625146
2021-04-19;FVG;6735;3143;3592;3214;3426;95;0;ITH;ITH4;6;Friuli-Venezia Giulia;45.6494354;13.76813649;371;52;423;8972;9395;-103;52;90169;3611;103175;1766421;622637
2021-04-19;VEN;21561;8929;12632;4707;16423;431;0;ITH;ITH3;5;Veneto;45.43490485;12.33845213;1206;238;1444;25078;26522;78;497;364314;11111;401947;6767287;1630559
2021-04-19;TOS;9105;4516;4589;7753;1034;318;0;ITI;ITI1;9;Toscana;43.76923077;11.25588885;1577;273;1850;23863;25713;-358;771;185753;5883;217349;3859447;1920175
2021-04-19;PAT;2646;1244;1402;2428;23;195;0;ITH;ITH2;4;Provincia Autonoma Trento;46.06893511;11.12123097;116;31;147;1230;1377;-70;88;40265;1323;42965;739118;188482
2021-04-19;CAL;7911;3821;4090;6174;1689;48;0;ITF;ITF6;18;Calabria;38.90597598;16.59440194;475;47;522;13341;13863;-205;156;40332;950;55145;728851;680955
2021-04-19;LAZ;30194;13731;16463;18948;10759;487;0;ITI;ITI4;12;Lazio;41.89277044;12.48366722;2753;370;3123;47335;50458;-332;950;253642;7328;311428;5749681;3735020
2021-04-19;CAM;30787;14835;15952;18635;11592;560;0;ITF;ITF3;15;Campania;40.83956555;14.25084984;1536;150;1686;90515;92201;-220;1334;273561;5987;371749;4012782;2673921
2021-04-19;SIC;18293;8674;9619;12462;5590;241;0;ITG;ITG1;19;Sicilia;38.11569725;13.362356699999998;1262;176;1438;24884;26322;564;1123;165148;5172;196642;3596744;1407591
2021-04-19;UMB;5038;2228;2810;2931;2048;59;0;ITI;ITI2;10;Umbria;43.10675841;12.38824698;258;34;292;3283;3575;-72;133;48089;1315;52979;1073539;348336
2021-04-19;SAR;10261;4648;5613;8662;1451;148;0;ITG;ITG2;20;Sardegna;39.21531192;9.110616306;367;61;428;17579;18007;-59;199;32417;1318;51742;1145841;661099
2021-04-19;LOM;60409;27490;32919;49673;9424;1312;0;ITC;ITC4;3;Lombardia;45.46679409;9.190347404;4623;708;5331;54201;59532;-6845;1040;690708;32319;782559;8975848;3669686
2021-04-19;EMR;20922;9806;11116;14336;6284;302;0;ITH;ITH5;8;Emilia-Romagna;44.49436681;11.341720800000001;2256;296;2552;60735;63287;-598;877;283279;12640;359206;5294185;1737512
2021-04-20;BAS;4156;1985;2171;2179;1949;28;0;ITF;ITF5;17;Basilicata;40.63947052;15.80514834;172;10;182;5604;5786;40;146;16112;502;22400;320551;180346
2021-04-20;VDA;937;430;507;710;196;31;0;ITC;ITC2;2;Valle d'Aosta / Vallée d'Aoste;45.73750286;7.320149366;57;13;70;882;952;-67;29;8975;439;10366;107258;55743
2021-04-20;PIE;25556;11695;13861;18559;6364;633;0;ITC;ITC1;1;Piemonte;45.0732745;7.680687483;2753;281;3034;17730;20764;-820;988;303708;10991;335463;3743256;1631828
2021-04-20;SIC;18995;9004;9991;13434;5250;311;0;ITG;ITG1;19;Sicilia;38.11569725;13.362356699999998;1255;180;1435;23464;24899;-1423;1148;167683;5208;197790;3622523;1416819
2021-04-20;CAM;32186;15558;16628;20223;11340;623;0;ITF;ITF3;15;Campania;40.83956555;14.25084984;1524;153;1677;90110;91787;-414;1750;275673;6039;373499;4037523;2684972
2021-04-20;CAL;7912;3995;3917;6080;1754;78;0;ITF;ITF6;18;Calabria;38.90597598;16.59440194;478;47;525;13509;14034;171;450;40606;955;55595;732807;684109
2021-04-20;LIG;14256;6525;7731;9743;4360;153;0;ITC;ITC3;7;Liguria;44.41149315;8.9326992;596;70;666;5817;6483;-216;292;86110;4090;96683;1372029;564384
2021-04-20;UMB;5451;2365;3086;3429;1947;75;0;ITI;ITI2;10;Umbria;43.10675841;12.38824698;237;33;270;3191;3461;-114;114;48313;1319;53093;1081820;349210
2021-04-20;SAR;11200;5069;6131;7797;3298;105;0;ITG;ITG2;20;Sardegna;39.21531192;9.110616306;377;58;435;17544;17979;-28;271;32713;1321;52013;1149591;664226
2021-04-20;EMR;22655;10419;12236;13890;8364;401;0;ITH;ITH5;8;Emilia-Romagna;44.49436681;11.341720800000001;2171;291;2462;58501;60963;-2324;740;286311;12667;359941;5322319;1739973
2021-04-20;VEN;22469;9510;12959;7878;14013;578;0;ITH;ITH3;5;Veneto;45.43490485;12.33845213;1195;217;1412;24043;25455;-1067;930;366283;11139;402877;6785068;1635055
2021-04-20;LAZ;31210;14321;16889;19375;11390;445;0;ITI;ITI4;12;Lazio;41.89277044;12.48366722;2782;353;3135;46041;49176;-1282;926;255816;7362;312354;5784737;3754021
2021-04-20;LOM;67721;30852;36869;55896;10365;1460;0;ITC;ITC4;3;Lombardia;45.46679409;9.190347404;4639;675;5314;53005;58319;-1213;1670;693524;32386;784229;9022749;3683455
2021-04-20;TOS;18162;8109;10053;12209;5589;364;0;ITI;ITI1;9;Toscana;43.76923077;11.25588885;1553;269;1822;23249;25071;-642;644;187011;5911;217993;3882478;1927119
2021-04-20;PAT;2910;1388;1522;2691;37;182;0;ITH;ITH2;4;Provincia Autonoma Trento;46.06893511;11.12123097;129;28;157;1179;1336;-41;85;40390;1324;43050;741022;188703
2021-04-20;FVG;7154;3083;4071;3101;3923;130;0;ITH;ITH4;6;Friuli-Venezia Giulia;45.6494354;13.76813649;344;51;395;8563;8958;-437;277;90876;3618;103452;1774610;624846
2021-04-20;ABR;5640;2714;2926;4103;1457;80;0;ITF;ITF1;13;Abruzzo;42.35122196;13.39843823;514;52;566;9192;9758;-342;97;57385;2337;69480;1351871;603567
2021-04-20;MAR;10754;5028;5726;9146;1471;137;0;ITI;ITI3;11;Marche;43.61675973;13.5188753;546;85;631;6630;7261;-125;211;84719;2868;94848;1088861;654039
2021-04-20;MOL;2343;1038;1305;1215;1113;15;0;ITF;ITF2;14;Molise;41.55774754;14.65916051;52;15;67;588;655;7;33;11704;463;12822;193228;174656
2021-04-20;PUG;21239;9861;11378;17475;3494;270;0;ITF;ITF4;16;Puglia;41.12559576;16.86736689;1893;260;2153;47646;49799;-627;1180;166688;5508;221995;2103967;1085601
2021-04-20;PAB;1565;785;780;1487;3;75;0;ITH;ITH1;4;Provincia Autonoma Bolzano / Bozen;46.49933453;11.35662422;63;13;76;191;267;41;41;68825;1155;70247;1262761;379949
2021-04-21;PAT;2947;1373;1574;2741;51;155;0;ITH;ITH2;4;Provincia Autonoma Trento;46.06893511;11.12123097;133;28;161;1154;1315;-21;13;40424;1324;43063;741658;188782
2021-04-21;TOS;29650;12689;16961;16852;12159;639;0;ITI;ITI1;9;Toscana;43.76923077;11.25588885;1551;257;1808;22665;24473;-598;936;188514;5942;218929;3907653;1935288
2021-04-21;VEN;32413;13207;19206;15568;16066;779;0;ITH;ITH3;5;Veneto;45.43490485;12.33845213;1169;208;1377;23216;24593;-862;1094;368219;11159;403971;6839391;1638483
2021-04-21;FVG;7793;3474;4319;4027;3685;81;0;ITH;ITH4;6;Friuli-Venezia Giulia;45.6494354;13.76813649;339;48;387;8515;8902;-56;263;91187;3626;103715;1783145;626928
2021-04-21;PIE;25836;11863;13973;19794;5365;677;0;ITC;ITC1;1;Piemonte;45.0732745;7.680687483;2666;277;2943;16885;19828;-936;1026;305622;11039;336489;3763444;1638015
2021-04-21;LOM;71890;32586;39304;55816;14704;1370;0;ITC;ITC4;3;Lombardia;45.46679409;9.190347404;4522;667;5189;52601;57790;-529;2095;696076;32458;786324;9072166;3698402
2021-04-21;LIG;14297;6461;7836;8861;5347;89;0;ITC;ITC3;7;Liguria;44.41149315;8.9326992;586;68;654;5626;6280;-203;266;86566;4103;96949;1379441;566533
2021-04-21;PUG;23179;10703;12476;19128;3748;303;0;ITF;ITF4;16;Puglia;41.12559576;16.86736689;1872;260;2132;47221;49353;-446;1141;168250;5533;223136;2116904;1088530
2021-04-21;PAB;3017;1470;1547;2037;849;131;0;ITH;ITH1;4;Provincia Autonoma Bolzano / Bozen;46.49933453;11.35662422;60;12;72;274;346;79;79;68825;1155;70326;1272341;381294
2021-04-21;VDA;869;410;459;588;249;32;0;ITC;ITC2;2;Valle d'Aosta / Vallée d'Aoste;45.73750286;7.320149366;60;13;73;906;979;27;67;9015;439;10433;107570;55832
2021-04-21;MAR;10788;4969;5819;9422;1196;170;0;ITI;ITI3;11;Marche;43.61675973;13.5188753;530;79;609;6648;7257;-4;388;85101;2878;95236;1093815;656762
2021-04-21;ABR;6393;3104;3289;4632;1673;88;0;ITF;ITF1;13;Abruzzo;42.35122196;13.39843823;494;51;545;8960;9505;-253;170;57800;2345;69650;1357330;605020
2021-04-21;CAL;11645;5849;5796;8637;2943;65;0;ITF;ITF6;18;Calabria;38.90597598;16.59440194;476;47;523;13606;14129;95;471;40979;958;56066;737617;687979
2021-04-21;MOL;1896;801;1095;974;910;12;0;ITF;ITF2;14;Molise;41.55774754;14.65916051;41;14;55;623;678;23;56;11735;465;12878;194848;175494
2021-04-21;UMB;5332;2320;3012;3060;2232;40;0;ITI;ITI2;10;Umbria;43.10675841;12.38824698;221;34;255;3167;3422;-39;113;48462;1322;53206;1087973;349815
2021-04-21;CAM;30355;14773;15582;17538;12232;585;0;ITF;ITF3;15;Campania;40.83956555;14.25084984;1534;144;1678;90207;91885;98;1881;277426;6069;375380;4064458;2699906
2021-04-21;EMR;23977;10974;13003;13871;9743;363;0;ITH;ITH5;8;Emilia-Romagna;44.49436681;11.341720800000001;2116;287;2403;56130;58533;-2430;760;289471;12690;360694;5349582;1744317
2021-04-21;SAR;12184;5582;6602;6478;5600;106;0;ITG;ITG2;20;Sardegna;39.21531192;9.110616306;375;55;430;17514;17944;-35;303;33042;1330;52316;1153053;667102
2021-04-21;BAS;3950;1845;2105;2241;1679;30;0;ITF;ITF5;17;Basilicata;40.63947052;15.80514834;165;13;178;5661;5839;53;173;16227;507;22573;322662;181401
2021-04-21;LAZ;33193;15086;18107;20240;12510;443;0;ITI;ITI4;12;Lazio;41.89277044;12.48366722;2657;334;2991;44755;47746;-1430;1161;258355;7414;313515;5818302;3772310
2021-04-21;SIC;22398;10753;11645;15987;6127;284;0;ITG;ITG1;19;Sicilia;38.11569725;13.362356699999998;1274;182;1456;23732;25188;289;1288;168672;5218;199078;3651572;1426412
2021-04-22;BAS;5051;2353;2698;3382;1614;55;0;ITF;ITF5;17;Basilicata;40.63947052;15.80514834;154;12;166;5806;5972;133;206;16296;511;22779;324556;182286
2021-04-22;ABR;6738;3252;3486;4828;1734;176;0;ITF;ITF1;13;Abruzzo;42.35122196;13.39843823;474;50;524;8990;9514;9;163;57951;2347;69812;1364874;606742
2021-04-22;VDA;1068;450;618;652;383;33;0;ITC;ITC2;2;Valle d'Aosta / Vallée d'Aoste;45.73750286;7.320149366;53;12;65;856;921;-58;35;9106;441;10468;108288;56067
2021-04-22;VEN;32084;13949;18135;15479;15782;823;0;ITH;ITH3;5;Veneto;45.43490485;12.33845213;1125;194;1319;22436;23755;-838;1060;370093;11183;405031;6877032;1642903
2021-04-22;PUG;23088;10564;12524;17753;4951;384;0;ITF;ITF4;16;Puglia;41.12559576;16.86736689;1819;260;2079;47343;49422;69;1895;170041;5568;225031;2129376;1092646
2021-04-22;UMB;5458;2251;3207;2702;2674;82;0;ITI;ITI2;10;Umbria;43.10675841;12.38824698;227;36;263;3033;3296;-126;14;48600;1324;53220;1089418;349965
2021-04-22;LAZ;39282;19545;19737;23813;14771;698;0;ITI;ITI4;12;Lazio;41.89277044;12.48366722;2578;338;2916;44947;47863;117;1311;259518;7445;314826;5852812;3791199
2021-04-22;EMR;29062;13456;15606;14616;14081;365;0;ITH;ITH5;8;Emilia-Romagna;44.49436681;11.341720800000001;2029;282;2311;54210;56521;-2012;1010;292461;12718;361700;5377093;1747870
2021-04-22;FVG;6804;3094;3710;3034;3698;72;0;ITH;ITH4;6;Friuli-Venezia Giulia;45.6494354;13.76813649;319;43;362;8394;8756;-146;210;91534;3635;103925;1790587;628760
2021-04-22;PIE;27705;12757;14948;20205;6698;802;0;ITC;ITC1;1;Piemonte;45.0732745;7.680687483;2568;280;2848;16284;19132;-696;1464;307736;11085;337953;3788437;1644977
2021-04-22;SIC;26776;12642;14134;19887;6463;426;0;ITG;ITG1;19;Sicilia;38.11569725;13.362356699999998;1244;178;1422;24206;25628;440;1412;169621;5241;200490;3685649;1437582
2021-04-22;PAT;3178;1484;1694;2947;46;185;0;ITH;ITH2;4;Provincia Autonoma Trento;46.06893511;11.12123097;119;30;149;1104;1253;-62;85;40567;1328;43148;743781;189084
2021-04-22;PAB;2939;1512;1427;1872;942;125;0;ITH;ITH1;4;Provincia Autonoma Bolzano / Bozen;46.49933453;11.35662422;60;12;72;336;408;62;63;68825;1156;70389;1276710;382147
2021-04-22;LOM;74084;33448;40636;56218;16451;1415;0;ITC;ITC4;3;Lombardia;45.46679409;9.190347404;4352;653;5005;52742;57747;-43;2509;698574;32512;788833;9124336;3715078
2021-04-22;CAL;9851;4926;4925;6852;2945;54;0;ITF;ITF6;18;Calabria;38.90597598;16.59440194;467;44;511;13724;14235;106;402;41266;967;56468;741489;691199
2021-04-22;SAR;10631;4686;5945;5542;4993;96;0;ITG;ITG2;20;Sardegna;39.21531192;9.110616306;375;53;428;17447;17875;-69;328;33432;1337;52644;1157324;670673
2021-04-22;CAM;34122;16637;17485;20868;12547;707;0;ITF;ITF3;15;Campania;40.83956555;14.25084984;1541;143;1684;90334;92018;133;1912;279179;6095;377292;4126289;2717337
2021-04-22;MAR;10799;4932;5867;9078;1579;142;0;ITI;ITI3;11;Marche;43.61675973;13.5188753;524;72;596;6599;7195;-62;272;85428;2885;95508;1097787;658790
2021-04-22;LIG;13882;6217;7665;8656;5092;134;0;ITC;ITC3;7;Liguria;44.41149315;8.9326992;564;69;633;5576;6209;-71;331;86962;4109;97280;1387142;569227
2021-04-22;TOS;35803;15322;20481;17413;17561;829;0;ITI;ITI1;9;Toscana;43.76923077;11.25588885;1524;257;1781;22208;23989;-484;1041;190006;5975;219970;3932092;1944069
2021-04-22;MOL;1865;873;992;1066;781;18;0;ITF;ITF2;14;Molise;41.55774754;14.65916051;41;14;55;587;642;-36;7;11778;465;12885;195088;175731
2021-04-23;PIE;27495;12627;14868;20006;6771;718;0;ITC;ITC1;1;Piemonte;45.0732745;7.680687483;2447;275;2722;15723;18445;-687;1099;309503;11104;339052;3813977;1650943
2021-04-23;UMB;6659;2821;3838;3301;3159;199;0;ITI;ITI2;10;Umbria;43.10675841;12.38824698;212;35;247;3057;3304;8;102;48687;1331;53322;1097689;350829
2021-04-23;SIC;28635;13726;14909;22405;5842;388;0;ITG;ITG1;19;Sicilia;38.11569725;13.362356699999998;1232;177;1409;23875;25284;-344;930;170871;5265;201420;3712535;1447005
2021-04-23;VEN;31322;13862;17460;21443;8711;1168;0;ITH;ITH3;5;Veneto;45.43490485;12.33845213;1093;193;1286;22021;23307;-448;1035;371556;11203;406066;6915314;1644314
2021-04-23;SAR;13069;5792;7277;7361;5555;153;0;ITG;ITG2;20;Sardegna;39.21531192;9.110616306;368;52;420;17372;17792;-83;267;33776;1343;52911;1160959;673707
2021-04-23;CAM;32361;15538;16823;22409;9161;791;0;ITF;ITF3;15;Campania;40.83956555;14.25084984;1513;146;1659;90367;92026;8;1970;281092;6144;379262;4147912;2733075
2021-04-23;LAZ;38018;18318;19700;22043;15429;546;0;ITI;ITI4;12;Lazio;41.89277044;12.48366722;2504;332;2836;43966;46802;-1061;1221;261777;7468;316047;5887505;3808405
2021-04-23;CAL;13160;6462;6698;9437;3619;104;0;ITF;ITF6;18;Calabria;38.90597598;16.59440194;461;43;504;14069;14573;338;610;41530;975;57078;745978;695108
2021-04-23;EMR;29586;13819;15767;14312;14896;378;0;ITH;ITH5;8;Emilia-Romagna;44.49436681;11.341720800000001;1948;276;2224;52325;54549;-1972;1104;295521;12731;362801;5405347;1751453
2021-04-23;PAT;3668;1786;1882;3428;56;184;0;ITH;ITH2;4;Provincia Autonoma Trento;46.06893511;11.12123097;117;29;146;1088;1234;-19;120;40705;1329;43268;746416;189322
2021-04-23;LOM;73648;33374;40274;55547;16666;1435;0;ITC;ITC4;3;Lombardia;45.46679409;9.190347404;4185;644;4829;51620;56449;-1298;2304;702119;32569;791137;9171176;3730373
2021-04-23;FVG;7635;3481;4154;3555;3940;140;0;ITH;ITH4;6;Friuli-Venezia Giulia;45.6494354;13.76813649;319;40;359;8272;8631;-125;124;91773;3645;104049;1796384;629782
2021-04-23;LIG;14700;6654;8046;8461;6130;109;0;ITC;ITC3;7;Liguria;44.41149315;8.9326992;543;70;613;5653;6266;57;370;87265;4119;97650;1394663;571887
2021-04-23;MAR;11320;5224;6096;8097;3055;168;0;ITI;ITI3;11;Marche;43.61675973;13.5188753;505;70;575;6311;6886;-309;326;86052;2896;95834;1101974;661056
2021-04-23;TOS;25738;11459;14279;8800;16407;531;0;ITI;ITI1;9;Toscana;43.76923077;11.25588885;1501;256;1757;21750;23507;-482;1003;191474;5992;220973;3958141;1953370
2021-04-23;PUG;29653;13781;15872;23935;5300;418;0;ITF;ITF4;16;Puglia;41.12559576;16.86736689;1778;253;2031;47166;49197;-225;1692;171894;5632;226723;2142721;1095502
2021-04-23;ABR;7416;3401;4015;4937;2308;171;0;ITF;ITF1;13;Abruzzo;42.35122196;13.39843823;466;46;512;8908;9420;-94;233;58270;2355;70045;1371971;608403
2021-04-23;MOL;2085;903;1182;1382;672;31;0;ITF;ITF2;14;Molise;41.55774754;14.65916051;41;13;54;531;585;-57;3;11837;466;12888;195364;175989
2021-04-23;PAB;4556;2159;2397;3056;1293;207;0;ITH;ITH1;4;Provincia Autonoma Bolzano / Bozen;46.49933453;11.35662422;65;11;76;282;358;-50;10;68885;1156;70399;1278194;382450
2021-04-23;VDA;923;443;480;511;383;29;0;ITC;ITC2;2;Valle d'Aosta / Vallée d'Aoste;45.73750286;7.320149366;55;12;67;824;891;-30;46;9180;443;10514;108845;56201
2021-04-23;BAS;4553;2193;2360;3473;1017;63;0;ITF;ITF5;17;Basilicata;40.63947052;15.80514834;161;11;172;5926;6098;126;189;16357;513;22968;326320;183107
2021-04-24;PAB;5120;2458;2662;4302;488;330;0;ITH;ITH1;4;Provincia Autonoma Bolzano / Bozen;46.49933453;11.35662422;58;10;68;345;413;55;56;68885;1157;70455;1289696;383813
2021-04-24;PUG;29477;13428;16049;25178;3959;340;0;ITF;ITF4;16;Puglia;41.12559576;16.86736689;1749;239;1988;47074;49062;-135;1255;173251;5665;227978;2156052;1099072
2021-04-24;MOL;2583;1217;1366;703;1852;28;0;ITF;ITF2;14;Molise;41.55774754;14.65916051;39;13;52;525;577;-8;47;11892;466;12935;208441;177018
2021-04-24;BAS;4584;2222;2362;3477;1051;56;0;ITF;ITF5;17;Basilicata;40.63947052;15.80514834;163;12;175;5903;6078;-20;157;16534;513;23125;327907;183836
2021-04-24;ABR;8732;3976;4756;6937;1532;263;0;ITF;ITF1;13;Abruzzo;42.35122196;13.39843823;459;45;504;8732;9236;-184;158;58607;2360;70203;1378879;610080
2021-04-24;LAZ;33605;15167;18438;20130;12927;548;0;ITI;ITI4;12;Lazio;41.89277044;12.48366722;2430;331;2761;44069;46830;28;1266;262992;7491;317313;5922686;3827060
2021-04-24;VDA;724;401;323;535;168;21;0;ITC;ITC2;2;Valle d'Aosta / Vallée d'Aoste;45.73750286;7.320149366;51;12;63;800;863;-28;39;9245;445;10553;109398;56373
2021-04-24;SIC;31218;14719;16499;23139;7642;437;0;ITG;ITG1;19;Sicilia;38.11569725;13.362356699999998;1234;179;1413;23798;25211;-73;1095;172018;5286;202515;3737986;1455983
2021-04-24;FVG;6694;2953;3741;5208;1245;241;0;ITH;ITH4;6;Friuli-Venezia Giulia;45.6494354;13.76813649;291;37;328;8123;8451;-180;204;92149;3653;104253;1804782;631716
2021-04-24;LOM;75884;33631;42253;53417;21174;1293;0;ITC;ITC4;3;Lombardia;45.46679409;9.190347404;4050;611;4661;52432;57093;644;2313;703739;32618;793450;9221632;3746851
2021-04-24;UMB;4568;1962;2606;3277;1185;106;0;ITI;ITI2;10;Umbria;43.10675841;12.38824698;206;36;242;2910;3152;-152;108;48947;1331;53430;1104506;351584
2021-04-24;PAT;3583;1716;1867;3355;16;212;0;ITH;ITH2;4;Provincia Autonoma Trento;46.06893511;11.12123097;99;26;125;1103;1228;-6;104;40811;1333;43372;748651;189549
2021-04-24;EMR;28660;13253;15407;14065;14245;350;0;ITH;ITH5;8;Emilia-Romagna;44.49436681;11.341720800000001;1873;265;2138;50265;52403;-2146;984;298618;12761;363782;5433738;1755287
2021-04-24;PIE;27582;12468;15114;21340;5667;575;0;ITC;ITC1;1;Piemonte;45.0732745;7.680687483;2443;267;2710;14941;17651;-794;821;311098;11124;339873;3838985;1657618
2021-04-24;SAR;10574;4912;5662;7960;2472;142;0;ITG;ITG2;20;Sardegna;39.21531192;9.110616306;378;51;429;17334;17763;-29;254;34055;1347;53165;1164436;676623
2021-04-24;VEN;24770;10832;13938;14965;9081;724;0;ITH;ITH3;5;Veneto;45.43490485;12.33845213;1055;186;1241;21978;23219;-88;976;372597;11226;407042;6950594;1650865
2021-04-24;TOS;13453;6176;7277;5622;7462;369;0;ITI;ITI1;9;Toscana;43.76923077;11.25588885;1474;255;1729;21318;23047;-460;886;192794;6018;221859;3984221;1962041
2021-04-24;MAR;12175;5367;6808;7556;4470;149;0;ITI;ITI3;11;Marche;43.61675973;13.5188753;480;70;550;6053;6603;-283;287;86614;2904;96121;1106348;663353
2021-04-24;CAL;19312;9609;9703;15758;3463;91;0;ITF;ITF6;18;Calabria;38.90597598;16.59440194;467;46;513;14024;14537;-36;544;42106;979;57622;750155;698455
2021-04-24;CAM;36389;17540;18849;24299;11250;840;0;ITF;ITF3;15;Campania;40.83956555;14.25084984;1499;140;1639;90223;91862;-164;2012;283223;6189;381274;4171575;2751536
2021-04-24;LIG;8223;3800;4423;4986;3155;82;0;ITC;ITC3;7;Liguria;44.41149315;8.9326992;529;72;601;5575;6176;-90;279;87624;4129;97929;1401450;574103
2021-04-25;LAZ;24588;11285;13303;16380;7876;332;0;ITI;ITI4;12;Lazio;41.89277044;12.48366722;2415;330;2745;44092;46837;7;1185;264151;7510;318498;5953261;3842895
2021-04-25;CAM;30744;15178;15566;24513;5408;823;0;ITF;ITF3;15;Campania;40.83956555;14.25084984;1511;137;1648;90683;92331;469;1854;284587;6210;383128;4190837;2765755
2021-04-25;LOM;51620;23667;27953;45520;4843;1257;0;ITC;ITC4;3;Lombardia;45.46679409;9.190347404;3886;610;4496;53126;57622;529;1967;705138;32657;795417;9260614;3761429
2021-04-25;SAR;4543;2286;2257;3707;786;50;0;ITG;ITG2;20;Sardegna;39.21531192;9.110616306;366;48;414;17469;17883;120;290;34220;1352;53455;1169560;680913
2021-04-25;FVG;2383;993;1390;2188;14;181;0;ITH;ITH4;6;Friuli-Venezia Giulia;45.6494354;13.76813649;282;37;319;7982;8301;-150;184;92472;3664;104437;1811417;633775
2021-04-25;EMR;22363;10246;12117;14405;7516;442;0;ITH;ITH5;8;Emilia-Romagna;44.49436681;11.341720800000001;1842;265;2107;48374;50481;-1922;1001;301517;12784;364782;5450270;1758518
2021-04-25;CAL;15900;8070;7830;14800;1032;68;0;ITF;ITF6;18;Calabria;38.90597598;16.59440194;471;46;517;14389;14906;369;484;42216;984;58106;753250;700998
2021-04-25;BAS;2990;1459;1531;2906;52;32;0;ITF;ITF5;17;Basilicata;40.63947052;15.80514834;163;13;176;5944;6120;42;163;16655;513;23288;329463;184636
2021-04-25;TOS;11067;5252;5815;8759;2146;162;0;ITI;ITI1;9;Toscana;43.76923077;11.25588885;1453;252;1705;21141;22846;-201;955;193928;6040;222814;4006191;1970020
2021-04-25;PIE;20281;9331;10950;17303;2510;468;0;ITC;ITC1;1;Piemonte;45.0732745;7.680687483;2403;260;2663;14810;17473;-178;978;312241;11137;340851;3852873;1662472
2021-04-25;VEN;18336;8155;10181;12898;4836;602;0;ITH;ITH3;5;Veneto;45.43490485;12.33845213;1050;185;1235;22077;23312;93;788;373283;11235;407830;6971802;1653825
2021-04-25;MAR;8603;3996;4607;6891;1578;134;0;ITI;ITI3;11;Marche;43.61675973;13.5188753;477;68;545;6035;6580;-23;299;86931;2909;96420;1110622;665676
2021-04-25;SIC;21403;10208;11195;16132;5019;252;0;ITG;ITG1;19;Sicilia;38.11569725;13.362356699999998;1244;171;1415;24095;25510;299;1061;172774;5292;203576;3759786;1462397
2021-04-25;PAB;3078;1501;1577;2281;672;125;0;ITH;ITH1;4;Provincia Autonoma Bolzano / Bozen;46.49933453;11.35662422;61;10;71;456;527;114;114;68885;1157;70569;1298964;385039
2021-04-25;PAT;2003;953;1050;1871;7;125;0;ITH;ITH2;4;Provincia Autonoma Trento;46.06893511;11.12123097;91;26;117;1122;1239;11;96;40896;1333;43468;751090;189808
2021-04-25;MOL;800;401;399;559;233;8;0;ITF;ITF2;14;Molise;41.55774754;14.65916051;40;14;54;564;618;41;74;11925;466;13009;209261;177801
2021-04-25;LIG;1936;921;1015;1509;415;12;0;ITC;ITC3;7;Liguria;44.41149315;8.9326992;524;72;596;5529;6125;-51;225;87893;4136;98154;1406255;575721
2021-04-25;ABR;9072;4624;4448;8053;809;210;0;ITF;ITF1;13;Abruzzo;42.35122196;13.39843823;448;43;491;8519;9010;-226;137;58961;2369;70340;1386637;611957
2021-04-25;UMB;4361;1686;2675;3868;83;410;0;ITI;ITI2;10;Umbria;43.10675841;12.38824698;194;34;228;2909;3137;-15;141;49100;1334;53571;1112018;352410
2021-04-25;PUG;11330;5244;6086;10052;1144;134;0;ITF;ITF4;16;Puglia;41.12559576;16.86736689;1738;235;1973;47298;49271;209;1203;174226;5684;229181;2165669;1101460
2021-04-25;VDA;850;409;441;674;139;37;0;ITC;ITC2;2;Valle d'Aosta / Vallée d'Aoste;45.73750286;7.320149366;46;12;58;783;841;-22;45;9311;446;10598;109951;56536
2021-04-26;LIG;10597;4998;5599;7866;2642;89;0;ITC;ITC3;7;Liguria;44.41149315;8.9326992;526;69;595;5473;6068;-57;200;88143;4143;98354;1410094;576951
2021-04-26;TOS;10148;4935;5213;7454;2557;137;0;ITI;ITI1;9;Toscana;43.76923077;11.25588885;1466;262;1728;20943;22671;-175;737;194818;6062;223551;4017800;1974280
2021-04-26;MAR;9177;4063;5114;6019;3028;130;0;ITI;ITI3;11;Marche;43.61675973;13.5188753;478;68;546;5866;6412;-168;123;87216;2915;96543;1112239;666408
2021-04-26;PUG;26377;12087;14290;22737;3246;394;0;ITF;ITF4;16;Puglia;41.12559576;16.86736689;1723;232;1955;46773;48728;-543;477;175209;5721;229658;2171461;1104197
2021-04-26;ABR;8562;4065;4497;7134;1214;214;0;ITF;ITF1;13;Abruzzo;42.35122196;13.39843823;432;44;476;8669;9145;135;179;58998;2376;70519;1393333;613889
2021-04-26;PAB;1551;777;774;1459;5;87;0;ITH;ITH1;4;Provincia Autonoma Bolzano / Bozen;46.49933453;11.35662422;61;11;72;541;613;86;96;68894;1158;70665;1306755;386247
2021-04-26;MOL;1179;529;650;822;332;25;0;ITF;ITF2;14;Molise;41.55774754;14.65916051;39;13;52;568;620;2;19;11941;467;13028;210020;178367
2021-04-26;VDA;720;332;388;518;170;32;0;ITC;ITC2;2;Valle d'Aosta / Vallée d'Aoste;45.73750286;7.320149366;41;11;52;729;781;-60;45;9412;450;10643;110495;56691
2021-04-26;PIE;19849;8769;11080;14930;4402;517;0;ITC;ITC1;1;Piemonte;45.0732745;7.680687483;2404;247;2651;14438;17089;-384;568;313172;11158;341419;3864827;1665337
2021-04-26;PAT;2676;1260;1416;2410;96;170;0;ITH;ITH2;4;Provincia Autonoma Trento;46.06893511;11.12123097;78;25;103;1119;1222;-17;75;40987;1334;43543;753727;190101
2021-04-26;SIC;21712;10279;11433;13299;8091;322;0;ITG;ITG1;19;Sicilia;38.11569725;13.362356699999998;1254;174;1428;24663;26091;581;1069;173249;5305;204645;3780405;1470043
2021-04-26;UMB;5402;2342;3060;3105;2255;42;0;ITI;ITI2;10;Umbria;43.10675841;12.38824698;187;36;223;2900;3123;-14;134;49246;1336;53705;1118932;353076
2021-04-26;LAZ;29377;13520;15857;19549;9316;512;0;ITI;ITI4;12;Lazio;41.89277044;12.48366722;2411;331;2742;43881;46623;-214;964;265285;7554;319462;5970097;3850736
2021-04-26;FVG;5515;2481;3034;3738;1657;120;0;ITH;ITH4;6;Friuli-Venezia Giulia;45.6494354;13.76813649;286;37;323;7942;8265;-36;100;92601;3671;104537;1814450;634874
2021-04-26;BAS;4465;2164;2301;4194;221;50;0;ITF;ITF5;17;Basilicata;40.63947052;15.80514834;166;10;176;5888;6064;-56;50;16756;518;23338;330768;185537
2021-04-26;SAR;6954;3300;3654;5922;929;103;0;ITG;ITG2;20;Sardegna;39.21531192;9.110616306;362;47;409;17351;17760;-123;135;34467;1363;53590;1171672;682680
2021-04-26;LOM;88036;40954;47082;67039;19171;1826;0;ITC;ITC4;3;Lombardia;45.46679409;9.190347404;3824;601;4425;48539;52964;-4658;872;710637;32688;796289;9277607;3769297
2021-04-26;CAM;34059;16653;17406;27507;5630;922;0;ITF;ITF3;15;Campania;40.83956555;14.25084984;1527;141;1668;90051;91719;-612;1282;286423;6268;384410;4203483;2773217
2021-04-26;CAL;10195;5062;5133;7709;2435;51;0;ITF;ITF6;18;Calabria;38.90597598;16.59440194;482;46;528;14343;14871;-35;185;42433;987;58291;755318;702618
2021-04-26;VEN;20734;9461;11273;14912;5140;682;0;ITH;ITH3;5;Veneto;45.43490485;12.33845213;1035;187;1222;22285;23507;195;535;373613;11245;408365;6987724;1656524
2021-04-26;EMR;27917;12941;14976;18040;9323;554;0;ITH;ITH5;8;Emilia-Romagna;44.49436681;11.341720800000001;1861;268;2129;46394;48523;-1958;936;304391;12801;365715;5462915;1761142
2021-04-27;VDA;979;424;555;653;292;34;0;ITC;ITC2;2;Valle d'Aosta / Vallée d'Aoste;45.73750286;7.320149366;43;12;55;737;792;11;50;9450;451;10693;111065;56869
2021-04-27;ABR;9087;4369;4718;6505;2469;113;0;ITF;ITF1;13;Abruzzo;42.35122196;13.39843823;419;44;463;8594;9057;-88;97;59181;2377;70615;1396909;614781
2021-04-27;BAS;4730;2243;2487;4349;327;54;0;ITF;ITF5;17;Basilicata;40.63947052;15.80514834;166;10;176;5883;6059;-5;90;16847;522;23428;332825;186246
2021-04-27;CAL;9985;4908;5077;7956;1977;52;0;ITF;ITF6;18;Calabria;38.90597598;16.59440194;474;45;519;14156;14675;-196;414;43034;996;58705;759229;705975
2021-04-27;SIC;26461;12689;13772;15144;10961;356;0;ITG;ITG1;19;Sicilia;38.11569725;13.362356699999998;1254;168;1422;24663;26085;-6;940;174162;5338;205585;3809167;1479597
2021-04-27;UMB;5669;2401;3268;3056;2578;35;0;ITI;ITI2;10;Umbria;43.10675841;12.38824698;188;34;222;2844;3066;-57;105;49405;1339;53810;1126978;353844
2021-04-27;LAZ;30862;13941;16921;19377;11025;460;0;ITI;ITI4;12;Lazio;41.89277044;12.48366722;2369;317;2686;43492;46178;-445;939;266635;7588;320401;6009842;3869095
2021-04-27;CAM;32171;15634;16537;23407;7930;834;0;ITF;ITF3;15;Campania;40.83956555;14.25084984;1506;136;1642;90037;91679;-40;1654;288080;6305;386064;4223172;2787896
2021-04-27;EMR;32136;14875;17261;19235;12470;431;0;ITH;ITH5;8;Emilia-Romagna;44.49436681;11.341720800000001;1833;246;2079;45724;47803;-720;723;305809;12820;366432;5493671;1764267
2021-04-27;LIG;14825;6701;8124;7144;7613;68;0;ITC;ITC3;7;Liguria;44.41149315;8.9326992;504;66;570;5258;5828;-240;217;88589;4154;98571;1417916;579255
2021-04-27;VEN;28215;12800;15415;20133;6917;1165;0;ITH;ITH3;5;Veneto;45.43490485;12.33845213;1007;183;1190;21654;22844;-663;848;375088;11281;409213;7022634;1660537
2021-04-27;SAR;7760;3593;4167;5574;2072;114;0;ITG;ITG2;20;Sardegna;39.21531192;9.110616306;371;46;417;17131;17548;-212;199;34869;1372;53789;1175188;685878
2021-04-27;LOM;86123;40014;46109;67639;16615;1869;0;ITC;ITC4;3;Lombardia;45.46679409;9.190347404;3819;582;4401;48650;53051;87;1369;711865;32742;797658;9313405;3782967
2021-04-27;MOL;1630;783;847;447;1140;43;0;ITF;ITF2;14;Molise;41.55774754;14.65916051;41;13;54;590;644;24;46;11963;467;13074;210493;178821
2021-04-27;TOS;10377;4927;5450;3667;6506;204;0;ITI;ITI1;9;Toscana;43.76923077;11.25588885;1449;257;1706;20060;21766;-905;522;196211;6096;224073;4038993;1980676
2021-04-27;MAR;9597;4391;5206;5505;3994;98;0;ITI;ITI3;11;Marche;43.61675973;13.5188753;457;66;523;5734;6257;-155;223;87590;2919;96766;1116163;668497
2021-04-27;PAB;2235;1015;1220;1062;1079;94;0;ITH;ITH1;4;Provincia Autonoma Bolzano / Bozen;46.49933453;11.35662422;60;9;69;603;672;59;65;68900;1158;70730;1315977;387345
2021-04-27;PUG;26749;12104;14645;20792;5629;328;0;ITF;ITF4;16;Puglia;41.12559576;16.86736689;1726;227;1953;46708;48661;-67;1056;176295;5758;230714;2186084;1108747
2021-04-27;FVG;8155;3742;4413;3551;4501;103;0;ITH;ITH4;6;Friuli-Venezia Giulia;45.6494354;13.76813649;267;32;299;7745;8044;-221;186;92998;3681;104723;1821797;636890
2021-04-27;PAT;3958;1903;2055;3595;70;293;0;ITH;ITH2;4;Provincia Autonoma Trento;46.06893511;11.12123097;85;27;112;1091;1203;-19;91;41097;1334;43634;755577;190399
2021-04-27;PIE;22674;10239;12435;16848;5168;658;0;ITC;ITC1;1;Piemonte;45.0732745;7.680687483;2308;240;2548;14216;16764;-325;667;314137;11185;342086;3882563;1671265
2021-04-28;CAM;36427;17632;18795;25816;9764;847;0;ITF;ITF3;15;Campania;40.83956555;14.25084984;1507;136;1643;90160;91803;124;1844;289769;6336;387908;4248290;2805503
2021-04-28;FVG;7360;3250;4110;3702;3521;137;0;ITH;ITH4;6;Friuli-Venezia Giulia;45.6494354;13.76813649;264;32;296;7832;8128;84;112;93020;3687;104835;1826687;636890
2021-04-28;SIC;29288;13724;15564;19709;9165;414;0;ITG;ITG1;19;Sicilia;38.11569725;13.362356699999998;1222;172;1394;23978;25372;-713;980;175825;5368;206565;3839317;1488576
2021-04-28;LOM;95815;43694;52121;66879;26961;1975;0;ITC;ITC4;3;Lombardia;45.46679409;9.190347404;3707;575;4282;47987;52269;-782;2442;715042;32789;800100;9370398;3801519
2021-04-28;LIG;14471;6527;7944;6378;8004;89;0;ITC;ITC3;7;Liguria;44.41149315;8.9326992;496;66;562;5064;5626;-202;268;89050;4163;98839;1425279;581407
2021-04-28;VEN;32468;15198;17270;22253;9025;1190;0;ITH;ITH3;5;Veneto;45.43490485;12.33845213;989;171;1160;21359;22519;-325;963;376358;11299;410176;7059872;1664467
2021-04-28;PIE;26127;11781;14346;15500;10072;555;0;ITC;ITC1;1;Piemonte;45.0732745;7.680687483;2264;223;2487;13971;16458;-306;1187;315596;11219;343273;3906338;1677579
2021-04-28;TOS;19143;8189;10954;3445;15340;358;0;ITI;ITI1;9;Toscana;43.76923077;11.25588885;1414;256;1670;19597;21267;-499;847;197525;6128;224920;4065475;1989366
2021-04-28;SAR;9132;4313;4819;5212;3766;154;0;ITG;ITG2;20;Sardegna;39.21531192;9.110616306;371;46;417;17038;17455;-93;264;35224;1374;54053;1179003;689062
2021-04-28;MOL;1725;945;780;492;1221;12;0;ITF;ITF2;14;Molise;41.55774754;14.65916051;40;14;54;596;650;6;29;11986;467;13103;211261;179566
2021-04-28;MAR;10939;4984;5955;6018;4745;176;0;ITI;ITI3;11;Marche;43.61675973;13.5188753;438;68;506;5690;6196;-61;301;87947;2924;97067;1120935;671133
2021-04-28;PAT;4294;1998;2296;3898;139;257;0;ITH;ITH2;4;Provincia Autonoma Trento;46.06893511;11.12123097;89;26;115;1045;1160;-43;16;41155;1335;43650;756005;190502
2021-04-28;PUG;19901;8926;10975;14841;4796;264;0;ITF;ITF4;16;Puglia;41.12559576;16.86736689;1685;231;1916;46727;48643;-18;1282;177547;5806;231996;2198817;1112647
2021-04-28;PAB;2469;1307;1162;2256;5;208;0;ITH;ITH1;4;Provincia Autonoma Bolzano / Bozen;46.49933453;11.35662422;60;7;67;672;739;67;76;68908;1159;70806;1325658;388494
2021-04-28;VDA;1220;633;587;683;503;34;0;ITC;ITC2;2;Valle d'Aosta / Vallée d'Aoste;45.73750286;7.320149366;46;8;54;760;814;22;53;9478;454;10746;111275;56938
2021-04-28;UMB;5394;2332;3062;2939;2398;57;0;ITI;ITI2;10;Umbria;43.10675841;12.38824698;179;29;208;2817;3025;-41;105;49546;1344;53915;1132966;354437
2021-04-28;CAL;12579;6102;6477;9622;2884;73;0;ITF;ITF6;18;Calabria;38.90597598;16.59440194;475;45;520;14367;14887;212;492;43305;1005;59197;763623;709504
2021-04-28;EMR;33752;15604;18148;20259;12899;594;0;ITH;ITH5;8;Emilia-Romagna;44.49436681;11.341720800000001;1790;250;2040;43505;45545;-2258;642;308683;12843;367071;5523280;1768156
2021-04-28;LAZ;33060;15086;17974;20913;11683;464;0;ITI;ITI4;12;Lazio;41.89277044;12.48366722;2295;307;2602;43043;45645;-533;1078;268214;7620;321479;6046535;3887489
2021-04-28;BAS;4707;2158;2549;4203;441;63;0;ITF;ITF5;17;Basilicata;40.63947052;15.80514834;162;9;171;5959;6130;71;187;16957;528;23615;334766;187083
2021-04-28;ABR;9517;4591;4926;7306;2026;185;0;ITF;ITF1;13;Abruzzo;42.35122196;13.39843823;400;45;445;8169;8614;-443;81;59697;2385;70696;1403606;616510
2021-04-29;ABR;12685;5854;6831;9269;3099;317;0;ITF;ITF1;13;Abruzzo;42.35122196;13.39843823;389;42;431;8125;8556;-58;177;59926;2391;70873;1411296;618324
2021-04-29;MOL;2271;1166;1105;888;1356;27;0;ITF;ITF2;14;Molise;41.55774754;14.65916051;42;14;56;583;639;-11;16;12012;468;13119;211634;179903
2021-04-29;VDA;1293;636;657;742;532;19;0;ITC;ITC2;2;Valle d'Aosta / Vallée d'Aoste;45.73750286;7.320149366;48;8;56;727;783;-31;40;9549;454;10786;111907;57146
2021-04-29;EMR;44994;21153;23841;26607;17566;821;0;ITH;ITH5;8;Emilia-Romagna;44.49436681;11.341720800000001;1764;234;1998;41653;43651;-1894;979;311535;12859;368045;5555224;1772832
2021-04-29;CAM;41557;20181;21376;23956;16750;851;0;ITF;ITF3;15;Campania;40.83956555;14.25084984;1462;137;1599;90286;91885;82;1986;291640;6369;389894;4274103;2822042
2021-04-29;TOS;39423;17758;21665;18560;20199;664;0;ITI;ITI1;9;Toscana;43.76923077;11.25588885;1362;254;1616;19511;21127;-140;1052;198690;6155;225972;4092664;1999972
2021-04-29;BAS;4860;2399;2461;4341;442;77;0;ITF;ITF5;17;Basilicata;40.63947052;15.80514834;168;6;174;5986;6160;30;169;17093;531;23784;336381;187817
2021-04-29;LOM;115672;53642;62030;83083;29933;2656;0;ITC;ITC4;3;Lombardia;45.46679409;9.190347404;3597;557;4154;47920;52074;-195;2306;717503;32829;802406;9421651;3819243
2021-04-29;CAL;12535;6098;6437;8655;3820;60;0;ITF;ITF6;18;Calabria;38.90597598;16.59440194;473;48;521;14431;14952;65;473;43708;1010;59670;768000;713245
2021-04-29;VEN;50340;23415;26925;35405;13186;1749;0;ITH;ITH3;5;Veneto;45.43490485;12.33845213;964;169;1133;21122;22255;-264;935;377540;11316;411111;7095913;1668208
2021-04-29;UMB;5240;2261;2979;2806;2343;91;0;ITI;ITI2;10;Umbria;43.10675841;12.38824698;169;31;200;2785;2985;-40;25;49608;1347;53940;1134028;354552
2021-04-29;SAR;11285;5137;6148;6687;4433;165;0;ITG;ITG2;20;Sardegna;39.21531192;9.110616306;365;48;413;16822;17235;-220;207;35644;1381;54260;1182855;692287
2021-04-29;SIC;31821;14849;16972;21797;9562;462;0;ITG;ITG1;19;Sicilia;38.11569725;13.362356699999998;1201;168;1369;23875;25244;-128;1061;176991;5391;207626;3865268;1498780
2021-04-29;LAZ;38884;17362;21522;24801;13400;683;0;ITI;ITI4;12;Lazio;41.89277044;12.48366722;2245;291;2536;42826;45362;-283;1124;269594;7647;322603;6083585;3908381
2021-04-29;PIE;48630;22035;26595;34756;12651;1223;0;ITC;ITC1;1;Piemonte;45.0732745;7.680687483;2170;220;2390;13731;16121;-337;1084;316999;11237;344357;3926129;1684101
2021-04-29;LIG;15596;6983;8613;6643;8858;95;0;ITC;ITC3;7;Liguria;44.41149315;8.9326992;479;67;546;4959;5505;-121;301;89463;4172;99140;1435449;583992
2021-04-29;PUG;26356;12189;14167;19209;6717;430;0;ITF;ITF4;16;Puglia;41.12559576;16.86736689;1658;230;1888;46541;48429;-214;1501;179232;5836;233497;2211107;1116575
2021-04-29;PAT;4706;2268;2438;4176;214;316;0;ITH;ITH2;4;Provincia Autonoma Trento;46.06893511;11.12123097;82;24;106;954;1060;-100;89;41341;1338;43739;758487;190784
2021-04-29;FVG;6813;3000;3813;4015;2610;188;0;ITH;ITH4;6;Friuli-Venezia Giulia;45.6494354;13.76813649;250;30;280;7347;7627;-501;213;93724;3697;105048;1838508;641059
2021-04-29;MAR;13452;6160;7292;7159;6109;184;0;ITI;ITI3;11;Marche;43.61675973;13.5188753;419;70;489;5693;6182;-14;308;88259;2934;97375;1125548;673659
2021-04-29;PAB;2645;1358;1287;1749;701;195;0;ITH;ITH1;4;Provincia Autonoma Bolzano / Bozen;46.49933453;11.35662422;58;7;65;734;799;60;67;68915;1159;70873;1329945;389246
2021-04-30;CAL;15121;7416;7705;10523;4518;80;0;ITF;ITF6;18;Calabria;38.90597598;16.59440194;467;46;513;14701;15214;262;404;43849;1011;60074;772432;716746
2021-04-30;EMR;36661;16810;19851;21238;14811;612;0;ITH;ITH5;8;Emilia-Romagna;44.49436681;11.341720800000001;1732;226;1958;42398;44356;705;1206;312018;12876;369250;5585982;1776316
2021-04-30;FVG;7429;3275;4154;3585;3670;174;0;ITH;ITH4;6;Friuli-Venezia Giulia;45.6494354;13.76813649;239;30;269;7309;7578;-49;108;93878;3700;105156;1844082;642020
2021-04-30;LAZ;41769;18509;23260;26633;14410;726;0;ITI;ITI4;12;Lazio;41.89277044;12.48366722;2182;284;2466;42230;44696;-666;1151;271385;7673;323754;6122534;3926563
2021-04-30;SAR;11319;5346;5973;6823;4303;193;0;ITG;ITG2;20;Sardegna;39.21531192;9.110616306;370;49;419;16674;17093;-142;247;36030;1384;54507;1186276;695144
2021-04-30;PIE;32013;14402;17611;17969;13351;693;0;ITC;ITC1;1;Piemonte;45.0732745;7.680687483;2111;210;2321;13378;15699;-422;1036;318439;11255;345393;3951835;1690857
2021-04-30;UMB;6259;2972;3287;2736;3401;122;0;ITI;ITI2;10;Umbria;43.10675841;12.38824698;164;33;197;2801;2998;13;96;49690;1348;54036;1142337;355527
2021-04-30;SIC;35062;16360;18702;23517;11058;487;0;ITG;ITG1;19;Sicilia;38.11569725;13.362356699999998;1172;165;1337;23559;24896;-348;861;178181;5410;208487;3893413;1507241
2021-04-30;CAM;42335;20200;22135;24931;16511;893;0;ITF;ITF3;15;Campania;40.83956555;14.25084984;1452;137;1589;89799;91388;-497;1898;294011;6393;391792;4303823;2837361
2021-04-30;VEN;50271;23624;26647;33163;15674;1434;0;ITH;ITH3;5;Veneto;45.43490485;12.33845213;964;161;1125;20767;21892;-363;788;378677;11330;411899;7132870;1672121
2021-04-30;PAT;4994;2435;2559;4445;163;386;0;ITH;ITH2;4;Provincia Autonoma Trento;46.06893511;11.12123097;74;26;100;1010;1110;50;93;41382;1340;43832;760905;191004
2021-04-30;TOS;40264;17815;22449;19653;19964;647;0;ITI;ITI1;9;Toscana;43.76923077;11.25588885;1332;253;1585;19084;20669;-458;870;199989;6184;226842;4120489;2009414
2021-04-30;LIG;14441;6453;7988;5773;8581;87;0;ITC;ITC3;7;Liguria;44.41149315;8.9326992;470;65;535;4936;5471;-34;276;89762;4183;99416;1442243;586141
2021-04-30;LOM;117561;54900;62661;87205;27692;2664;0;ITC;ITC4;3;Lombardia;45.46679409;9.190347404;3495;550;4045;48440;52485;411;2214;719265;32870;804620;9475296;3838002
2021-04-30;PUG;35080;15720;19360;22480;12028;572;0;ITF;ITF4;16;Puglia;41.12559576;16.86736689;1631;224;1855;45737;47592;-837;1344;181376;5873;234841;2224403;1120349
2021-04-30;MOL;2980;1577;1403;829;2122;29;0;ITF;ITF2;14;Molise;41.55774754;14.65916051;43;11;54;552;606;-33;3;12045;471;13122;211965;180213
2021-04-30;PAB;3350;1600;1750;1440;1779;131;0;ITH;ITH1;4;Provincia Autonoma Bolzano / Bozen;46.49933453;11.35662422;65;6;71;731;802;3;4;68916;1159;70877;1331125;389492
2021-04-30;MAR;14168;6206;7962;5393;8576;199;0;ITI;ITI3;11;Marche;43.61675973;13.5188753;408;67;475;5727;6202;20;330;88565;2938;97705;1130042;675999
2021-04-30;ABR;12513;5871;6642;6510;5728;275;0;ITF;ITF1;13;Abruzzo;42.35122196;13.39843823;382;39;421;8130;8551;-5;195;60119;2397;71067;1418219;620016
2021-04-30;BAS;5285;2375;2910;4061;1162;62;0;ITF;ITF5;17;Basilicata;40.63947052;15.80514834;164;8;172;6058;6230;70;172;17192;534;23956;337824;188473
2021-04-30;VDA;833;357;476;469;347;17;0;ITC;ITC2;2;Valle d'Aosta / Vallée d'Aoste;45.73750286;7.320149366;49;8;57;693;750;-33;37;9618;455;10823;112587;57329
2021-05-01;PUG;27741;12703;15038;16738;10723;280;0;ITF;ITF4;16;Puglia;41.12559576;16.86736689;1596;228;1824;45943;47767;175;1130;182310;5894;235971;2235853;1123006
2021-05-01;MOL;2676;1284;1392;408;2234;34;0;ITF;ITF2;14;Molise;41.55774754;14.65916051;44;11;55;549;604;-2;30;12076;472;13152;213280;181288
2021-05-01;MAR;9327;3926;5401;3498;5752;77;0;ITI;ITI3;11;Marche;43.61675973;13.5188753;398;66;464;5714;6178;-24;259;88843;2943;97964;1135300;678943
2021-05-01;PAB;2105;1067;1038;1812;160;133;0;ITH;ITH1;4;Provincia Autonoma Bolzano / Bozen;46.49933453;11.35662422;65;6;71;775;846;44;48;68920;1159;70925;1343619;391057
2021-05-01;BAS;4709;2139;2570;3884;755;70;0;ITF;ITF5;17;Basilicata;40.63947052;15.80514834;158;9;167;6125;6292;62;199;17329;534;24155;339466;189167
2021-05-01;ABR;10753;5053;5700;5631;4985;137;0;ITF;ITF1;13;Abruzzo;42.35122196;13.39843823;374;36;410;7973;8383;-168;151;60432;2403;71218;1424564;621666
2021-05-01;VDA;941;564;377;440;484;17;0;ITC;ITC2;2;Valle d'Aosta / Vallée d'Aoste;45.73750286;7.320149366;44;7;51;713;764;14;61;9665;455;10884;113250;57532
2021-05-01;LAZ;38287;17217;21070;25707;12091;489;0;ITI;ITI4;12;Lazio;41.89277044;12.48366722;2145;276;2421;40874;43295;-1401;1069;273842;7686;324823;6166300;3945249
2021-05-01;FVG;7218;3254;3964;5910;1048;260;0;ITH;ITH4;6;Friuli-Venezia Giulia;45.6494354;13.76813649;216;30;246;7118;7364;-214;223;94304;3711;105379;1856474;645474
2021-05-01;PIE;28636;13038;15598;16354;11824;458;0;ITC;ITC1;1;Piemonte;45.0732745;7.680687483;2084;200;2284;13187;15471;-228;882;319531;11273;346275;3978892;1698460
2021-05-01;UMB;5381;2643;2738;2100;3235;46;0;ITI;ITI2;10;Umbria;43.10675841;12.38824698;160;33;193;2715;2908;-90;98;49877;1349;54134;1149258;356398
2021-05-01;PAT;4891;2486;2405;4551;37;303;0;ITH;ITH2;4;Provincia Autonoma Trento;46.06893511;11.12123097;73;20;93;969;1062;-48;70;41497;1343;43902;763444;191190
2021-05-01;SIC;24460;11322;13138;18998;5172;290;0;ITG;ITG1;19;Sicilia;38.11569725;13.362356699999998;1136;167;1303;23470;24773;-123;1000;179294;5420;209487;3920442;1516447
2021-05-01;LOM;96112;43737;52375;65011;29337;1764;0;ITC;ITC4;3;Lombardia;45.46679409;9.190347404;3403;536;3939;47684;51623;-862;2139;722214;32922;806759;9534440;3857911
2021-05-01;CAM;46356;22668;23688;29227;16117;1012;0;ITF;ITF3;15;Campania;40.83956555;14.25084984;1441;137;1578;90019;91597;209;1950;295740;6405;393742;4336049;2855990
2021-05-01;EMR;28432;12783;15649;15279;12794;359;0;ITH;ITH5;8;Emilia-Romagna;44.49436681;11.341720800000001;1640;216;1856;39474;41330;-3026;941;315967;12893;370190;5620325;1780955
2021-05-01;SAR;10013;4799;5214;5422;4488;103;0;ITG;ITG2;20;Sardegna;39.21531192;9.110616306;371;49;420;16556;16976;-117;184;36328;1387;54691;1190323;698532
2021-05-01;VEN;38877;18252;20625;28706;8929;1242;0;ITH;ITH3;5;Veneto;45.43490485;12.33845213;907;154;1061;20715;21776;-116;914;379687;11350;412813;7176728;1676614
2021-05-01;TOS;23337;10070;13267;13728;9224;385;0;ITI;ITI1;9;Toscana;43.76923077;11.25588885;1279;248;1527;18872;20399;-270;895;201136;6202;227737;4152203;2019607
2021-05-01;CAL;16762;7986;8776;12400;4268;94;0;ITF;ITF6;18;Calabria;38.90597598;16.59440194;444;45;489;14568;15057;-157;337;44339;1015;60411;776182;719974
2021-05-01;LIG;7155;3261;3894;1313;5811;31;0;ITC;ITC3;7;Liguria;44.41149315;8.9326992;459;63;522;5011;5533;62;219;89913;4189;99635;1449115;588440
2021-05-02;VDA;765;345;420;581;160;24;0;ITC;ITC2;2;Valle d'Aosta / Vallée d'Aoste;45.73750286;7.320149366;36;8;44;705;749;-15;48;9725;458;10932;113967;57750
2021-05-02;BAS;4182;2001;2181;3489;629;64;0;ITF;ITF5;17;Basilicata;40.63947052;15.80514834;159;9;168;6116;6284;-8;77;17412;536;24232;340221;189511
2021-05-02;SAR;6077;2727;3350;5296;678;103;0;ITG;ITG2;20;Sardegna;39.21531192;9.110616306;362;49;411;16481;16892;-84;124;36534;1389;54815;1193791;701439
2021-05-02;VEN;37247;17266;19981;25600;10332;1315;0;ITH;ITH3;5;Veneto;45.43490485;12.33845213;897;149;1046;20694;21740;-36;329;380037;11365;413142;7191540;1679095
2021-05-02;LAZ;32958;14470;18488;22941;9484;533;0;ITI;ITI4;12;Lazio;41.89277044;12.48366722;2160;269;2429;40784;43213;-82;986;274897;7699;325809;6182041;3953602
2021-05-02;TOS;11181;4936;6245;8979;1968;234;0;ITI;ITI1;9;Toscana;43.76923077;11.25588885;1296;250;1546;18744;20290;-109;730;201958;6219;228467;4167136;2025328
2021-05-02;PIE;25172;11296;13876;14020;10754;398;0;ITC;ITC1;1;Piemonte;45.0732745;7.680687483;2034;203;2237;13236;15473;2;702;320221;11283;346977;3988269;1701484
2021-05-02;CAM;43495;21552;21943;31166;11377;952;0;ITF;ITF3;15;Campania;40.83956555;14.25084984;1467;143;1610;89627;91237;-360;1352;297441;6416;395094;4355232;2866672
2021-05-02;CAL;12564;5863;6701;10582;1913;69;0;ITF;ITF6;18;Calabria;38.90597598;16.59440194;434;48;482;14743;15225;168;286;44453;1019;60697;778545;721921
2021-05-02;LIG;3981;1837;2144;503;3472;6;0;ITC;ITC3;7;Liguria;44.41149315;8.9326992;475;61;536;5061;5597;64;202;90046;4194;99837;1453767;590041
2021-05-02;PAT;3565;1980;1585;3294;39;232;0;ITH;ITH2;4;Provincia Autonoma Trento;46.06893511;11.12123097;69;20;89;987;1076;14;97;41579;1344;43999;765959;191471
2021-05-02;EMR;25597;11657;13940;13192;12000;405;0;ITH;ITH5;8;Emilia-Romagna;44.49436681;11.341720800000001;1671;217;1888;39875;41763;433;950;316468;12906;371137;5630177;1783565
2021-05-02;LOM;83540;38348;45192;59220;22486;1834;0;ITC;ITC4;3;Lombardia;45.46679409;9.190347404;3290;542;3832;48454;52286;663;1287;722815;32945;808046;9564689;3869494
2021-05-02;FVG;6923;3259;3664;3810;2970;143;0;ITH;ITH4;6;Friuli-Venezia Giulia;45.6494354;13.76813649;217;34;251;7022;7273;-91;24;94416;3714;105403;1859453;646277
2021-05-02;MAR;8905;3939;4966;3077;5743;85;0;ITI;ITI3;11;Marche;43.61675973;13.5188753;415;67;482;5619;6101;-77;132;89051;2944;98096;1137308;679917
2021-05-02;PUG;21369;9683;11686;13907;7280;182;0;ITF;ITF4;16;Puglia;41.12559576;16.86736689;1594;219;1813;45824;47637;-130;810;183232;5912;236781;2242079;1124128
2021-05-02;ABR;10465;5115;5350;5088;5232;145;0;ITF;ITF1;13;Abruzzo;42.35122196;13.39843823;348;32;380;8199;8579;196;226;60457;2408;71444;1432454;623798
2021-05-02;PAB;2454;1284;1170;1428;916;110;0;ITH;ITH1;4;Provincia Autonoma Bolzano / Bozen;46.49933453;11.35662422;65;4;69;831;900;54;61;68926;1160;70986;1354965;392318
2021-05-02;MOL;1922;950;972;584;1318;20;0;ITF;ITF2;14;Molise;41.55774754;14.65916051;44;9;53;553;606;2;37;12109;474;13189;213828;181813
2021-05-02;SIC;24617;11434;13183;17694;6607;316;0;ITG;ITG1;19;Sicilia;38.11569725;13.362356699999998;1148;163;1311;23470;24781;8;772;180055;5423;210259;3930215;1521743
2021-05-02;UMB;3782;1867;1915;1298;2455;29;0;ITI;ITI2;10;Umbria;43.10675841;12.38824698;169;33;202;2753;2955;47;188;50017;1350;54322;1157494;357271
2021-05-03;PAT;4314;2224;2090;3846;157;311;0;ITH;ITH2;4;Provincia Autonoma Trento;46.06893511;11.12123097;61;20;81;1051;1132;56;78;41600;1345;44077;768965;191854
2021-05-03;TOS;11952;5521;6431;10363;1341;248;0;ITI;ITI1;9;Toscana;43.76923077;11.25588885;1306;249;1555;18435;19990;-300;570;202799;6248;229037;4176686;2028970
2021-05-03;LIG;13270;5925;7345;6362;6822;86;0;ITC;ITC3;7;Liguria;44.41149315;8.9326992;480;60;540;4827;5367;-230;135;90405;4200;99972;1457279;591192
2021-05-03;LOM;83752;39781;43971;69433;12150;2169;0;ITC;ITC4;3;Lombardia;45.46679409;9.190347404;3215;535;3750;44527;48277;-4009;637;727433;32973;808683;9579976;3877234
2021-05-03;PAB;1838;851;987;398;1419;21;0;ITH;ITH1;4;Provincia Autonoma Bolzano / Bozen;46.49933453;11.35662422;62;3;65;897;962;62;70;68933;1161;71056;1362361;393462
2021-05-03;MAR;10411;4691;5720;4857;5414;140;0;ITI;ITI3;11;Marche;43.61675973;13.5188753;413;69;482;5594;6076;-25;59;89134;2945;98155;1138087;680235
2021-05-03;PUG;33451;14953;18498;22178;10704;569;0;ITF;ITF4;16;Puglia;41.12559576;16.86736689;1604;208;1812;45211;47023;-614;335;184129;5964;237116;2247607;1126726
2021-05-03;ABR;11152;5260;5892;7128;3838;186;0;ITF;ITF1;13;Abruzzo;42.35122196;13.39843823;355;31;386;8347;8733;154;159;60458;2412;71603;1436150;624857
2021-05-03;VDA;841;400;441;459;352;30;0;ITC;ITC2;2;Valle d'Aosta / Vallée d'Aoste;45.73750286;7.320149366;35;8;43;684;727;-22;58;9804;459;10990;114816;58067
2021-05-03;BAS;4512;2044;2468;3621;827;64;0;ITF;ITF5;17;Basilicata;40.63947052;15.80514834;163;7;170;6061;6231;-53;26;17487;540;24258;340569;189687
2021-05-03;FVG;7260;3304;3956;3346;3797;117;0;ITH;ITH4;6;Friuli-Venezia Giulia;45.6494354;13.76813649;211;32;243;7044;7287;14;51;94450;3717;105454;1861691;646926
2021-05-03;UMB;5092;2273;2819;2100;2888;104;0;ITI;ITI2;10;Umbria;43.10675841;12.38824698;169;34;203;2730;2933;-22;120;50157;1352;54442;1165024;358093
2021-05-03;PIE;26734;12224;14510;12053;14232;449;0;ITC;ITC1;1;Piemonte;45.0732745;7.680687483;2042;194;2236;12935;15171;-302;343;320847;11302;347320;3999707;1704260
2021-05-03;SAR;8341;3856;4485;6600;1627;114;0;ITG;ITG2;20;Sardegna;39.21531192;9.110616306;358;51;409;16356;16765;-127;61;36718;1393;54876;1195227;702649
2021-05-03;LAZ;39682;17916;21766;26191;12807;684;0;ITI;ITI4;12;Lazio;41.89277044;12.48366722;2183;275;2458;40299;42757;-456;661;275992;7721;326470;6199409;3960355
2021-05-03;CAL;14862;6808;8054;10464;4303;95;0;ITF;ITF6;18;Calabria;38.90597598;16.59440194;440;39;479;13906;14385;-840;228;45505;1035;60925;780794;723671
2021-05-03;SIC;23329;10802;12527;13259;9804;266;0;ITG;ITG1;19;Sicilia;38.11569725;13.362356699999998;1178;160;1338;23617;24955;174;734;180595;5443;210993;3944689;1528128
2021-05-03;CAM;40767;19896;20871;27826;11874;1067;0;ITF;ITF3;15;Campania;40.83956555;14.25084984;1483;139;1622;88793;90415;-822;959;299192;6446;396053;4366274;2871970
2021-05-03;VEN;40714;19815;20899;32802;6439;1473;0;ITH;ITH3;5;Veneto;45.43490485;12.33845213;896;151;1047;20876;21923;183;364;380214;11369;413506;7201077;1681115
2021-05-03;MOL;2562;1217;1345;2326;166;70;0;ITF;ITF2;14;Molise;41.55774754;14.65916051;40;8;48;581;629;23;39;12124;475;13228;214609;182573
2021-05-03;EMR;28740;13571;15169;17398;10885;457;0;ITH;ITH5;8;Emilia-Romagna;44.49436681;11.341720800000001;1687;219;1906;40095;42001;238;641;316859;12916;371776;5641239;1785610
2021-05-04;BAS;4142;1995;2147;3568;524;50;0;ITF;ITF5;17;Basilicata;40.63947052;15.80514834;163;9;172;6051;6223;-8;72;17565;542;24330;342093;190289
2021-05-04;ABR;10855;5094;5761;7036;3628;191;0;ITF;ITF1;13;Abruzzo;42.35122196;13.39843823;360;34;394;8218;8612;-121;37;60613;2415;71640;1438203;625236
2021-05-04;VDA;1136;511;625;435;674;27;0;ITC;ITC2;2;Valle d'Aosta / Vallée d'Aoste;45.73750286;7.320149366;38;8;46;652;698;-29;23;9856;459;11013;115231;58176
2021-05-04;UMB;5544;2547;2997;2355;3127;62;0;ITI;ITI2;10;Umbria;43.10675841;12.38824698;165;28;193;2688;2881;-52;96;50300;1357;54538;1174592;359191
2021-05-04;EMR;29319;13733;15586;15163;13676;480;0;ITH;ITH5;8;Emilia-Romagna;44.49436681;11.341720800000001;1620;213;1833;37295;39128;-2873;488;320194;12940;372262;5670785;1788645
2021-05-04;CAL;16546;7629;8917;11623;4817;106;0;ITF;ITF6;18;Calabria;38.90597598;16.59440194;439;40;479;13668;14147;-238;302;46040;1040;61227;784856;726583
2021-05-04;LOM;86893;41102;45791;70257;14429;2207;0;ITC;ITC4;3;Lombardia;45.46679409;9.190347404;3263;525;3788;44395;48183;-94;1354;728840;33014;810037;9619341;3892095
2021-05-04;SAR;9685;4429;5256;7624;1905;156;0;ITG;ITG2;20;Sardegna;39.21531192;9.110616306;354;47;401;16042;16443;-322;104;37139;1398;54980;1198146;705090
2021-05-04;CAM;48482;23344;25138;38197;8907;1378;0;ITF;ITF3;15;Campania;40.83956555;14.25084984;1480;128;1608;87412;89020;-1395;1331;301880;6484;397384;4393166;2885171
2021-05-04;LIG;13664;6095;7569;5362;8236;66;0;ITC;ITC3;7;Liguria;44.41149315;8.9326992;487;62;549;4488;5037;-330;161;90886;4210;100133;1463867;593080
2021-05-04;LAZ;40331;18552;21779;26059;13746;526;0;ITI;ITI4;12;Lazio;41.89277044;12.48366722;2185;271;2456;38823;41279;-1478;803;278237;7757;327273;6239775;3977723
2021-05-04;VEN;43037;20385;22652;33351;8033;1653;0;ITH;ITH3;5;Veneto;45.43490485;12.33845213;878;149;1027;19987;21014;-909;721;381828;11385;414227;7235461;1684524
2021-05-04;TOS;18327;8218;10109;12414;5468;445;0;ITI;ITI1;9;Toscana;43.76923077;11.25588885;1266;237;1503;18033;19536;-454;503;203731;6273;229540;4199079;2036172
2021-05-04;SIC;26864;12477;14387;17143;9299;422;0;ITG;ITG1;19;Sicilia;38.11569725;13.362356699999998;1152;160;1312;23511;24823;-132;902;181604;5468;211895;3977246;1536665
2021-05-04;MAR;10974;4840;6134;4926;5905;143;0;ITI;ITI3;11;Marche;43.61675973;13.5188753;406;69;475;5535;6010;-66;204;89398;2951;98359;1142503;682426
2021-05-04;MOL;2755;1200;1555;2562;133;60;0;ITF;ITF2;14;Molise;41.55774754;14.65916051;34;6;40;592;632;3;31;12149;478;13259;215213;183156
2021-05-04;PAB;3453;1845;1608;2262;1038;153;0;ITH;ITH1;4;Provincia Autonoma Bolzano / Bozen;46.49933453;11.35662422;63;2;65;974;1039;77;86;68942;1161;71142;1372085;394762
2021-05-04;PUG;35254;14912;20342;18249;16580;425;0;ITF;ITF4;16;Puglia;41.12559576;16.86736689;1585;197;1782;44838;46620;-403;1028;185526;5998;238144;2261410;1130408
2021-05-04;FVG;9621;4342;5279;6004;3388;229;0;ITH;ITH4;6;Friuli-Venezia Giulia;45.6494354;13.76813649;210;33;243;6811;7054;-233;133;94813;3720;105587;1867477;648576
2021-05-04;PIE;31690;14648;17042;17313;13778;599;0;ITC;ITC1;1;Piemonte;45.0732745;7.680687483;1981;188;2169;12590;14759;-412;637;321868;11330;347957;4020658;1710791
2021-05-04;PAT;4574;2490;2084;4172;97;305;0;ITH;ITH2;4;Provincia Autonoma Trento;46.06893511;11.12123097;63;20;83;967;1050;-82;38;41720;1345;44115;770060;192082
2021-05-05;TOS;30162;13465;16697;14854;14572;736;0;ITI;ITI1;9;Toscana;43.76923077;11.25588885;1218;229;1447;17489;18936;-600;744;205040;6308;230284;4225879;2044515
2021-05-05;CAL;13644;6529;7115;8415;5150;79;0;ITF;ITF6;18;Calabria;38.90597598;16.59440194;432;39;471;13404;13875;-272;284;46590;1046;61511;789216;730160
2021-05-05;UMB;7224;3306;3918;3834;3306;84;0;ITI;ITI2;10;Umbria;43.10675841;12.38824698;171;30;201;2650;2851;-30;65;50395;1357;54603;1176357;359425
2021-05-05;VEN;44420;21284;23136;36218;6562;1640;0;ITH;ITH3;5;Veneto;45.43490485;12.33845213;854;145;999;19177;20176;-838;745;383399;11397;414972;7272298;1688635
2021-05-05;SAR;10287;4680;5607;8009;2064;214;0;ITG;ITG2;20;Sardegna;39.21531192;9.110616306;338;46;384;15863;16247;-196;166;37496;1403;55146;1201710;708052
2021-05-05;SIC;26412;12236;14176;16276;9688;448;0;ITG;ITG1;19;Sicilia;38.11569725;13.362356699999998;1121;152;1273;23256;24529;-294;782;182656;5492;212677;4004318;1545925
2021-05-05;PAT;5061;2612;2449;4432;306;323;0;ITH;ITH2;4;Provincia Autonoma Trento;46.06893511;11.12123097;67;18;85;966;1051;1;17;41735;1346;44132;770512;193068
2021-05-05;FVG;9807;4281;5526;6083;3480;244;0;ITH;ITH4;6;Friuli-Venezia Giulia;45.6494354;13.76813649;193;33;226;6640;6866;-188;174;95172;3723;105761;1878045;651239
2021-05-05;CAM;51187;24866;26321;43133;6398;1656;0;ITF;ITF3;15;Campania;40.83956555;14.25084984;1459;122;1581;86455;88036;-984;1447;304273;6522;398831;4422438;2902762
2021-05-05;LAZ;46887;21518;25369;30361;15898;628;0;ITI;ITI4;12;Lazio;41.89277044;12.48366722;2055;265;2320;37878;40198;-1081;838;280117;7796;328111;6275995;3997677
2021-05-05;LOM;88141;42013;46128;70406;15379;2356;0;ITC;ITC4;3;Lombardia;45.46679409;9.190347404;3188;519;3707;43581;47288;-895;1557;731260;33046;811594;9669592;3908890
2021-05-05;LIG;13726;6143;7583;5176;8465;85;0;ITC;ITC3;7;Liguria;44.41149315;8.9326992;463;62;525;4177;4702;-335;194;91406;4219;100327;1471331;595410
2021-05-05;PIE;34744;16279;18465;20349;13684;711;0;ITC;ITC1;1;Piemonte;45.0732745;7.680687483;1896;175;2071;12295;14366;-393;947;323186;11352;348904;4040711;1717460
2021-05-05;EMR;30151;14006;16145;18310;11276;565;0;ITH;ITH5;8;Emilia-Romagna;44.49436681;11.341720800000001;1546;213;1759;37323;39082;-46;561;320778;12957;372817;5700763;1792959
2021-05-05;PUG;39381;17288;22093;24504;14278;599;0;ITF;ITF4;16;Puglia;41.12559576;16.86736689;1548;194;1742;44744;46486;-134;1171;186819;6010;239315;2273761;1135615
2021-05-05;VDA;1039;566;473;435;582;22;0;ITC;ITC2;2;Valle d'Aosta / Vallée d'Aoste;45.73750286;7.320149366;40;8;48;667;715;17;28;9867;459;11041;115469;58245
2021-05-05;MAR;11697;5322;6375;5101;6434;162;0;ITI;ITI3;11;Marche;43.61675973;13.5188753;391;68;459;5414;5873;-137;278;89811;2953;98637;1147062;684972
2021-05-05;PAB;4161;1948;2213;1825;2118;218;0;ITH;ITH1;4;Provincia Autonoma Bolzano / Bozen;46.49933453;11.35662422;61;4;65;1095;1160;121;135;68955;1162;71277;1383822;395048
2021-05-05;MOL;2507;1074;1433;2315;145;47;0;ITF;ITF2;14;Molise;41.55774754;14.65916051;34;7;41;563;604;-28;28;12205;478;13287;215689;183610
2021-05-05;ABR;11647;5576;6071;6270;5213;164;0;ITF;ITF1;13;Abruzzo;42.35122196;13.39843823;349;26;375;7991;8366;-246;85;60938;2420;71724;1443921;626783
2021-05-05;BAS;4337;2049;2288;3375;891;71;0;ITF;ITF5;17;Basilicata;40.63947052;15.80514834;160;8;168;6107;6275;52;175;17687;543;24505;343952;191070
2021-05-06;MOL;2757;1248;1509;2061;617;79;0;ITF;ITF2;14;Molise;41.55774754;14.65916051;31;9;40;553;593;-11;22;12238;478;13309;216065;183967
2021-05-06;PAB;5191;2752;2439;2365;2571;255;0;ITH;ITH1;4;Provincia Autonoma Bolzano / Bozen;46.49933453;11.35662422;65;5;70;1108;1178;18;72;69009;1162;71349;1386876;397071
2021-05-06;PUG;39806;17413;22393;19298;19943;565;0;ITF;ITF4;16;Puglia;41.12559576;16.86736689;1512;202;1714;43761;45475;-1011;877;188680;6037;240192;2285654;1138799
2021-05-06;PIE;33522;15843;17679;19342;13568;612;0;ITC;ITC1;1;Piemonte;45.0732745;7.680687483;1820;162;1982;12075;14057;-309;903;324380;11370;349807;4062721;1724591
2021-05-06;SIC;29492;14020;15472;18154;10843;495;0;ITG;ITG1;19;Sicilia;38.11569725;13.362356699999998;1063;149;1212;22666;23878;-651;1202;184485;5516;213879;4030583;1557268
2021-05-06;UMB;9474;4326;5148;6028;3316;130;0;ITI;ITI2;10;Umbria;43.10675841;12.38824698;173;28;201;2586;2787;-64;35;50490;1361;54638;1177898;359591
2021-05-06;LAZ;48917;22795;26122;30541;17640;736;0;ITI;ITI4;12;Lazio;41.89277044;12.48366722;2007;265;2272;36519;38791;-1407;1007;282492;7835;329118;6313769;4017126
2021-05-06;ABR;13004;6087;6917;7795;5049;160;0;ITF;ITF1;13;Abruzzo;42.35122196;13.39843823;335;30;365;7796;8161;-205;192;61333;2422;71916;1450557;628637
2021-05-06;BAS;5069;2441;2628;3431;1587;51;0;ITF;ITF5;17;Basilicata;40.63947052;15.80514834;154;10;164;6018;6182;-93;140;17919;544;24645;345410;191705
2021-05-06;EMR;35988;16629;19359;22154;13106;728;0;ITH;ITH5;8;Emilia-Romagna;44.49436681;11.341720800000001;1466;204;1670;37845;39515;433;824;321141;12976;373632;5731012;1797946
2021-05-06;SAR;13178;6068;7110;9733;3194;251;0;ITG;ITG2;20;Sardegna;39.21531192;9.110616306;319;41;360;15636;15996;-251;128;37873;1405;55274;1205247;711005
2021-05-06;MAR;12661;5825;6836;5355;7076;230;0;ITI;ITI3;11;Marche;43.61675973;13.5188753;373;65;438;5317;5755;-118;282;90207;2957;98919;1151503;687426
2021-05-06;LOM;89981;42245;47736;70968;16595;2418;0;ITC;ITC4;3;Lombardia;45.46679409;9.190347404;3072;513;3585;44467;48052;764;2151;732612;33081;813745;9724314;3927391
2021-05-06;CAL;13372;6326;7046;8921;4377;74;0;ITF;ITF6;18;Calabria;38.90597598;16.59440194;426;38;464;13188;13652;-223;343;47146;1056;61854;793133;733542
2021-05-06;VEN;47061;22070;24991;36581;8498;1982;0;ITH;ITH3;5;Veneto;45.43490485;12.33845213;780;136;916;19119;20035;-141;850;384383;11404;415822;7310604;1693342
2021-05-06;TOS;31449;13678;17771;13457;17296;696;0;ITI;ITI1;9;Toscana;43.76923077;11.25588885;1190;225;1415;17253;18668;-268;861;206136;6341;231145;4252015;2053838
2021-05-06;CAM;57626;28141;29485;41135;14779;1712;0;ITF;ITF3;15;Campania;40.83956555;14.25084984;1433;123;1556;85775;87331;-705;1503;306455;6548;400334;4450552;2919286
2021-05-06;LIG;14544;6446;8098;6072;8343;129;0;ITC;ITC3;7;Liguria;44.41149315;8.9326992;439;57;496;4049;4545;-157;201;91756;4227;100528;1478966;597912
2021-05-06;FVG;11982;5571;6411;7714;3987;281;0;ITH;ITH4;6;Friuli-Venezia Giulia;45.6494354;13.76813649;183;31;214;6518;6732;-134;80;95383;3726;105841;1883934;652782
2021-05-06;PAT;5619;2796;2823;4447;795;377;0;ITH;ITH2;4;Provincia Autonoma Trento;46.06893511;11.12123097;68;17;85;927;1012;-39;87;41861;1346;44219;772361;193474
2021-05-06;VDA;1083;516;567;664;385;34;0;ITC;ITC2;2;Valle d'Aosta / Vallée d'Aoste;45.73750286;7.320149366;42;9;51;634;685;-30;25;9922;459;11066;116159;58480
2021-05-07;UMB;10134;4716;5418;6656;3192;286;0;ITI;ITI2;10;Umbria;43.10675841;12.38824698;165;28;193;2621;2814;27;98;50561;1361;54736;1187939;360506
2021-05-07;EMR;35342;16989;18353;22663;11895;784;0;ITH;ITH5;8;Emilia-Romagna;44.49436681;11.341720800000001;1416;195;1611;38025;39636;121;871;321870;12992;374498;5760555;1801942
2021-05-07;CAL;16301;7678;8623;9649;6552;100;0;ITF;ITF6;18;Calabria;38.90597598;16.59440194;428;36;464;13368;13832;180;450;47408;1064;62304;797509;737084
2021-05-07;FVG;10957;5017;5940;7186;3570;201;0;ITH;ITH4;6;Friuli-Venezia Giulia;45.6494354;13.76813649;175;28;203;6404;6607;-125;86;95588;3732;105927;1891412;654810
2021-05-07;PIE;33186;15703;17483;18396;14157;633;0;ITC;ITC1;1;Piemonte;45.0732745;7.680687483;1764;162;1926;11936;13862;-195;867;325428;11384;350674;4089039;1731174
2021-05-07;TOS;32205;14726;17479;11347;20243;615;0;ITI;ITI1;9;Toscana;43.76923077;11.25588885;1146;220;1366;16781;18147;-521;715;207361;6352;231860;4279078;2063400
2021-05-07;VEN;48659;23313;25346;37607;8680;2372;0;ITH;ITH3;5;Veneto;45.43490485;12.33845213;753;132;885;18744;19629;-406;629;385408;11414;416451;7350884;1698551
2021-05-07;LAZ;48367;22677;25690;29788;17858;721;0;ITI;ITI4;12;Lazio;41.89277044;12.48366722;1943;273;2216;36344;38560;-231;1063;283769;7852;330181;6350326;4034696
2021-05-07;SIC;36607;17283;19324;24566;11630;411;0;ITG;ITG1;19;Sicilia;38.11569725;13.362356699999998;1021;142;1163;22167;23330;-548;603;185625;5527;214482;4056323;1565213
2021-05-07;SAR;14635;6666;7969;9786;4559;290;0;ITG;ITG2;20;Sardegna;39.21531192;9.110616306;311;40;351;15414;15765;-231;164;38264;1409;55438;1208702;713888
2021-05-07;MOL;2701;1258;1443;2034;602;65;0;ITF;ITF2;14;Molise;41.55774754;14.65916051;29;9;38;529;567;-26;5;12269;478;13314;216628;184420
2021-05-07;CAM;59795;29216;30579;42254;15971;1570;0;ITF;ITF3;15;Campania;40.83956555;14.25084984;1406;121;1527;84966;86493;-838;1382;308632;6591;401716;4477105;2934523
2021-05-07;LOM;92494;43757;48737;67893;22509;2092;0;ITC;ITC4;3;Lombardia;45.46679409;9.190347404;2968;491;3459;43647;47106;-946;1759;735292;33106;815504;9775509;3944562
2021-05-07;LIG;13619;6050;7569;5701;7815;103;0;ITC;ITC3;7;Liguria;44.41149315;8.9326992;415;54;469;3812;4281;-264;133;92144;4236;100661;1485079;599851
2021-05-07;PAT;6092;3133;2959;4854;854;384;0;ITH;ITH2;4;Provincia Autonoma Trento;46.06893511;11.12123097;65;19;84;852;936;-76;63;42000;1346;44282;774455;195988
2021-05-07;MAR;12839;5802;7037;3549;9187;103;0;ITI;ITI3;11;Marche;43.61675973;13.5188753;356;65;421;5245;5666;-89;314;90607;2960;99233;1155969;689934
2021-05-07;PAB;4200;2063;2137;3393;528;279;0;ITH;ITH1;4;Provincia Autonoma Bolzano / Bozen;46.49933453;11.35662422;65;5;70;1107;1177;-1;5;69015;1162;71354;1388197;397351
2021-05-07;PUG;50304;22445;27859;25960;23723;621;0;ITF;ITF4;16;Puglia;41.12559576;16.86736689;1486;199;1685;42952;44637;-838;870;190368;6057;241062;2297340;1142550
2021-05-07;VDA;566;247;319;513;30;23;0;ITC;ITC2;2;Valle d'Aosta / Vallée d'Aoste;45.73750286;7.320149366;37;9;46;584;630;-55;12;9988;460;11078;116671;58622
2021-05-07;ABR;12215;5716;6499;7636;4425;154;0;ITF;ITF1;13;Abruzzo;42.35122196;13.39843823;320;29;349;7813;8162;1;174;61506;2422;72090;1456847;630023
2021-05-07;BAS;4639;2281;2358;3264;1341;34;0;ITF;ITF5;17;Basilicata;40.63947052;15.80514834;147;10;157;6026;6183;1;120;18036;546;24765;346811;192334
2021-05-08;MAR;12292;5486;6806;4849;7265;178;0;ITI;ITI3;11;Marche;43.61675973;13.5188753;342;61;403;5185;5588;-78;254;90934;2965;99487;1160727;692586
2021-05-08;PUG;54508;23073;31435;23930;29966;612;0;ITF;ITF4;16;Puglia;41.12559576;16.86736689;1471;188;1659;42721;44380;-257;979;191583;6078;242041;2308883;1145150
2021-05-08;PAB;4431;2383;2048;3566;664;201;0;ITH;ITH1;4;Provincia Autonoma Bolzano / Bozen;46.49933453;11.35662422;54;6;60;1109;1169;-8;73;69094;1164;71427;1399290;398659
2021-05-08;LIG;7540;3337;4203;2274;5228;38;0;ITC;ITC3;7;Liguria;44.41149315;8.9326992;390;53;443;3545;3988;-293;202;92634;4241;100863;1491809;602033
2021-05-08;ABR;10291;4869;5422;6297;3836;158;0;ITF;ITF1;13;Abruzzo;42.35122196;13.39843823;307;27;334;7577;7911;-251;196;61947;2428;72286;1463948;631776
2021-05-08;BAS;4848;2408;2440;3379;1413;56;0;ITF;ITF5;17;Basilicata;40.63947052;15.80514834;149;7;156;5871;6027;-156;117;18307;548;24882;348365;193061
2021-05-08;CAL;18598;8441;10157;10495;8018;85;0;ITF;ITF6;18;Calabria;38.90597598;16.59440194;411;36;447;13220;13667;-165;334;47900;1071;62638;801350;739954
2021-05-08;VDA;909;544;365;500;383;26;0;ITC;ITC2;2;Valle d'Aosta / Vallée d'Aoste;45.73750286;7.320149366;31;8;39;571;610;-20;40;10047;461;11118;117200;58791
2021-05-08;MOL;3044;1480;1564;1720;1261;63;0;ITF;ITF2;14;Molise;41.55774754;14.65916051;29;9;38;511;549;-18;30;12316;479;13344;217516;185269
2021-05-08;CAM;56455;27150;29305;38983;15851;1621;0;ITF;ITF3;15;Campania;40.83956555;14.25084984;1382;122;1504;84480;85984;-509;1415;310521;6626;403131;4507560;2953166
2021-05-08;LOM;87868;40790;47078;63422;22147;2299;0;ITC;ITC4;3;Lombardia;45.46679409;9.190347404;2850;490;3340;42214;45554;-1552;1584;738385;33149;817088;9828006;3962547
2021-05-08;UMB;8164;3749;4415;4806;3252;106;0;ITI;ITI2;10;Umbria;43.10675841;12.38824698;146;24;170;2557;2727;-87;131;50776;1364;54867;1196012;361468
2021-05-08;LAZ;45544;20798;24746;29323;15484;737;0;ITI;ITI4;12;Lazio;41.89277044;12.48366722;1868;273;2141;36049;38190;-370;999;285123;7867;331180;6390229;4053209
2021-05-08;PAT;3196;1744;1452;2570;426;200;0;ITH;ITH2;4;Provincia Autonoma Trento;46.06893511;11.12123097;67;16;83;884;967;31;69;42038;1346;44351;776530;197026
2021-05-08;FVG;10345;4674;5671;5358;4794;193;0;ITH;ITH4;6;Friuli-Venezia Giulia;45.6494354;13.76813649;157;21;178;6309;6487;-120;90;95790;3740;106017;1899175;656811
2021-05-08;PIE;34392;16311;18081;18182;15675;535;0;ITC;ITC1;1;Piemonte;45.0732745;7.680687483;1726;166;1892;11711;13603;-259;719;326399;11391;351393;4115275;1738399
2021-05-08;EMR;32381;15112;17269;20398;11439;544;0;ITH;ITH5;8;Emilia-Romagna;44.49436681;11.341720800000001;1365;189;1554;36131;37685;-1951;875;324679;13007;375371;5790769;1805900
2021-05-08;SIC;35675;17050;18625;24886;10326;463;0;ITG;ITG1;19;Sicilia;38.11569725;13.362356699999998;995;140;1135;21495;22630;-700;851;187157;5546;215333;4081757;1573869
2021-05-08;SAR;13221;6004;7217;10757;2291;173;0;ITG;ITG2;20;Sardegna;39.21531192;9.110616306;310;39;349;15387;15736;-29;159;38447;1414;55597;1212331;716933
2021-05-08;VEN;41539;18790;22749;28257;11842;1440;0;ITH;ITH3;5;Veneto;45.43490485;12.33845213;717;128;845;18283;19128;-501;537;386440;11420;416988;7389587;1702452
2021-05-08;TOS;29195;13133;16062;13262;15532;401;0;ITI;ITI1;9;Toscana;43.76923077;11.25588885;1108;214;1322;16521;17843;-304;676;208320;6373;232536;4306302;2072636
2021-05-09;VDA;575;287;288;425;131;19;0;ITC;ITC2;2;Valle d'Aosta / Vallée d'Aoste;45.73750286;7.320149366;27;9;36;594;630;20;51;10078;461;11169;117869;59010
2021-05-09;EMR;25647;12271;13376;18278;6977;392;0;ITH;ITH5;8;Emilia-Romagna;44.49436681;11.341720800000001;1335;187;1522;31832;33354;-4331;650;329654;13010;376018;5807883;1808790
2021-05-09;FVG;7389;3318;4071;3375;3877;137;0;ITH;ITH4;6;Friuli-Venezia Giulia;45.6494354;13.76813649;152;21;173;6218;6391;-96;68;95953;3741;106085;1903568;658305
2021-05-09;BAS;4689;2343;2346;2946;1694;49;0;ITF;ITF5;17;Basilicata;40.63947052;15.80514834;135;11;146;5826;5972;-55;103;18465;548;24985;349863;193651
2021-05-09;SAR;6181;2889;3292;5161;926;94;0;ITG;ITG2;20;Sardegna;39.21531192;9.110616306;295;40;335;15325;15660;-76;54;38575;1416;55651;1214532;718776
2021-05-09;PIE;27188;12945;14243;13166;13624;398;0;ITC;ITC1;1;Piemonte;45.0732745;7.680687483;1680;159;1839;11648;13487;-116;592;327094;11404;351985;4127042;1742731
2021-05-09;CAM;43219;20294;22925;30862;11108;1249;0;ITF;ITF3;15;Campania;40.83956555;14.25084984;1348;119;1467;84124;85591;-393;1233;312137;6636;404364;4532167;2968403
2021-05-09;LOM;69733;32896;36837;54418;13287;2028;0;ITC;ITC4;3;Lombardia;45.46679409;9.190347404;2726;492;3218;42506;45724;170;1326;739508;33182;818414;9867304;3977431
2021-05-09;PUG;30877;12674;18203;14798;15697;382;0;ITF;ITF4;16;Puglia;41.12559576;16.86736689;1474;192;1666;42672;44338;-42;646;192246;6103;242687;2317514;1146681
2021-05-09;CAL;9708;4536;5172;6030;3629;49;0;ITF;ITF6;18;Calabria;38.90597598;16.59440194;419;34;453;13373;13826;159;312;48049;1075;62950;805279;743001
2021-05-09;PAT;2357;1226;1131;1869;347;141;0;ITH;ITH2;4;Provincia Autonoma Trento;46.06893511;11.12123097;61;18;79;874;953;-14;90;42142;1346;44441;779046;197780
2021-05-09;MAR;8867;4023;4844;3559;5230;78;0;ITI;ITI3;11;Marche;43.61675973;13.5188753;331;59;390;5144;5534;-54;250;91235;2968;99737;1164625;694668
2021-05-09;LIG;2827;1245;1582;1085;1712;30;0;ITC;ITC3;7;Liguria;44.41149315;8.9326992;384;52;436;3642;4078;90;152;92694;4243;101015;1497516;604164
2021-05-09;VEN;35091;16145;18946;23790;10055;1246;0;ITH;ITH3;5;Veneto;45.43490485;12.33845213;701;126;827;18199;19026;-102;492;387031;11423;417480;7409685;1705607
2021-05-09;ABR;9159;4091;5068;4171;4874;114;0;ITF;ITF1;13;Abruzzo;42.35122196;13.39843823;281;28;309;7513;7822;-89;85;62115;2434;72371;1470943;633580
2021-05-09;TOS;22559;9786;12773;9414;12883;262;0;ITI;ITI1;9;Toscana;43.76923077;11.25588885;1084;212;1296;16157;17453;-390;713;209414;6382;233249;4327283;2080026
2021-05-09;MOL;2086;953;1133;1940;98;48;0;ITF;ITF2;14;Molise;41.55774754;14.65916051;29;6;35;480;515;-34;11;12361;479;13355;217997;185743
2021-05-09;PAB;4243;2410;1833;2934;1150;159;0;ITH;ITH1;4;Provincia Autonoma Bolzano / Bozen;46.49933453;11.35662422;46;7;53;1138;1191;22;94;69163;1167;71521;1407048;399592
2021-05-09;LAZ;37584;17277;20307;25769;11316;499;0;ITI;ITI4;12;Lazio;41.89277044;12.48366722;1832;266;2098;35570;37668;-522;788;286423;7877;331968;6418729;4068417
2021-05-09;SIC;28443;13324;15119;19764;8299;380;0;ITG;ITG1;19;Sicilia;38.11569725;13.362356699999998;974;136;1110;21035;22145;-485;494;188122;5560;215827;4096094;1579457
2021-05-09;UMB;5764;2756;3008;5253;391;120;0;ITI;ITI2;10;Umbria;43.10675841;12.38824698;140;22;162;2522;2684;-43;99;50917;1365;54966;1202932;362254
2021-05-10;PIE;29104;14046;15058;15317;13143;644;0;ITC;ITC1;1;Piemonte;45.0732745;7.680687483;1680;161;1841;11285;13126;-361;346;327784;11421;352331;4140786;1745638
2021-05-10;LIG;12662;5649;7013;6194;6382;86;0;ITC;ITC3;7;Liguria;44.41149315;8.9326992;387;52;439;3489;3928;-150;66;92908;4245;101081;1500909;605249
2021-05-10;SAR;9950;4419;5531;7207;2560;183;0;ITG;ITG2;20;Sardegna;39.21531192;9.110616306;288;41;329;15146;15475;-185;31;38789;1418;55682;1219005;719768
2021-05-10;PAT;3272;1680;1592;2530;518;224;0;ITH;ITH2;4;Provincia Autonoma Trento;46.06893511;11.12123097;62;18;80;854;934;-19;59;42220;1346;44500;781740;198589
2021-05-10;LOM;85314;40904;44410;61451;21602;2261;0;ITC;ITC4;3;Lombardia;45.46679409;9.190347404;2668;479;3147;38554;41701;-4023;583;744091;33205;818997;9883527;3985109
2021-05-10;VEN;36531;17090;19441;25414;9862;1255;0;ITH;ITH3;5;Veneto;45.43490485;12.33845213;702;126;828;18208;19036;10;247;387266;11425;417727;7419551;1707960
2021-05-10;PAB;3029;1306;1723;1337;1611;81;0;ITH;ITH1;4;Provincia Autonoma Bolzano / Bozen;46.49933453;11.35662422;43;6;49;1151;1200;9;62;69216;1167;71583;1413047;400370
2021-05-10;PUG;37954;16771;21183;19303;18120;531;0;ITF;ITF4;16;Puglia;41.12559576;16.86736689;1424;183;1607;41854;43461;-877;247;193345;6128;242934;2322283;1147729
2021-05-10;VDA;786;385;401;531;235;20;0;ITC;ITC2;2;Valle d'Aosta / Vallée d'Aoste;45.73750286;7.320149366;25;9;34;571;605;-25;40;10142;462;11209;118570;59252
2021-05-10;MAR;9460;4342;5118;4742;4564;154;0;ITI;ITI3;11;Marche;43.61675973;13.5188753;334;58;392;5126;5518;-16;57;91306;2970;99794;1165765;695203
2021-05-10;ABR;10114;4785;5329;5337;4654;123;0;ITF;ITF1;13;Abruzzo;42.35122196;13.39843823;271;28;299;7648;7947;125;145;62132;2437;72516;1477574;635393
2021-05-10;UMB;6012;2814;3198;3743;2152;117;0;ITI;ITI2;10;Umbria;43.10675841;12.38824698;139;20;159;2486;2645;-39;99;51054;1366;55065;1210218;363004
2021-05-10;SIC;28744;13798;14946;16159;12221;364;0;ITG;ITG1;19;Sicilia;38.11569725;13.362356699999998;988;131;1119;21111;22230;85;589;188620;5566;216416;4115624;1586602
2021-05-10;EMR;33899;16156;17743;26007;7262;630;0;ITH;ITH5;8;Emilia-Romagna;44.49436681;11.341720800000001;1357;187;1544;29835;31379;-1975;471;332088;13019;376486;5818912;1810787
2021-05-10;FVG;8011;3559;4452;6221;1546;244;0;ITH;ITH4;6;Friuli-Venezia Giulia;45.6494354;13.76813649;147;22;169;6216;6385;-6;38;95994;3744;106123;1905377;658859
2021-05-10;BAS;4804;2382;2422;2709;2042;53;0;ITF;ITF5;17;Basilicata;40.63947052;15.80514834;131;10;141;5767;5908;-64;24;18549;552;25009;350285;193861
2021-05-10;LAZ;44544;20375;24169;30368;13460;716;0;ITI;ITI4;12;Lazio;41.89277044;12.48366722;1863;270;2133;34735;36868;-800;680;287886;7894;332648;6434303;4075333
2021-05-10;CAM;35484;16397;19087;24791;9934;759;0;ITF;ITF3;15;Campania;40.83956555;14.25084984;1365;113;1478;83106;84584;-1007;943;314033;6690;405307;4543672;2974165
2021-05-10;CAL;13177;6129;7048;7682;5422;73;0;ITF;ITF6;18;Calabria;38.90597598;16.59440194;423;31;454;13075;13529;-297;168;48505;1084;63118;806898;744628
2021-05-10;TOS;26246;12418;13828;15246;10652;348;0;ITI;ITI1;9;Toscana;43.76923077;11.25588885;1106;205;1311;15837;17148;-305;481;210180;6402;233730;4337791;2084156
2021-05-10;MOL;2964;1309;1655;2518;377;69;0;ITF;ITF2;14;Molise;41.55774754;14.65916051;28;5;33;484;517;2;30;12388;480;13385;218645;186380
2021-05-11;VDA;649;326;323;472;150;27;0;ITC;ITC2;2;Valle d'Aosta / Vallée d'Aoste;45.73750286;7.320149366;31;9;40;552;592;-13;8;10163;462;11217;119141;59471
2021-05-11;BAS;2654;1353;1301;1597;1033;24;0;ITF;ITF5;17;Basilicata;40.63947052;15.80514834;126;10;136;5580;5716;-192;80;18818;555;25089;351803;194478
2021-05-11;ABR;10765;5121;5644;5730;4857;178;0;ITF;ITF1;13;Abruzzo;42.35122196;13.39843823;278;29;307;7545;7852;-95;54;62280;2438;72570;1478960;635696
2021-05-11;LAZ;48417;22236;26181;31132;16605;680;0;ITI;ITI4;12;Lazio;41.89277044;12.48366722;1818;255;2073;34160;36233;-635;635;289116;7934;333283;6468899;4090708
2021-05-11;SIC;32694;15505;17189;19679;12502;513;0;ITG;ITG1;19;Sicilia;38.11569725;13.3623567;959;133;1092;21070;22162;-68;894;189556;5592;217310;4142986;1597306
2021-05-11;UMB;6260;2842;3418;3925;2193;142;0;ITI;ITI2;10;Umbria;43.10675841;12.38824698;137;19;156;2480;2636;-9;97;51159;1367;55162;1218128;363808
2021-05-11;VEN;33208;16521;16687;27150;4729;1329;0;ITH;ITH3;5;Veneto;45.43490485;12.33845213;695;123;818;17460;18278;-758;417;388424;11442;418144;7454378;1711091
2021-05-11;TOS;27972;12996;14976;12099;15492;381;0;ITI;ITI1;9;Toscana;43.76923077;11.25588885;1068;195;1263;15195;16458;-690;367;211216;6423;234097;4359704;2091141
2021-05-11;CAL;15153;7336;7817;10242;4838;73;0;ITF;ITF6;18;Calabria;38.90597598;16.59440194;414;29;443;12820;13263;-266;237;49000;1092;63355;810139;747367
2021-05-11;CAM;39892;19253;20639;29508;9407;977;0;ITF;ITF3;15;Campania;40.83956555;14.25084984;1353;111;1464;81810;83274;-1310;1109;316423;6719;406416;4567390;2986222
2021-05-11;EMR;35827;16810;19017;27866;7265;696;0;ITH;ITH5;8;Emilia-Romagna;44.49436681;11.3417208;1294;186;1480;27396;28876;-2503;456;335032;13031;376939;5844292;1813308
2021-05-11;PAB;2855;1339;1516;1256;1523;76;0;ITH;ITH1;4;Provincia Autonoma Bolzano / Bozen;46.49933453;11.35662422;34;6;40;1134;1174;-26;62;69304;1167;71645;1421215;401242
2021-05-11;MOL;3280;1448;1832;2928;254;98;0;ITF;ITF2;14;Molise;41.55774754;14.65916051;26;4;30;443;473;-44;29;12459;482;13414;219174;186888
2021-05-11;MAR;10624;4831;5793;5487;4943;194;0;ITI;ITI3;11;Marche;43.61675973;13.5188753;316;53;369;4869;5238;-280;151;91734;2973;99945;1169786;697461
2021-05-11;LOM;86953;41461;45492;58206;26261;2486;0;ITC;ITC4;3;Lombardia;45.46679409;9.190347404;2556;454;3010;37726;40736;-965;788;745814;33235;819785;9917506;3997531
2021-05-11;LIG;13944;6401;7543;7197;6632;115;0;ITC;ITC3;7;Liguria;44.41149315;8.9326992;374;47;421;3222;3643;-285;128;93314;4252;101209;1507599;607236
2021-05-11;SAR;9115;4248;4867;6454;2521;140;0;ITG;ITG2;20;Sardegna;39.21531192;9.110616306;274;40;314;14916;15230;-245;83;39113;1422;55765;1224781;721898
2021-05-11;PUG;32778;14489;18289;13704;18580;494;0;ITF;ITF4;16;Puglia;41.12559576;16.86736689;1374;168;1542;41140;42682;-779;684;194784;6152;243618;2333975;1151084
2021-05-11;PAT;3745;1770;1975;2640;863;242;0;ITH;ITH2;4;Provincia Autonoma Trento;46.06893511;11.12123097;59;18;77;803;880;-54;57;42331;1346;44557;783585;199142
2021-05-11;FVG;9194;4436;4758;7158;1815;221;0;ITH;ITH4;6;Friuli-Venezia Giulia;45.6494354;13.76813649;136;20;156;6082;6238;-147;70;96209;3746;106193;1911323;660427
2021-05-11;PIE;32346;15588;16758;18435;13263;648;0;ITC;ITC1;1;Piemonte;45.0732745;7.680687483;1658;148;1806;10880;12686;-440;529;328741;11433;352860;4160691;1751527
2021-05-12;LAZ;47642;21631;26011;30243;16707;692;0;ITI;ITI4;12;Lazio;41.89277044;12.48366722;1732;244;1976;33599;35575;-658;633;290385;7956;333916;6500219;4105951
2021-05-12;FVG;11205;5183;6022;9348;1438;419;0;ITH;ITH4;6;Friuli-Venezia Giulia;45.6494354;13.76813649;120;18;138;5948;6086;-152;75;96430;3752;106268;1919417;662247
2021-05-12;EMR;38977;18313;20664;28475;9707;795;0;ITH;ITH5;8;Emilia-Romagna;44.49436681;11.3417208;1239;178;1417;25114;26531;-2345;509;337875;13038;377444;5866306;1816245
2021-05-12;LOM;87577;41781;45796;57285;27615;2677;0;ITC;ITC4;3;Lombardia;45.46679409;9.190347404;2441;448;2889;36982;39871;-865;1198;747841;33271;820983;9968164;4013270
2021-05-12;PIE;31996;15231;16765;18400;12963;633;0;ITC;ITC1;1;Piemonte;45.0732745;7.680687483;1599;145;1744;10541;12285;-401;774;329898;11451;353634;4180197;1757613
2021-05-12;SAR;11228;5282;5946;7859;3155;214;0;ITG;ITG2;20;Sardegna;39.21531192;9.110616306;254;38;292;14660;14952;-278;96;39482;1427;55861;1229785;724172
2021-05-12;VEN;37024;17928;19096;30262;5128;1634;0;ITH;ITH3;5;Veneto;45.43490485;12.33845213;670;110;780;16855;17635;-643;493;389542;11460;418637;7499417;1714801
2021-05-12;UMB;6528;3038;3490;4209;2149;170;0;ITI;ITI2;10;Umbria;43.10675841;12.38824698;135;21;156;2427;2583;-53;108;51317;1370;55270;1223957;364412
2021-05-12;CAL;16508;8051;8457;10823;5586;99;0;ITF;ITF6;18;Calabria;38.90597598;16.59440194;402;28;430;12528;12958;-305;280;49581;1096;63635;813468;750099
2021-05-12;SIC;36868;17397;19471;21402;14925;541;0;ITG;ITG1;19;Sicilia;38.11569725;13.3623567;919;125;1044;18991;20035;-2127;607;192268;5614;217917;4169302;1604909
2021-05-12;PAT;3352;1513;1839;1961;1221;170;0;ITH;ITH2;4;Provincia Autonoma Trento;46.06893511;11.12123097;60;20;80;781;861;-19;12;42361;1347;44569;783997;199266
2021-05-12;PUG;36685;16361;20324;23540;12556;589;0;ITF;ITF4;16;Puglia;41.12559576;16.86736689;1315;161;1476;40073;41549;-1133;615;196496;6188;244233;2344907;1154116
2021-05-12;BAS;4730;2330;2400;2800;1881;49;0;ITF;ITF5;17;Basilicata;40.63947052;15.80514834;122;10;132;5336;5468;-248;122;19184;559;25211;353256;195113
2021-05-12;TOS;34230;15590;18640;13584;20060;586;0;ITI;ITI1;9;Toscana;43.76923077;11.25588885;1014;188;1202;14714;15916;-542;495;212215;6461;234592;4382894;2098565
2021-05-12;PAB;3808;2065;1743;3413;154;241;0;ITH;ITH1;4;Provincia Autonoma Bolzano / Bozen;46.49933453;11.35662422;27;6;33;1127;1160;-14;75;69393;1167;71720;1430338;402366
2021-05-12;VDA;1145;550;595;450;671;24;0;ITC;ITC2;2;Valle d'Aosta / Vallée d'Aoste;45.73750286;7.320149366;27;9;36;532;568;-24;19;10205;463;11236;119387;59524
2021-05-12;MOL;2931;1330;1601;2718;102;111;0;ITF;ITF2;14;Molise;41.55774754;14.65916051;25;4;29;437;466;-7;18;12483;483;13432;219865;187547
2021-05-12;CAM;40937;19979;20958;30492;9172;1273;0;ITF;ITF3;15;Campania;40.83956555;14.25084984;1307;116;1423;80995;82418;-856;1127;318376;6749;407543;4591680;3001361
2021-05-12;MAR;10430;4691;5739;4729;5505;196;0;ITI;ITI3;11;Marche;43.61675973;13.5188753;301;51;352;4806;5158;-80;230;92040;2977;100175;1174886;700063
2021-05-12;LIG;12125;5493;6632;6612;5412;101;0;ITC;ITC3;7;Liguria;44.41149315;8.9326992;350;49;399;3025;3424;-219;143;93669;4259;101352;1514272;609217
2021-05-12;ABR;9628;4602;5026;5869;3582;177;0;ITF;ITF1;13;Abruzzo;42.35122196;13.39843823;254;25;279;7392;7671;-181;79;62531;2447;72649;1485257;637199
2021-05-13;MOL;3118;1448;1670;2559;461;98;0;ITF;ITF2;14;Molise;41.55774754;14.65916051;25;5;30;406;436;-30;2;12515;483;13434;220006;187684
2021-05-13;MAR;12613;5698;6915;6822;5508;283;0;ITI;ITI3;11;Marche;43.61675973;13.5188753;286;50;336;4733;5069;-89;233;92358;2981;100408;1179811;702735
2021-05-13;PAB;3005;1360;1645;1020;1934;51;0;ITH;ITH1;4;Provincia Autonoma Bolzano / Bozen;46.49933453;11.35662422;29;6;35;1104;1139;-21;83;69497;1167;71803;1433818;402964
2021-05-13;ABR;11151;5044;6107;6952;3964;235;0;ITF;ITF1;13;Abruzzo;42.35122196;13.39843823;246;24;270;6989;7259;-412;150;63093;2447;72799;1491578;638738
2021-05-13;BAS;5987;2970;3017;3298;2598;91;0;ITF;ITF5;17;Basilicata;40.63947052;15.80514834;121;10;131;5210;5341;-127;91;19400;561;25302;354509;195665
2021-05-13;UMB;5945;2671;3274;3731;2085;129;0;ITI;ITI2;10;Umbria;43.10675841;12.38824698;143;20;163;2393;2556;-27;18;51362;1370;55288;1225093;364543
2021-05-13;SIC;47503;22278;25225;30292;16558;653;0;ITG;ITG1;19;Sicilia;38.11569725;13.3623567;883;124;1007;18158;19165;-870;603;193722;5633;218520;4189509;1612494
2021-05-13;LAZ;50309;22618;27691;31658;17895;756;0;ITI;ITI4;12;Lazio;41.89277044;12.48366722;1589;233;1822;33323;35145;-430;654;291448;7977;334570;6531273;4121583
2021-05-13;TOS;35223;15556;19667;13203;21379;641;0;ITI;ITI1;9;Toscana;43.76923077;11.25588885;978;187;1165;14265;15430;-486;651;213331;6482;235243;4406165;2107070
2021-05-13;CAM;55454;24831;30623;37687;16025;1742;0;ITF;ITF3;15;Campania;40.83956555;14.25084984;1285;105;1390;80060;81450;-968;1110;320430;6773;408653;4616296;3015720
2021-05-13;EMR;35885;16526;19359;27302;7862;721;0;ITH;ITH5;8;Emilia-Romagna;44.49436681;11.3417208;1199;163;1362;25447;26809;278;618;338195;13056;378060;5890242;1818791
2021-05-13;LOM;87249;41802;45447;55591;28917;2741;0;ITC;ITC4;3;Lombardia;45.46679409;9.190347404;2351;417;2768;36776;39544;-327;1396;749551;33284;822379;10017648;4029571
2021-05-13;CAL;15996;7699;8297;11176;4741;79;0;ITF;ITF6;18;Calabria;38.90597598;16.59440194;400;28;428;12025;12453;-505;327;50409;1100;63962;817225;753305
2021-05-13;LIG;13329;6094;7235;8892;4273;164;0;ITC;ITC3;7;Liguria;44.41149315;8.9326992;326;47;373;2874;3247;-177;115;93953;4267;101467;1521123;611416
2021-05-13;SAR;12452;5874;6578;8769;3469;214;0;ITG;ITG2;20;Sardegna;39.21531192;9.110616306;241;39;280;14474;14754;-198;72;39751;1428;55933;1234462;726923
2021-05-13;VEN;44356;21890;22466;32580;9921;1855;0;ITH;ITH3;5;Veneto;45.43490485;12.33845213;640;109;749;16362;17111;-524;468;390525;11469;419105;7531658;1719129
2021-05-13;FVG;11230;5431;5799;8745;2083;402;0;ITH;ITH4;6;Friuli-Venezia Giulia;45.6494354;13.76813649;98;18;116;5854;5970;-116;100;96638;3760;106368;1928216;664224
2021-05-13;PIE;35813;17596;18217;19924;15155;734;0;ITC;ITC1;1;Piemonte;45.0732745;7.680687483;1497;143;1640;10254;11894;-391;706;330981;11465;354340;4202604;1764189
2021-05-13;PAT;3459;1608;1851;2101;1127;231;0;ITH;ITH2;4;Provincia Autonoma Trento;46.06893511;11.12123097;54;19;73;761;834;-27;44;42430;1349;44613;785670;199768
2021-05-13;PUG;38911;17343;21568;21006;17333;572;0;ITF;ITF4;16;Puglia;41.12559576;16.86736689;1239;144;1383;38912;40295;-1254;554;198273;6219;244787;2354067;1156162
2021-05-13;VDA;1146;561;585;523;602;21;0;ITC;ITC2;2;Valle d'Aosta / Vallée d'Aoste;45.73750286;7.320149366;22;9;31;503;534;-34;23;10261;464;11259;120140;59757
2021-05-14;UMB;5347;2526;2821;3353;1819;175;0;ITI;ITI2;10;Umbria;43.10675841;12.38824698;140;20;160;2494;2654;98;114;51378;1370;55402;1232797;365383
2021-05-14;VEN;46851;22286;24565;24286;20971;1594;0;ITH;ITH3;5;Veneto;45.43490485;12.33845213;610;106;716;16019;16735;-376;453;391348;11475;419558;7560856;1722141
2021-05-14;CAL;19957;9585;10372;12949;6891;117;0;ITF;ITF6;18;Calabria;38.90597598;16.59440194;382;29;411;11934;12345;-108;253;50765;1105;64215;820597;756314
2021-05-14;PAT;5450;2616;2834;3717;1431;302;0;ITH;ITH2;4;Provincia Autonoma Trento;46.06893511;11.12123097;48;20;68;775;843;9;71;42492;1349;44684;788038;200715
2021-05-14;TOS;33416;15466;17950;20024;12750;642;0;ITI;ITI1;9;Toscana;43.76923077;11.25588885;935;182;1117;13857;14974;-456;529;214299;6499;235772;4429458;2114985
2021-05-14;FVG;10896;5414;5482;7931;2665;300;0;ITH;ITH4;6;Friuli-Venezia Giulia;45.6494354;13.76813649;89;17;106;5777;5883;-87;36;96756;3765;106404;1934374;665505
2021-05-14;LIG;13165;5871;7294;8636;4353;176;0;ITC;ITC3;7;Liguria;44.41149315;8.9326992;303;49;352;2855;3207;-40;138;94125;4273;101605;1527412;613471
2021-05-14;LAZ;51683;23611;28072;32427;18430;826;0;ITI;ITI4;12;Lazio;41.89277044;12.48366722;1599;231;1830;32911;34741;-404;706;292548;7987;335276;6563398;4137191
2021-05-14;LOM;86058;41442;44616;53161;30376;2521;0;ITC;ITC4;3;Lombardia;45.46679409;9.190347404;2251;411;2662;36027;38689;-855;1160;751543;33307;823539;10061653;4044528
2021-05-14;CAM;61049;27586;33463;34654;24742;1653;0;ITF;ITF3;15;Campania;40.83956555;14.25084984;1247;102;1349;79302;80651;-799;1118;322323;6797;409771;4639498;3028268
2021-05-14;PIE;33514;16322;17192;17376;15457;681;0;ITC;ITC1;1;Piemonte;45.0732745;7.680687483;1402;144;1546;9963;11509;-385;595;331942;11484;354935;4227622;1769927
2021-05-14;PUG;45138;20629;24509;28015;16258;865;0;ITF;ITF4;16;Puglia;41.12559576;16.86736689;1182;139;1321;37920;39241;-1054;591;199894;6243;245378;2363894;1158445
2021-05-14;MOL;2692;1242;1450;1902;724;66;0;ITF;ITF2;14;Molise;41.55774754;14.65916051;26;5;31;392;423;-13;5;12533;483;13439;220408;188058
2021-05-14;SIC;52253;24503;27750;35781;15685;787;0;ITG;ITG1;19;Sicilia;38.11569725;13.3623567;841;120;961;17048;18009;-1156;573;195434;5650;219093;4211778;1619810
2021-05-14;SAR;14681;6896;7785;10816;3653;212;0;ITG;ITG2;20;Sardegna;39.21531192;9.110616306;222;39;261;14289;14550;-204;99;40052;1430;56032;1239478;729329
2021-05-14;PAB;5147;2323;2824;2898;2044;205;0;ITH;ITH1;4;Provincia Autonoma Bolzano / Bozen;46.49933453;11.35662422;31;6;37;1084;1121;-18;4;69519;1167;71807;1434893;403219
2021-05-14;VDA;964;444;520;264;670;30;0;ITC;ITC2;2;Valle d'Aosta / Vallée d'Aoste;45.73750286;7.320149366;19;7;26;487;513;-21;23;10303;466;11282;120694;59913
2021-05-14;MAR;13638;6294;7344;6505;6915;218;0;ITI;ITI3;11;Marche;43.61675973;13.5188753;278;50;328;4475;4803;-266;252;92869;2988;100660;1184273;705254
2021-05-14;BAS;5907;2798;3109;3271;2530;106;0;ITF;ITF5;17;Basilicata;40.63947052;15.80514834;116;9;125;5192;5317;-24;114;19537;562;25416;355924;196305
2021-05-14;ABR;10598;5072;5526;5282;5153;163;0;ITF;ITF1;13;Abruzzo;42.35122196;13.39843823;235;20;255;6755;7010;-249;89;63427;2450;72887;1496916;640067
2021-05-14;EMR;37361;17204;20157;26803;9658;900;0;ITH;ITH5;8;Emilia-Romagna;44.49436681;11.3417208;1136;160;1296;25596;26892;83;551;338648;13067;378607;5929769;1825038
2021-05-15;PUG;43748;19053;24695;22844;20189;715;0;ITF;ITF4;16;Puglia;41.12559576;16.86736689;1126;134;1260;37476;38736;-505;567;200955;6254;245945;2373878;1160888
2021-05-15;MAR;14119;6442;7677;7826;6045;248;0;ITI;ITI3;11;Marche;43.61675973;13.5188753;269;47;316;4397;4713;-90;149;93106;2990;100809;1187950;707398
2021-05-15;LIG;7328;3279;4049;4297;2965;66;0;ITC;ITC3;7;Liguria;44.41149315;8.9326992;290;52;342;2775;3117;-90;97;94307;4278;101702;1533469;615497
2021-05-15;TOS;29378;13867;15511;22870;5911;597;0;ITI;ITI1;9;Toscana;43.76923077;11.25588885;884;180;1064;13467;14531;-443;491;215214;6518;236263;4453519;2122881
2021-05-15;ABR;11443;5184;6259;5935;5328;180;0;ITF;ITF1;13;Abruzzo;42.35122196;13.39843823;215;19;234;6652;6886;-124;144;63692;2452;73030;1503118;641480
2021-05-15;MOL;3044;1429;1615;2565;390;89;0;ITF;ITF2;14;Molise;41.55774754;14.65916051;24;4;28;346;374;-49;26;12606;485;13465;221428;189035
2021-05-15;PAB;7023;3698;3325;6325;294;404;0;ITH;ITH1;4;Provincia Autonoma Bolzano / Bozen;46.49933453;11.35662422;26;6;32;998;1030;-91;53;69662;1168;71860;1443928;404159
2021-05-15;FVG;12695;6121;6574;7684;4706;305;0;ITH;ITH4;6;Friuli-Venezia Giulia;45.6494354;13.76813649;74;16;90;5691;5781;-102;68;96923;3768;106472;1942574;667568
2021-05-15;BAS;6533;3344;3189;3875;2575;83;0;ITF;ITF5;17;Basilicata;40.63947052;15.80514834;110;9;119;5122;5241;-76;119;19732;562;25535;357606;197010
2021-05-15;PIE;33852;15785;18067;19427;13745;680;0;ITC;ITC1;1;Piemonte;45.0732745;7.680687483;1284;139;1423;9683;11106;-403;472;332802;11499;355407;4253253;1776505
2021-05-15;LOM;81002;38813;42189;45386;33455;2161;0;ITC;ITC4;3;Lombardia;45.46679409;9.190347404;2159;390;2549;36177;38726;37;1154;752638;33329;824693;10110605;4060617
2021-05-15;VDA;1068;615;453;368;687;13;0;ITC;ITC2;2;Valle d'Aosta / Vallée d'Aoste;45.73750286;7.320149366;21;6;27;476;503;-10;29;10342;466;11311;121340;60065
2021-05-15;CAM;62830;29089;33741;41935;18880;2015;0;ITF;ITF3;15;Campania;40.83956555;14.25084984;1196;102;1298;78860;80158;-493;946;323754;6805;410717;4664379;3043760
2021-05-15;VEN;36280;17522;18758;24819;10026;1435;0;ITH;ITH3;5;Veneto;45.43490485;12.33845213;585;97;682;15212;15894;-841;343;392524;11483;419901;7592323;1725396
2021-05-15;UMB;4999;1886;3113;1767;3168;64;0;ITI;ITI2;10;Umbria;43.10675841;12.38824698;133;22;155;2367;2522;-132;77;51586;1371;55479;1240012;366311
2021-05-15;SIC;56538;26407;30131;40361;15251;926;0;ITG;ITG1;19;Sicilia;38.11569725;13.3623567;833;114;947;16566;17513;-496;557;196477;5660;219650;4231759;1627543
2021-05-15;EMR;33297;14999;18298;22211;10442;644;0;ITH;ITH5;8;Emilia-Romagna;44.49436681;11.3417208;1057;160;1217;23502;24719;-2173;530;341330;13081;379130;5955782;1828510
2021-05-15;PAT;1610;838;772;650;918;42;0;ITH;ITH2;4;Provincia Autonoma Trento;46.06893511;11.12123097;50;18;68;794;862;19;53;42526;1349;44737;790208;201583
2021-05-15;CAL;27285;13059;14226;20267;6886;132;0;ITF;ITF6;18;Calabria;38.90597598;16.59440194;380;25;405;11929;12334;-11;193;50965;1109;64408;824238;759389
2021-05-15;SAR;13882;6446;7436;10239;3445;198;0;ITG;ITG2;20;Sardegna;39.21531192;9.110616306;218;38;256;14203;14459;-91;67;40207;1433;56099;1242603;731948
2021-05-15;LAZ;57534;27482;30052;40041;16605;888;0;ITI;ITI4;12;Lazio;41.89277044;12.48366722;1591;233;1824;32043;33867;-874;621;294038;7992;335897;6594948;4153128
2021-05-16;ABR;9578;4135;5443;5646;3812;120;0;ITF;ITF1;13;Abruzzo;42.35122196;13.39843823;205;19;224;6668;6892;6;112;63797;2453;73142;1509686;642943
2021-05-16;VDA;690;342;348;340;342;8;0;ITC;ITC2;2;Valle d'Aosta / Vallée d'Aoste;45.73750286;7.320149366;25;6;31;485;516;13;43;10372;466;11354;121858;60243
2021-05-16;BAS;4973;2468;2505;2805;2113;55;0;ITF;ITF5;17;Basilicata;40.63947052;15.80514834;107;9;116;5022;5138;-103;92;19925;564;25627;358814;197459
2021-05-16;CAM;51162;23230;27932;32759;17588;815;0;ITF;ITF3;15;Campania;40.83956555;14.25084984;1174;99;1273;78369;79642;-516;919;325178;6816;411636;4685103;3052374
2021-05-16;UMB;5227;2493;2734;5087;50;90;0;ITI;ITI2;10;Umbria;43.10675841;12.38824698;125;21;146;2396;2542;20;139;51704;1372;55618;1246874;367094
2021-05-16;CAL;13820;6743;7077;9919;3846;55;0;ITF;ITF6;18;Calabria;38.90597598;16.59440194;361;21;382;12001;12383;49;224;51133;1116;64632;827038;761861
2021-05-16;LIG;3713;1864;1849;2119;1567;27;0;ITC;ITC3;7;Liguria;44.41149315;8.9326992;280;51;331;2635;2966;-151;80;94534;4282;101782;1537853;616886
2021-05-16;LOM;68744;32520;36224;35548;32238;958;0;ITC;ITC4;3;Lombardia;45.46679409;9.190347404;2053;382;2435;36079;38514;-212;796;753628;33347;825489;10142990;4073166
2021-05-16;EMR;25893;12185;13708;18366;7149;378;0;ITH;ITH5;8;Emilia-Romagna;44.49436681;11.3417208;1042;157;1199;22230;23429;-1290;452;343060;13088;379577;5969945;1831204
2021-05-16;TOS;26692;12895;13797;23926;2470;296;0;ITI;ITI1;9;Toscana;43.76923077;11.25588885;842;175;1017;13254;14271;-260;506;215972;6526;236769;4473632;2131074
2021-05-16;VEN;28422;14015;14407;20313;7081;1028;0;ITH;ITH3;5;Veneto;45.43490485;12.33845213;572;95;667;14949;15616;-278;277;393077;11485;420178;7612358;1727961
2021-05-16;FVG;10028;4803;5225;8376;1407;245;0;ITH;ITH4;6;Friuli-Venezia Giulia;45.6494354;13.76813649;72;16;88;5636;5724;-57;33;97013;3768;106505;1946009;668712
2021-05-16;MAR;10899;4958;5941;6544;4231;124;0;ITI;ITI3;11;Marche;43.61675973;13.5188753;256;47;303;4442;4745;32;215;93288;2991;101024;1191451;709250
2021-05-16;MOL;1286;585;701;1066;185;35;0;ITF;ITF2;14;Molise;41.55774754;14.65916051;20;4;24;325;349;-25;12;12643;485;13477;221832;189438
2021-05-16;PUG;24662;11126;13536;12469;11963;230;0;ITF;ITF4;16;Puglia;41.12559576;16.86736689;1124;127;1251;37467;38718;-18;404;201369;6262;246349;2380773;1162063
2021-05-16;PIE;28240;12812;15428;14768;13093;379;0;ITC;ITC1;1;Piemonte;45.0732745;7.680687483;1250;138;1388;9467;10855;-251;403;333451;11504;355810;4264961;1780444
2021-05-16;PAT;1361;759;602;1043;248;70;0;ITH;ITH2;4;Provincia Autonoma Trento;46.06893511;11.12123097;50;18;68;739;807;-55;51;42632;1349;44788;792374;202449
2021-05-16;PAB;2029;935;1094;1280;694;55;0;ITH;ITH1;4;Provincia Autonoma Bolzano / Bozen;46.49933453;11.35662422;25;6;31;1019;1050;20;108;69750;1168;71968;1450276;404441
2021-05-16;SAR;8252;3839;4413;6001;2162;89;0;ITG;ITG2;20;Sardegna;39.21531192;9.110616306;212;39;251;14150;14401;-58;33;40298;1433;56132;1244081;733184
2021-05-16;SIC;33720;16445;17275;21889;11529;302;0;ITG;ITG1;19;Sicilia;38.11569725;13.3623567;812;118;930;16229;17159;-354;405;197233;5663;220055;4250948;1633067
2021-05-16;LAZ;51045;24582;26463;36915;13527;603;0;ITI;ITI4;12;Lazio;41.89277044;12.48366722;1548;236;1784;31643;33427;-440;577;295041;8006;336474;6618635;4164065
2021-05-17;LAZ;44665;20453;24212;35407;8637;621;0;ITI;ITI4;12;Lazio;41.89277044;12.48366722;1563;235;1798;30946;32744;-683;388;296095;8023;336862;6633335;4170365
2021-05-17;VEN;26553;13002;13551;15642;10081;830;0;ITH;ITH3;5;Veneto;45.43490485;12.33845213;571;95;666;14844;15510;-106;173;393354;11487;420351;7621505;1729661
2021-05-17;PAT;4358;2158;2200;3751;363;244;0;ITH;ITH2;4;Provincia Autonoma Trento;46.06893511;11.12123097;47;18;65;735;800;-7;43;42682;1349;44831;794932;203472
2021-05-17;TOS;29788;14886;14902;20556;8952;280;0;ITI;ITI1;9;Toscana;43.76923077;11.25588885;853;178;1031;13000;14031;-240;382;216579;6541;237151;4482682;2134895
2021-05-17;CAM;49511;21756;27755;23600;25400;511;0;ITF;ITF3;15;Campania;40.83956555;14.25084984;1166;95;1261;77310;78571;-1071;550;326771;6844;412186;4694282;3056506
2021-05-17;SIC;31939;15411;16528;18994;12648;297;0;ITG;ITG1;19;Sicilia;38.11569725;13.3623567;808;112;920;15776;16696;-463;299;197991;5667;220354;4263445;1638497
2021-05-17;SAR;12844;6268;6576;9136;3555;153;0;ITG;ITG2;20;Sardegna;39.21531192;9.110616306;211;39;250;13991;14241;-160;23;40477;1437;56155;1248965;733784
2021-05-17;LIG;12049;5528;6521;8595;3382;72;0;ITC;ITC3;7;Liguria;44.41149315;8.9326992;267;52;319;2642;2961;-5;51;94585;4287;101833;1541242;618008
2021-05-17;FVG;8850;4113;4737;6075;2498;277;0;ITH;ITH4;6;Friuli-Venezia Giulia;45.6494354;13.76813649;72;15;87;5621;5708;-16;16;97045;3768;106521;1947586;669220
2021-05-17;LOM;94704;45381;49323;29504;64451;749;0;ITC;ITC4;3;Lombardia;45.46679409;9.190347404;2028;371;2399;35839;38238;-276;675;754566;33360;826164;10163812;4082150
2021-05-17;PUG;32998;15295;17703;20464;12030;504;0;ITF;ITF4;16;Puglia;41.12559576;16.86736689;1097;126;1223;36404;37627;-1091;145;202584;6283;246494;2385103;1163520
2021-05-17;PAB;3154;1525;1629;2279;697;178;0;ITH;ITH1;4;Provincia Autonoma Bolzano / Bozen;46.49933453;11.35662422;24;7;31;1034;1065;15;65;69800;1168;72033;1455244;405649
2021-05-17;PIE;31033;14655;16378;17392;13218;423;0;ITC;ITC1;1;Piemonte;45.0732745;7.680687483;1179;140;1319;9099;10418;-437;207;334085;11514;356017;4275906;1782891
2021-05-17;ABR;11038;5039;5999;6017;4857;164;0;ITF;ITF1;13;Abruzzo;42.35122196;13.39843823;199;22;221;6747;6968;76;100;63820;2454;73242;1515023;644318
2021-05-17;BAS;5548;2735;2813;3362;2136;50;0;ITF;ITF5;17;Basilicata;40.63947052;15.80514834;107;8;115;4838;4953;-185;17;20127;564;25644;359099;197603
2021-05-17;MAR;12047;5649;6398;7463;4355;229;0;ITI;ITI3;11;Marche;43.61675973;13.5188753;262;48;310;4415;4725;-20;53;93360;2992;101077;1192727;709871
2021-05-17;EMR;32485;15417;17068;22331;9565;589;0;ITH;ITH5;8;Emilia-Romagna;44.49436681;11.3417208;1062;156;1218;21790;23008;-421;342;343813;13097;379918;5981039;1832899
2021-05-17;VDA;809;417;392;365;434;10;0;ITC;ITC2;2;Valle d'Aosta / Vallée d'Aoste;45.73750286;7.320149366;24;5;29;443;472;-44;10;10425;467;11364;122422;60402
2021-05-17;CAL;14911;7464;7447;10130;4723;58;0;ITF;ITF6;18;Calabria;38.90597598;16.59440194;356;23;379;11405;11784;-599;71;51799;1120;64703;828659;763048
2021-05-17;UMB;6380;3068;3312;4114;2180;86;0;ITI;ITI2;10;Umbria;43.10675841;12.38824698;126;18;144;2337;2481;-61;73;51836;1374;55691;1253214;367775
2021-05-17;MOL;2266;1108;1158;1718;498;50;0;ITF;ITF2;14;Molise;41.55774754;14.65916051;18;4;22;312;334;-15;15;12672;486;13492;222443;190042
2021-05-18;ABR;12111;5661;6450;7558;4381;172;0;ITF;ITF1;13;Abruzzo;42.35122196;13.39843823;202;21;223;6654;6877;-91;20;63928;2457;73262;1516215;644584
2021-05-18;MOL;1687;899;788;1016;658;13;0;ITF;ITF2;14;Molise;41.55774754;14.65916051;18;4;22;313;335;1;8;12677;488;13500;222972;190555
2021-05-18;PAB;3365;1765;1600;2079;1191;95;0;ITH;ITH1;4;Provincia Autonoma Bolzano / Bozen;46.49933453;11.35662422;23;7;30;1006;1036;-29;73;69902;1168;72106;1462417;406388
2021-05-18;BAS;5895;2855;3040;3376;2492;27;0;ITF;ITF5;17;Basilicata;40.63947052;15.80514834;100;9;109;4781;4890;-63;84;20271;567;25728;360578;198183
2021-05-18;FVG;10877;5440;5437;8410;2105;362;0;ITH;ITH4;6;Friuli-Venezia Giulia;45.6494354;13.76813649;65;15;80;5494;5574;-134;42;97219;3770;106563;1954857;670566
2021-05-18;PIE;32271;14887;17384;19125;12694;452;0;ITC;ITC1;1;Piemonte;45.0732745;7.680687483;1114;139;1253;8703;9956;-462;437;334963;11535;356454;4297537;1788673
2021-05-18;EMR;29239;13283;15956;18101;10649;489;0;ITH;ITH5;8;Emilia-Romagna;44.49436681;11.3417208;1003;149;1152;21129;22281;-727;331;344858;13107;380246;6005694;1835830
2021-05-18;VDA;972;484;488;348;619;5;0;ITC;ITC2;2;Valle d'Aosta / Vallée d'Aoste;45.73750286;7.320149366;22;4;26;425;451;-21;20;10466;467;11384;123017;60611
2021-05-18;CAM;52280;23285;28995;31817;19732;731;0;ITF;ITF3;15;Campania;40.83956555;14.25084984;1118;96;1214;76015;77229;-1342;598;328681;6874;412784;4714048;3066073
2021-05-18;LOM;88267;42188;46079;31861;55602;804;0;ITC;ITC4;3;Lombardia;45.46679409;9.190347404;1992;353;2345;35468;37813;-425;598;755558;33391;826762;10196842;4094111
2021-05-18;PAT;4325;2048;2277;3170;870;285;0;ITH;ITH2;4;Provincia Autonoma Trento;46.06893511;11.12123097;48;17;65;708;773;-27;83;42790;1351;44914;796823;204229
2021-05-18;SAR;14796;7392;7404;9417;5227;152;0;ITG;ITG2;20;Sardegna;39.21531192;9.110616306;205;40;245;13749;13994;-247;61;40784;1438;56216;1251222;735665
2021-05-18;SIC;36147;17401;18746;23244;12493;410;0;ITG;ITG1;19;Sicilia;38.11569725;13.3623567;786;108;894;15399;16293;-403;411;198783;5689;220765;4287835;1646087
2021-05-18;VEN;27041;12550;14491;12630;13646;765;0;ITH;ITH3;5;Veneto;45.43490485;12.33845213;546;88;634;13847;14481;-1029;306;394677;11499;420657;7652714;1732587
2021-05-18;CAL;15345;7678;7667;11848;3428;69;0;ITF;ITF6;18;Calabria;38.90597598;16.59440194;347;26;373;11115;11488;-296;108;52203;1120;64811;831812;765740
2021-05-18;MAR;11273;5348;5925;7489;3603;181;0;ITI;ITI3;11;Marche;43.61675973;13.5188753;233;47;280;4403;4683;-42;115;93513;2996;101192;1196262;711716
2021-05-18;PUG;29012;13493;15519;15774;12927;311;0;ITF;ITF4;16;Puglia;41.12559576;16.86736689;1035;124;1159;35630;36789;-838;407;203808;6304;246901;2396787;1166599
2021-05-18;LAZ;45151;20660;24491;34884;9644;623;0;ITI;ITI4;12;Lazio;41.89277044;12.48366722;1519;216;1735;30320;32055;-689;348;297118;8037;337210;6661551;4183955
2021-05-18;LIG;13504;6136;7368;10060;3316;128;0;ITC;ITC3;7;Liguria;44.41149315;8.9326992;251;50;301;2500;2801;-160;80;94818;4294;101913;1547511;619938
2021-05-18;TOS;28855;14281;14574;19766;8836;253;0;ITI;ITI1;9;Toscana;43.76923077;11.25588885;802;167;969;12963;13932;-99;291;216951;6559;237442;4502395;2141135
2021-05-18;UMB;7767;3364;4403;3836;3841;90;0;ITI;ITI2;10;Umbria;43.10675841;12.38824698;122;16;138;2268;2406;-75;54;51962;1377;55745;1260825;368450
2021-05-19;PIE;33236;15350;17886;21485;11147;604;0;ITC;ITC1;1;Piemonte;45.0732745;7.680687483;1075;133;1208;8212;9420;-536;515;336000;11549;356969;4317740;1794289
2021-05-19;SAR;17084;8682;8402;12632;4281;171;0;ITG;ITG2;20;Sardegna;39.21531192;9.110616306;195;38;233;13536;13769;-225;69;41074;1442;56285;1260322;738183
2021-05-19;UMB;9432;4219;5213;5599;3745;88;0;ITI;ITI2;10;Umbria;43.10675841;12.38824698;124;16;140;2243;2383;-23;59;52044;1377;55804;1265968;369014
2021-05-19;FVG;12143;5997;6146;9324;2381;438;0;ITH;ITH4;6;Friuli-Venezia Giulia;45.6494354;13.76813649;64;13;77;5365;5442;-132;56;97404;3773;106619;1963889;672410
2021-05-19;SIC;42920;20779;22141;28197;14339;384;0;ITG;ITG1;19;Sicilia;38.11569725;13.3623567;733;107;840;14428;15268;-1025;603;200401;5699;221368;4309302;1653792
2021-05-19;LAZ;47359;21759;25600;36472;10190;697;0;ITI;ITI4;12;Lazio;41.89277044;12.48366722;1454;215;1669;28956;30625;-1430;466;298998;8053;337676;6694996;4199925
2021-05-19;EMR;33846;14999;18847;18043;15270;533;0;ITH;ITH5;8;Emilia-Romagna;44.49436681;11.3417208;937;145;1082;20932;22014;-267;328;345439;13116;380569;6028815;1838727
2021-05-19;CAM;51310;22660;28650;33755;16759;796;0;ITF;ITF3;15;Campania;40.83956555;14.25084984;1081;93;1174;75151;76325;-904;634;330200;6893;413418;4733546;3076937
2021-05-19;LOM;83318;39793;43525;33123;49384;811;0;ITC;ITC4;3;Lombardia;45.46679409;9.190347404;1920;337;2257;34985;37242;-571;936;757040;33416;827698;10245843;4109666
2021-05-19;PAT;5197;2515;2682;3670;1274;253;0;ITH;ITH2;4;Provincia Autonoma Trento;46.06893511;11.12123097;47;15;62;697;759;-14;15;42817;1353;44929;797180;204372
2021-05-19;TOS;27981;13590;14391;18644;9070;267;0;ITI;ITI1;9;Toscana;43.76923077;11.25588885;759;170;929;12544;13473;-459;341;217735;6575;237783;4523950;2147743
2021-05-19;VEN;33169;15188;17981;16228;16000;941;0;ITH;ITH3;5;Veneto;45.43490485;12.33845213;523;84;607;13013;13620;-861;333;395863;11507;420990;7687269;1735714
2021-05-19;PUG;26523;12817;13706;19579;6505;439;0;ITF;ITF4;16;Puglia;41.12559576;16.86736689;991;127;1118;34643;35761;-1028;433;205261;6312;247334;2406397;1168478
2021-05-19;VDA;993;498;495;410;575;8;0;ITC;ITC2;2;Valle d'Aosta / Vallée d'Aoste;45.73750286;7.320149366;22;3;25;417;442;-9;9;10483;468;11393;123438;60688
2021-05-19;ABR;10736;5126;5610;7572;3037;127;0;ITF;ITF1;13;Abruzzo;42.35122196;13.39843823;199;18;217;6197;6414;-463;33;64421;2460;73295;1522100;645802
2021-05-19;BAS;2873;1499;1374;1183;1677;13;0;ITF;ITF5;17;Basilicata;40.63947052;15.80514834;91;6;97;4658;4755;-135;67;20471;569;25795;361859;198692
2021-05-19;PAB;3888;1997;1891;1959;1789;140;0;ITH;ITH1;4;Provincia Autonoma Bolzano / Bozen;46.49933453;11.35662422;21;7;28;1002;1030;-6;58;69966;1168;72164;1470371;406655
2021-05-19;MOL;2411;1231;1180;1909;433;69;0;ITF;ITF2;14;Molise;41.55774754;14.65916051;18;4;22;292;314;-21;14;12712;488;13514;223544;191112
2021-05-19;CAL;18326;9082;9244;11256;6993;77;0;ITF;ITF6;18;Calabria;38.90597598;16.59440194;340;27;367;10839;11206;-282;228;52711;1122;65039;835122;768717
2021-05-19;LIG;13587;5967;7620;10326;3129;132;0;ITC;ITC3;7;Liguria;44.41149315;8.9326992;231;47;278;2387;2665;-136;85;95037;4296;101998;1553819;621776
2021-05-19;MAR;11668;5364;6304;8364;3103;201;0;ITI;ITI3;11;Marche;43.61675973;13.5188753;216;44;260;4350;4610;-73;130;93716;2996;101322;1200325;713798
2021-05-20;PAB;4975;2502;2473;3339;1480;156;0;ITH;ITH1;4;Provincia Autonoma Bolzano / Bozen;46.49933453;11.35662422;18;6;24;981;1005;-25;61;70052;1168;72225;1473701;407924
2021-05-20;MAR;12686;5962;6724;7537;4898;251;0;ITI;ITI3;11;Marche;43.61675973;13.5188753;195;41;236;4336;4572;-38;214;93966;2998;101536;1204159;715963
2021-05-20;PUG;33754;15317;18437;20768;12472;514;0;ITF;ITF4;16;Puglia;41.12559576;16.86736689;916;111;1027;33178;34205;-1556;386;207173;6342;247720;2415076;1170315
2021-05-20;MOL;2752;1418;1334;2424;190;138;0;ITF;ITF2;14;Molise;41.55774754;14.65916051;19;4;23;269;292;-22;1;12735;488;13515;223718;191286
2021-05-20;ABR;12825;5933;6892;7429;5268;128;0;ITF;ITF1;13;Abruzzo;42.35122196;13.39843823;200;18;218;5877;6095;-319;72;64806;2465;73366;1527887;646971
2021-05-20;LAZ;51991;25094;26897;37285;14013;693;0;ITI;ITI4;12;Lazio;41.89277044;12.48366722;1394;210;1604;28534;30138;-487;558;300033;8063;338234;6719994;4214291
2021-05-20;CAL;17000;8509;8491;11271;5660;69;0;ITF;ITF6;18;Calabria;38.90597598;16.59440194;325;27;352;10771;11123;-83;263;53052;1127;65302;838283;770909
2021-05-20;BAS;5886;2981;2905;2886;2972;28;0;ITF;ITF5;17;Basilicata;40.63947052;15.80514834;92;5;97;4622;4719;-36;53;20560;569;25848;362993;199125
2021-05-20;EMR;40417;18347;22070;18393;21504;520;0;ITH;ITH5;8;Emilia-Romagna;44.49436681;11.3417208;887;137;1024;20683;21707;-307;464;346200;13122;381029;6050514;1841218
2021-05-20;VEN;44861;21265;23596;19370;24381;1110;0;ITH;ITH3;5;Veneto;45.43490485;12.33845213;486;74;560;12086;12646;-974;293;397122;11515;421283;7719542;1738592
2021-05-20;LOM;95627;46248;49379;31718;63092;817;0;ITC;ITC4;3;Lombardia;45.46679409;9.190347404;1755;316;2071;34312;36383;-859;1003;758880;33438;828701;10289952;4124301
2021-05-20;TOS;29789;13930;15859;18640;10864;285;0;ITI;ITI1;9;Toscana;43.76923077;11.25588885;719;158;877;11985;12862;-611;559;218890;6590;238342;4545995;2155892
2021-05-20;SIC;44106;21134;22972;27752;15937;417;0;ITG;ITG1;19;Sicilia;38.11569725;13.3623567;704;104;808;14205;15013;-255;443;201089;5709;221811;4327213;1661680
2021-05-20;LIG;12951;6009;6942;8787;4042;122;0;ITC;ITC3;7;Liguria;44.41149315;8.9326992;223;43;266;2061;2327;-338;111;95483;4299;102109;1560274;623819
2021-05-20;CAM;61063;28279;32784;42249;17823;991;0;ITF;ITF3;15;Campania;40.83956555;14.25084984;1061;93;1154;74206;75360;-965;649;331774;6933;414067;4751115;3084358
2021-05-20;SAR;16415;7895;8520;11291;4915;209;0;ITG;ITG2;20;Sardegna;39.21531192;9.110616306;194;37;231;13438;13669;-100;47;41221;1442;56332;1264856;740211
2021-05-20;PAT;5129;2409;2720;3154;1690;285;0;ITH;ITH2;4;Provincia Autonoma Trento;46.06893511;11.12123097;46;14;60;619;679;-80;36;42933;1353;44965;798985;205094
2021-05-20;FVG;12745;6339;6406;9800;2535;410;0;ITH;ITH4;6;Friuli-Venezia Giulia;45.6494354;13.76813649;60;11;71;5329;5400;-42;41;97485;3775;106660;1969152;673667
2021-05-20;PIE;38739;17998;20741;13378;24998;363;0;ITC;ITC1;1;Piemonte;45.0732745;7.680687483;1001;121;1122;7915;9037;-383;426;336799;11559;357395;4336262;1799662
2021-05-20;VDA;1045;475;570;592;440;13;0;ITC;ITC2;2;Valle d'Aosta / Vallée d'Aoste;45.73750286;7.320149366;26;3;29;358;387;-55;9;10546;469;11402;124283;60978
2021-05-20;UMB;9874;4610;5264;6106;3658;110;0;ITI;ITI2;10;Umbria;43.10675841;12.38824698;114;17;131;2196;2327;-56;15;52114;1378;55819;1266969;369197
2021-05-21;BAS;4578;2321;2257;1480;3086;12;0;ITF;ITF5;17;Basilicata;40.63947052;15.80514834;86;5;91;4508;4599;-120;62;20741;570;25910;364112;199545
2021-05-21;FVG;11339;5071;6268;7918;3072;349;0;ITH;ITH4;6;Friuli-Venezia Giulia;45.6494354;13.76813649;55;12;67;5260;5327;-73;38;97594;3777;106698;1975937;674907
2021-05-21;VDA;933;443;490;523;401;9;0;ITC;ITC2;2;Valle d'Aosta / Vallée d'Aoste;45.73750286;7.320149366;23;0;23;331;354;-33;23;10600;471;11425;124827;61170
2021-05-21;LOM;93944;45285;48659;28393;64790;761;0;ITC;ITC4;3;Lombardia;45.46679409;9.190347404;1662;308;1970;34251;36221;-162;847;759878;33449;829548;10335010;4139148
2021-05-21;CAM;63878;29655;34223;42140;20708;1030;0;ITF;ITF3;15;Campania;40.83956555;14.25084984;1042;87;1129;73199;74328;-1032;705;333404;7040;414772;4771343;3095922
2021-05-21;SIC;48725;23084;25641;26668;21630;427;0;ITG;ITG1;19;Sicilia;38.11569725;13.3623567;679;99;778;13237;14015;-998;493;202569;5720;222304;4353548;1670121
2021-05-21;UMB;8983;3673;5310;4068;4831;84;0;ITI;ITI2;10;Umbria;43.10675841;12.38824698;113;17;130;2213;2343;16;69;52166;1379;55888;1274521;369965
2021-05-21;PIE;36312;16871;19441;20099;15686;527;0;ITC;ITC1;1;Piemonte;45.0732745;7.680687483;938;106;1044;7512;8556;-481;393;337659;11573;357788;4359195;1804536
2021-05-21;PAT;5219;2507;2712;3136;1809;274;0;ITH;ITH2;4;Provincia Autonoma Trento;46.06893511;11.12123097;42;13;55;591;646;-33;59;43024;1354;45024;801097;205938
2021-05-21;MOL;2492;1263;1229;1970;367;155;0;ITF;ITF2;14;Molise;41.55774754;14.65916051;18;4;22;260;282;-10;3;12748;488;13518;224193;191687
2021-05-21;SAR;22805;11237;11568;16392;6133;280;0;ITG;ITG2;20;Sardegna;39.21531192;9.110616306;186;35;221;13319;13540;-129;42;41389;1445;56374;1268040;741736
2021-05-21;TOS;28964;13504;15460;17226;11481;257;0;ITI;ITI1;9;Toscana;43.76923077;11.25588885;689;148;837;11451;12288;-574;392;219845;6601;238734;4566549;2163188
2021-05-21;CAL;21379;10888;10491;13859;7411;109;0;ITF;ITF6;18;Calabria;38.90597598;16.59440194;314;27;341;10799;11140;17;253;53284;1131;65555;841708;773638
2021-05-21;PUG;39285;18662;20623;28290;10201;794;0;ITF;ITF4;16;Puglia;41.12559576;16.86736689;889;102;991;32156;33147;-1058;365;208578;6360;248085;2423491;1172514
2021-05-21;LAZ;52187;25111;27076;37314;14158;715;0;ITI;ITI4;12;Lazio;41.89277044;12.48366722;1323;205;1528;27399;28927;-1211;471;301704;8074;338705;6749653;4227485
2021-05-21;PAB;7397;4066;3331;5212;1879;306;0;ITH;ITH1;4;Provincia Autonoma Bolzano / Bozen;46.49933453;11.35662422;18;1;19;960;979;-26;3;70081;1168;72228;1474684;408159
2021-05-21;LIG;12875;5968;6907;9606;3136;133;0;ITC;ITC3;7;Liguria;44.41149315;8.9326992;203;45;248;1913;2161;-166;70;95715;4303;102179;1566221;625963
2021-05-21;MAR;13910;6594;7316;7225;6472;213;0;ITI;ITI3;11;Marche;43.61675973;13.5188753;194;40;234;4312;4546;-26;176;94166;3000;101712;1207327;717590
2021-05-21;ABR;13018;6329;6689;7863;4979;176;0;ITF;ITF1;13;Abruzzo;42.35122196;13.39843823;181;16;197;5746;5943;-152;62;65021;2463;73427;1532738;648028
2021-05-21;EMR;39389;17563;21826;21633;17134;622;0;ITH;ITH5;8;Emilia-Romagna;44.49436681;11.3417208;851;127;978;20230;21208;-499;412;347102;13129;381439;6072313;1843298
2021-05-21;VEN;44869;22068;22801;19797;23960;1112;0;ITH;ITH3;5;Veneto;45.43490485;12.33845213;456;71;527;11264;11791;-855;274;398245;11521;421557;7750837;1741225
2021-05-22;TOS;26037;12667;13370;21489;4299;249;0;ITI;ITI1;9;Toscana;43.76923077;11.25588885;652;144;796;10756;11552;-736;358;220923;6617;239092;4588599;2170605
2021-05-22;LIG;6657;3222;3435;4879;1687;91;0;ITC;ITC3;7;Liguria;44.41149315;8.9326992;194;43;237;1811;2048;-113;60;95887;4304;102239;1571719;627674
2021-05-22;VEN;34847;16711;18136;12717;21455;675;0;ITH;ITH3;5;Veneto;45.43490485;12.33845213;437;72;509;10787;11296;-495;234;398970;11525;421791;7786476;1745152
2021-05-22;LOM;70700;33876;36824;31734;38250;716;0;ITC;ITC4;3;Lombardia;45.46679409;9.190347404;1566;298;1864;33552;35416;-805;828;761498;33462;830376;10382386;4154385
2021-05-22;PAT;3375;1666;1709;849;2435;91;0;ITH;ITH2;4;Provincia Autonoma Trento;46.06893511;11.12123097;37;14;51;612;663;17;43;43050;1354;45067;803200;206780
2021-05-22;MAR;11941;5720;6221;7321;4449;171;0;ITI;ITI3;11;Marche;43.61675973;13.5188753;186;39;225;4305;4530;-16;125;94303;3004;101837;1211675;719235
2021-05-22;CAL;22208;10565;11643;14213;7904;91;0;ITF;ITF6;18;Calabria;38.90597598;16.59440194;294;24;318;10855;11173;33;161;53407;1136;65716;844539;776180
2021-05-22;PUG;34808;15932;18876;23668;10595;545;0;ITF;ITF4;16;Puglia;41.12559576;16.86736689;863;100;963;31831;32794;-353;399;209321;6369;248484;2432468;1174777
2021-05-22;PAB;6844;3572;3272;4462;2169;213;0;ITH;ITH1;4;Provincia Autonoma Bolzano / Bozen;46.49933453;11.35662422;21;6;27;917;944;-35;85;70201;1168;72313;1482728;409043
2021-05-22;BAS;5493;2725;2768;1929;3553;11;0;ITF;ITF5;17;Basilicata;40.63947052;15.80514834;84;5;89;4453;4542;-57;67;20865;570;25977;365356;199999
2021-05-22;ABR;13161;6393;6768;8130;4919;112;0;ITF;ITF1;13;Abruzzo;42.35122196;13.39843823;182;15;197;5633;5830;-113;67;65198;2465;73493;1536846;648931
2021-05-22;MOL;4411;2275;2136;4192;180;39;0;ITF;ITF2;14;Molise;41.55774754;14.65916051;18;4;22;241;263;-19;11;12778;488;13529;224852;192322
2021-05-22;SAR;25074;12017;13057;19581;5188;305;0;ITG;ITG2;20;Sardegna;39.21531192;9.110616306;184;32;216;13268;13484;-56;35;41479;1446;56409;1270593;743869
2021-05-22;CAM;68135;32558;35577;45597;21662;876;0;ITF;ITF3;15;Campania;40.83956555;14.25084984;1011;82;1093;71438;72531;-1797;565;335737;7069;415337;4790260;3105946
2021-05-22;EMR;33183;14163;19020;16473;16253;457;0;ITH;ITH5;8;Emilia-Romagna;44.49436681;11.3417208;791;126;917;18421;19338;-1870;340;349298;13140;381776;6097541;1846477
2021-05-22;LAZ;55249;27077;28172;43656;10724;869;0;ITI;ITI4;12;Lazio;41.89277044;12.48366722;1283;195;1478;26856;28334;-593;494;302784;8081;339199;6787939;4243241
2021-05-22;SIC;48030;22812;25218;28301;19330;399;0;ITG;ITG1;19;Sicilia;38.11569725;13.3623567;662;104;766;12501;13267;-748;350;203650;5737;222654;4372749;1676182
2021-05-22;UMB;6986;2762;4224;2603;4334;49;0;ITI;ITI2;10;Umbria;43.10675841;12.38824698;106;16;122;2126;2248;-95;47;52306;1381;55935;1281380;370686
2021-05-22;VDA;956;505;451;545;401;10;0;ITC;ITC2;2;Valle d'Aosta / Vallée d'Aoste;45.73750286;7.320149366;23;0;23;321;344;-10;18;10628;471;11443;125323;61313
2021-05-22;FVG;11605;5209;6396;7085;4243;277;0;ITH;ITH4;6;Friuli-Venezia Giulia;45.6494354;13.76813649;50;10;60;5228;5288;-39;39;97672;3777;106737;1982137;676545
2021-05-22;PIE;33600;15173;18427;16933;16253;414;0;ITC;ITC1;1;Piemonte;45.0732745;7.680687483;893;105;998;7211;8209;-347;400;338402;11577;358188;4384479;1810272
2021-05-23;VDA;999;465;534;653;340;6;0;ITC;ITC2;2;Valle d'Aosta / Vallée d'Aoste;45.73750286;7.320149366;22;0;22;303;325;-19;13;10660;471;11456;125746;61456
2021-05-23;ABR;9880;4693;5187;7067;2692;121;0;ITF;ITF1;13;Abruzzo;42.35122196;13.39843823;179;17;196;5705;5901;71;128;65254;2466;73621;1541732;650079
2021-05-23;CAL;11394;5555;5839;6993;4357;44;0;ITF;ITF6;18;Calabria;38.90597598;16.59440194;285;28;313;10894;11207;34;165;53536;1138;65881;847263;778722
2021-05-23;UMB;5074;1857;3217;637;4421;16;0;ITI;ITI2;10;Umbria;43.10675841;12.38824698;96;15;111;2083;2194;-54;45;52403;1383;55980;1287262;371307
2021-05-23;EMR;25508;11869;13639;13582;11609;317;0;ITH;ITH5;8;Emilia-Romagna;44.49436681;11.3417208;766;122;888;18194;19082;-256;299;349845;13146;382073;6110226;1848737
2021-05-23;LIG;2310;1121;1189;1172;1124;14;0;ITC;ITC3;7;Liguria;44.41149315;8.9326992;190;43;233;1694;1927;-121;58;96065;4305;102297;1575333;628747
2021-05-23;CAM;58766;28649;30117;37205;20907;654;0;ITF;ITF3;15;Campania;40.83956555;14.25084984;967;85;1052;70986;72038;-493;628;336853;7074;415965;4807482;3115570
2021-05-23;PAT;1995;1015;980;430;1535;30;0;ITH;ITH2;4;Provincia Autonoma Trento;46.06893511;11.12123097;34;14;48;572;620;-43;35;43128;1354;45102;805406;207662
2021-05-23;FVG;10299;4871;5428;5923;4159;217;0;ITH;ITH4;6;Friuli-Venezia Giulia;45.6494354;13.76813649;57;9;66;5176;5242;-46;31;97748;3778;106768;1986180;677947
2021-05-23;PIE;28837;13178;15659;15492;13023;322;0;ITC;ITC1;1;Piemonte;45.0732745;7.680687483;861;108;969;6959;7928;-281;271;338952;11579;358459;4395668;1813883
2021-05-23;MAR;9210;4284;4926;7414;1672;124;0;ITI;ITI3;11;Marche;43.61675973;13.5188753;176;36;212;4296;4508;-22;107;94432;3004;101944;1215413;721124
2021-05-23;PAB;4344;2306;2038;4136;8;200;0;ITH;ITH1;4;Provincia Autonoma Bolzano / Bozen;46.49933453;11.35662422;19;6;25;904;929;-15;70;70285;1169;72383;1488474;409671
2021-05-23;TOS;28445;13678;14767;25612;2563;270;0;ITI;ITI1;9;Toscana;43.76923077;11.25588885;625;135;760;10539;11299;-253;382;221550;6625;239474;4605433;2176978
2021-05-23;PUG;17994;8415;9579;13891;3843;260;0;ITF;ITF4;16;Puglia;41.12559576;16.86736689;838;95;933;31796;32729;-65;274;209640;6389;248758;2438845;1175933
2021-05-23;VEN;34492;16470;18022;10619;23400;473;0;ITH;ITH3;5;Veneto;45.43490485;12.33845213;444;68;512;10638;11150;-146;133;399246;11528;421924;7803799;1746969
2021-05-23;MOL;1799;905;894;1753;10;36;0;ITF;ITF2;14;Molise;41.55774754;14.65916051;15;5;20;226;246;-17;6;12801;488;13535;225330;192794
2021-05-23;BAS;4518;2302;2216;1527;2984;7;0;ITF;ITF5;17;Basilicata;40.63947052;15.80514834;82;6;88;4423;4511;-31;38;20934;570;26015;366198;200324
2021-05-23;LAZ;47204;22906;24298;39086;7422;696;0;ITI;ITI4;12;Lazio;41.89277044;12.48366722;1255;194;1449;26180;27629;-705;413;303893;8090;339612;6809179;4253650
2021-05-23;SAR;10037;4817;5220;7685;2255;97;0;ITG;ITG2;20;Sardegna;39.21531192;9.110616306;182;33;215;13209;13424;-60;20;41559;1446;56429;1273431;745185
2021-05-23;SIC;34113;16609;17504;19856;14028;229;0;ITG;ITG1;19;Sicilia;38.11569725;13.3623567;618;102;720;12208;12928;-339;238;204225;5739;222892;4383759;1680917
2021-05-23;LOM;60825;28967;31858;26295;34017;513;0;ITC;ITC4;3;Lombardia;45.46679409;9.190347404;1480;294;1774;33847;35621;205;711;761995;33471;831087;10415363;4167016
2021-05-24;FVG;11488;5561;5927;7530;3654;304;0;ITH;ITH4;6;Friuli-Venezia Giulia;45.6494354;13.76813649;58;9;67;5166;5233;-9;2;97759;3778;106770;1987593;678374
2021-05-24;PIE;29038;13445;15593;16657;11992;389;0;ITC;ITC1;1;Piemonte;45.0732745;7.680687483;832;101;933;6729;7662;-266;106;339316;11587;358565;4406904;1816314
2021-05-24;EMR;30013;13740;16273;17967;11530;516;0;ITH;ITH5;8;Emilia-Romagna;44.49436681;11.3417208;763;123;886;17635;18521;-561;315;350713;13153;382387;6120434;1849967
2021-05-24;LOM;89627;43530;46097;48601;40088;938;0;ITC;ITC4;3;Lombardia;45.46679409;9.190347404;1473;284;1757;33883;35640;19;249;762218;33478;831336;10428882;4173990
2021-05-24;SIC;35894;17454;18440;15596;20065;233;0;ITG;ITG1;19;Sicilia;38.11569725;13.3623567;601;98;699;12317;13016;88;378;204507;5747;223270;4394953;1685738
2021-05-24;UMB;9079;4521;4558;8031;882;166;0;ITI;ITI2;10;Umbria;43.10675841;12.38824698;89;12;101;1996;2097;-97;45;52542;1386;56025;1293232;371875
2021-05-24;SAR;14491;7259;7232;8360;5999;132;0;ITG;ITG2;20;Sardegna;39.21531192;9.110616306;184;29;213;13110;13323;-101;20;41678;1448;56449;1279682;745847
2021-05-24;CAM;31363;15157;16206;15851;15159;353;0;ITF;ITF3;15;Campania;40.83956555;14.25084984;916;83;999;70271;71270;-768;401;337994;7102;416366;4814792;3117616
2021-05-24;PAT;4494;2078;2416;1268;3110;116;0;ITH;ITH2;4;Provincia Autonoma Trento;46.06893511;11.12123097;32;13;45;566;611;-9;24;43161;1354;45126;807799;208619
2021-05-24;VEN;33095;16436;16659;7629;25055;411;0;ITH;ITH3;5;Veneto;45.43490485;12.33845213;429;68;497;10558;11055;-95;150;399489;11530;422074;7814228;1748250
2021-05-24;CAL;17786;8910;8876;9935;7770;81;0;ITF;ITF6;18;Calabria;38.90597598;16.59440194;283;29;312;10582;10894;-313;70;53917;1140;65951;848599;779943
2021-05-24;TOS;33770;16734;17036;23901;9589;280;0;ITI;ITI1;9;Toscana;43.76923077;11.25588885;608;133;741;10208;10949;-350;245;222131;6639;239719;4613991;2180231
2021-05-24;LAZ;44082;20230;23852;33540;9873;669;0;ITI;ITI4;12;Lazio;41.89277044;12.48366722;1219;194;1413;25234;26647;-982;292;305156;8101;339904;6822963;4259089
2021-05-24;MAR;11001;5193;5808;7958;2866;177;0;ITI;ITI3;11;Marche;43.61675973;13.5188753;169;36;205;4296;4501;-7;58;94495;3006;102002;1215626;721577
2021-05-24;PUG;36257;17101;19156;24517;11128;612;0;ITF;ITF4;16;Puglia;41.12559576;16.86736689;808;95;903;30866;31769;-960;71;210660;6400;248829;2442965;1176735
2021-05-24;VDA;1142;519;623;678;448;16;0;ITC;ITC2;2;Valle d'Aosta / Vallée d'Aoste;45.73750286;7.320149366;18;0;18;297;315;-10;28;10698;471;11484;126418;61681
2021-05-24;MOL;1993;866;1127;1283;677;33;0;ITF;ITF2;14;Molise;41.55774754;14.65916051;16;5;21;212;233;-13;9;12823;488;13544;225819;193266
2021-05-24;LIG;11896;5597;6299;9283;2513;100;0;ITC;ITC3;7;Liguria;44.41149315;8.9326992;184;40;224;1583;1807;-120;61;96243;4308;102358;1578717;629971
2021-05-24;ABR;12226;5841;6385;8729;3341;156;0;ITF;ITF1;13;Abruzzo;42.35122196;13.39843823;178;17;195;5772;5967;66;68;65254;2468;73689;1546045;651143
2021-05-24;BAS;4833;2344;2489;1087;3733;13;0;ITF;ITF5;17;Basilicata;40.63947052;15.80514834;78;6;84;4324;4408;-103;4;21041;570;26019;366432;200440
2021-05-24;PAB;1459;769;690;1051;335;73;0;ITH;ITH1;4;Provincia Autonoma Bolzano / Bozen;46.49933453;11.35662422;19;6;25;910;935;6;57;70335;1170;72440;1493515;410337
2021-05-25;PAB;3900;2024;1876;2903;889;108;0;ITH;ITH1;4;Provincia Autonoma Bolzano / Bozen;46.49933453;11.35662422;15;6;21;868;889;-46;56;70436;1171;72496;1500159;411054
2021-05-25;PUG;34878;16284;18594;20583;13709;586;0;ITF;ITF4;16;Puglia;41.12559576;16.86736689;759;88;847;29786;30633;-1136;314;212082;6428;249143;2452254;1179100
2021-05-25;MOL;1988;895;1093;1311;636;41;0;ITF;ITF2;14;Molise;41.55774754;14.65916051;15;5;20;203;223;-10;3;12836;488;13547;226201;193642
2021-05-25;VEN;27875;13455;14420;11272;16099;504;0;ITH;ITH3;5;Veneto;45.43490485;12.33845213;400;66;466;10065;10531;-524;159;400170;11532;422233;7848659;1750844
2021-05-25;VDA;1118;532;586;530;576;12;0;ITC;ITC2;2;Valle d'Aosta / Vallée d'Aoste;45.73750286;7.320149366;16;0;16;279;295;-20;15;10733;471;11499;126900;61859
2021-05-25;BAS;4201;2115;2086;869;3322;10;0;ITF;ITF5;17;Basilicata;40.63947052;15.80514834;81;5;86;4240;4326;-82;50;21172;571;26069;367654;200926
2021-05-25;FVG;12963;6408;6555;9287;3329;347;0;ITH;ITH4;6;Friuli-Venezia Giulia;45.6494354;13.76813649;56;9;65;5072;5137;-96;34;97887;3780;106804;1994052;679768
2021-05-25;EMR;25246;11240;14006;11300;13516;430;0;ITH;ITH5;8;Emilia-Romagna;44.49436681;11.3417208;730;116;846;16976;17822;-699;161;351559;13163;382544;6143162;1852285
2021-05-25;PIE;31953;14807;17146;15650;15904;399;0;ITC;ITC1;1;Piemonte;45.0732745;7.680687483;808;94;902;6299;7201;-461;274;340038;11600;358839;4431656;1820979
2021-05-25;ABR;11420;5324;6096;8082;3140;198;0;ITF;ITF1;13;Abruzzo;42.35122196;13.39843823;183;17;200;5708;5908;-59;15;65327;2469;73704;1547612;651427
2021-05-25;SAR;15160;7704;7456;8495;6489;176;0;ITG;ITG2;20;Sardegna;39.21531192;9.110616306;167;29;196;12985;13181;-142;28;41847;1449;56477;1287168;747465
2021-05-25;TOS;34212;16518;17694;19295;14644;273;0;ITI;ITI1;9;Toscana;43.76923077;11.25588885;568;134;702;9724;10426;-523;215;222862;6646;239934;4632701;2186521
2021-05-25;PAT;4871;2317;2554;1743;2976;152;0;ITH;ITH2;4;Provincia Autonoma Trento;46.06893511;11.12123097;35;13;48;552;600;-11;52;43224;1354;45178;809433;209273
2021-05-25;MAR;11769;5798;5971;8497;3052;220;0;ITI;ITI3;11;Marche;43.61675973;13.5188753;151;36;187;4285;4472;-29;77;94598;3009;102079;1218572;722926
2021-05-25;LIG;14285;6960;7325;10961;3198;126;0;ITC;ITC3;7;Liguria;44.41149315;8.9326992;164;41;205;1353;1558;-249;47;96535;4312;102405;1584682;631862
2021-05-25;CAL;16429;8047;8382;10216;6126;87;0;ITF;ITF6;18;Calabria;38.90597598;16.59440194;281;22;303;10295;10598;-296;113;54316;1150;66064;851758;782885
2021-05-25;CAM;46578;22433;24145;22549;23460;569;0;ITF;ITF3;15;Campania;40.83956555;14.25084984;861;81;942;69481;70423;-847;410;339214;7139;416776;4833179;3125048
2021-05-25;LOM;91234;43650;47584;43860;46550;824;0;ITC;ITC4;3;Lombardia;45.46679409;9.190347404;1453;272;1725;32853;34578;-1062;505;763768;33495;831841;10461328;4185494
2021-05-25;LAZ;47674;22388;25286;35294;11751;629;0;ITI;ITI4;12;Lazio;41.89277044;12.48366722;1176;185;1361;23790;25151;-1496;308;306944;8117;340212;6850710;4271585
2021-05-25;UMB;8827;4304;4523;7588;1066;173;0;ITI;ITI2;10;Umbria;43.10675841;12.38824698;80;12;92;1938;2030;-67;36;52643;1388;56061;1299161;372406
2021-05-25;SIC;33581;15443;18138;13945;19379;257;0;ITG;ITG1;19;Sicilia;38.11569725;13.3623567;575;93;668;11936;12604;-412;372;205280;5758;223642;4414288;1692464
2021-05-26;EMR;33349;14757;18592;9923;23040;386;0;ITH;ITH5;8;Emilia-Romagna;44.49436681;11.3417208;689;109;798;16736;17534;-288;224;352065;13167;382766;6166700;1854870
2021-05-26;LAZ;47709;21945;25764;34843;12169;697;0;ITI;ITI4;12;Lazio;41.89277044;12.48366722;1106;177;1283;22435;23718;-1433;318;308677;8135;340530;6877036;4283920
2021-05-26;CAL;18754;9340;9414;10336;8326;92;0;ITF;ITF6;18;Calabria;38.90597598;16.59440194;274;21;295;10277;10572;-26;205;54543;1154;66269;855306;786175
2021-05-26;UMB;9667;4574;5093;8221;1254;192;0;ITI;ITI2;10;Umbria;43.10675841;12.38824698;78;13;91;1876;1967;-63;40;52745;1389;56101;1304128;373026
2021-05-26;CAM;52749;25882;26867;21110;31162;477;0;ITF;ITF3;15;Campania;40.83956555;14.25084984;833;81;914;68683;69597;-826;483;340515;7147;417259;4851768;3134052
2021-05-26;SAR;15551;8197;7354;9708;5661;182;0;ITG;ITG2;20;Sardegna;39.21531192;9.110616306;169;21;190;12883;13073;-108;34;41985;1453;56511;1289720;749088
2021-05-26;FVG;13506;6747;6759;9653;3493;360;0;ITH;ITH4;6;Friuli-Venezia Giulia;45.6494354;13.76813649;46;10;56;5007;5063;-74;30;97989;3782;106834;2001356;681223
2021-05-26;PIE;34252;15783;18469;15365;18521;366;0;ITC;ITC1;1;Piemonte;45.0732745;7.680687483;771;97;868;5844;6712;-489;350;340872;11605;359189;4451206;1826571
2021-05-26;LOM;93797;44690;49107;42749;50157;891;0;ITC;ITC4;3;Lombardia;45.46679409;9.190347404;1369;273;1642;31857;33499;-1079;666;765498;33510;832507;10503550;4198628
2021-05-26;PAB;5020;2537;2483;2857;1979;184;0;ITH;ITH1;4;Provincia Autonoma Bolzano / Bozen;46.49933453;11.35662422;14;4;18;844;862;-27;43;70505;1172;72539;1508868;412013
2021-05-26;TOS;35626;17116;18510;20149;15220;257;0;ITI;ITI1;9;Toscana;43.76923077;11.25588885;530;130;660;9243;9903;-523;258;223632;6657;240192;4651964;2192577
2021-05-26;SIC;44747;21041;23706;23907;20494;346;0;ITG;ITG1;19;Sicilia;38.11569725;13.3623567;553;86;639;11076;11715;-889;375;206524;5778;224017;4434916;1699665
2021-05-26;PAT;3971;1873;2098;1118;2730;123;0;ITH;ITH2;4;Provincia Autonoma Trento;46.06893511;11.12123097;36;15;51;547;598;-2;20;43246;1354;45198;810003;209501
2021-05-26;VEN;31173;15237;15936;13993;16499;681;0;ITH;ITH3;5;Veneto;45.43490485;12.33845213;363;64;427;9277;9704;-827;255;401244;11540;422488;7883413;1755057
2021-05-26;ABR;13562;6047;7515;8406;4997;159;0;ITF;ITF1;13;Abruzzo;42.35122196;13.39843823;176;17;193;5631;5824;-84;40;65449;2471;73744;1553439;652777
2021-05-26;PUG;38773;18629;20144;26264;11853;656;0;ITF;ITF4;16;Puglia;41.12559576;16.86736689;726;83;809;28866;29675;-958;237;213261;6444;249380;2461051;1181512
2021-05-26;BAS;4489;2260;2229;1676;2784;29;0;ITF;ITF5;17;Basilicata;40.63947052;15.80514834;75;4;79;4138;4217;-109;66;21347;571;26135;368858;201429
2021-05-26;VDA;1212;587;625;567;634;11;0;ITC;ITC2;2;Valle d'Aosta / Vallée d'Aoste;45.73750286;7.320149366;15;0;15;270;285;-10;5;10748;471;11504;127013;61887
2021-05-26;MOL;1652;755;897;834;771;47;0;ITF;ITF2;14;Molise;41.55774754;14.65916051;15;5;20;182;202;-21;3;12860;488;13550;226466;193904
2021-05-26;LIG;16702;8433;8269;12171;4385;146;0;ITC;ITC3;7;Liguria;44.41149315;8.9326992;157;39;196;1205;1401;-157;74;96764;4314;102479;1590807;633840
2021-05-26;MAR;11889;5952;5937;8448;3227;214;0;ITI;ITI3;11;Marche;43.61675973;13.5188753;140;34;174;4331;4505;33;132;94696;3010;102211;1222569;724917
2021-05-27;LIG;17018;8722;8296;12678;4181;159;0;ITC;ITC3;7;Liguria;44.41149315;8.9326992;142;36;178;1132;1310;-91;49;96902;4316;102528;1596501;635706
2021-05-27;MAR;13736;6819;6917;9183;4301;252;0;ITI;ITI3;11;Marche;43.61675973;13.5188753;132;34;166;4137;4303;-202;154;95051;3011;102365;1226141;726796
2021-05-27;PAB;6215;3279;2936;3887;2017;311;0;ITH;ITH1;4;Provincia Autonoma Bolzano / Bozen;46.49933453;11.35662422;13;4;17;821;838;-24;49;70577;1173;72588;1511942;412587
2021-05-27;PUG;41053;19406;21647;22897;17480;676;0;ITF;ITF4;16;Puglia;41.12559576;16.86736689;686;81;767;27118;27885;-1790;288;215307;6476;249668;2468973;1183246
2021-05-27;MOL;2870;1367;1503;1984;844;42;0;ITF;ITF2;14;Molise;41.55774754;14.65916051;15;5;20;177;197;-5;1;12866;488;13551;226631;194068
2021-05-27;ABR;13323;6104;7219;8315;4831;177;0;ITF;ITF1;13;Abruzzo;42.35122196;13.39843823;171;16;187;5498;5685;-139;66;65652;2473;73810;1558099;653840
2021-05-27;BAS;3623;1863;1760;1072;2537;14;0;ITF;ITF5;17;Basilicata;40.63947052;15.80514834;70;4;74;4048;4122;-95;53;21494;572;26188;369890;201836
2021-05-27;SAR;17864;9269;8595;12109;5545;210;0;ITG;ITG2;20;Sardegna;39.21531192;9.110616306;155;18;173;12776;12949;-124;28;42134;1456;56539;1295208;750848
2021-05-27;LOM;95031;45510;49521;40620;53620;791;0;ITC;ITC4;3;Lombardia;45.46679409;9.190347404;1299;260;1559;31181;32740;-759;739;766955;33551;833246;10547940;4212942
2021-05-27;FVG;12873;6162;6711;7393;5254;226;0;ITH;ITH4;6;Friuli-Venezia Giulia;45.6494354;13.76813649;41;8;49;4965;5014;-49;33;98069;3784;106867;2006923;682498
2021-05-27;EMR;42354;18772;23582;13553;28293;508;0;ITH;ITH5;8;Emilia-Romagna;44.49436681;11.3417208;622;111;733;16624;17357;-177;263;352498;13170;383025;6186832;1857008
2021-05-27;PAT;4381;2035;2346;1164;3083;134;0;ITH;ITH2;4;Provincia Autonoma Trento;46.06893511;11.12123097;33;14;47;540;587;-11;24;43281;1354;45222;811783;210213
2021-05-27;CAM;73053;35403;37650;25809;46663;581;0;ITF;ITF3;15;Campania;40.83956555;14.25084984;782;73;855;68006;68861;-736;533;341763;7168;417792;4869387;3143416
2021-05-27;VEN;46681;22930;23751;22364;23268;1049;0;ITH;ITH3;5;Veneto;45.43490485;12.33845213;336;59;395;8982;9377;-327;242;401807;11546;422730;7913231;1757757
2021-05-27;TOS;28387;13213;15174;13279;14886;222;0;ITI;ITI1;9;Toscana;43.76923077;11.25588885;499;119;618;8865;9483;-420;319;224355;6673;240511;4671631;2199944
2021-05-27;CAL;17681;8745;8936;9771;7826;84;0;ITF;ITF6;18;Calabria;38.90597598;16.59440194;274;19;293;10095;10388;-184;185;54909;1157;66454;858302;788952
2021-05-27;LAZ;58601;27271;31330;43941;13841;819;0;ITI;ITI4;12;Lazio;41.89277044;12.48366722;1061;165;1226;21520;22746;-972;361;310001;8144;340891;6901321;4294005
2021-05-27;PIE;37551;17457;20094;18885;18213;453;0;ITC;ITC1;1;Piemonte;45.0732745;7.680687483;765;90;855;5478;6333;-379;298;341541;11613;359487;4467475;1831841
2021-05-27;VDA;1093;498;595;575;506;12;0;ITC;ITC2;2;Valle d'Aosta / Vallée d'Aoste;45.73750286;7.320149366;11;0;11;247;258;-27;21;10795;472;11525;127565;62042
2021-05-27;SIC;47627;21936;25691;24462;22742;423;0;ITG;ITG1;19;Sicilia;38.11569725;13.3623567;535;81;616;10724;11340;-375;383;207262;5798;224400;4453020;1705589
2021-05-27;UMB;9983;4871;5112;8475;1325;183;0;ITI;ITI2;10;Umbria;43.10675841;12.38824698;81;13;94;1852;1946;-21;10;52774;1391;56111;1305112;373196
2021-05-28;VDA;977;415;562;545;414;18;0;ITC;ITC2;2;Valle d'Aosta / Vallée d'Aoste;45.73750286;7.320149366;12;0;12;230;242;-16;9;10820;472;11534;128042;62155
2021-05-28;BAS;3617;1811;1806;918;2666;33;0;ITF;ITF5;17;Basilicata;40.63947052;15.80514834;69;3;72;3999;4071;-51;57;21600;574;26245;370850;202149
2021-05-28;LAZ;57296;26654;30642;43112;13355;829;0;ITI;ITI4;12;Lazio;41.89277044;12.48366722;1011;159;1170;20589;21759;-987;296;311273;8155;341187;6928345;4303963
2021-05-28;SIC;51288;22993;28295;24319;26556;413;0;ITG;ITG1;19;Sicilia;38.11569725;13.3623567;512;73;585;10030;10615;-725;418;208396;5807;224818;4472406;1712324
2021-05-28;UMB;9601;4440;5161;7116;2301;184;0;ITI;ITI2;10;Umbria;43.10675841;12.38824698;77;13;90;1826;1916;-30;55;52859;1391;56166;1312238;373957
2021-05-28;CAL;21030;10221;10809;11424;9493;113;0;ITF;ITF6;18;Calabria;38.90597598;16.59440194;260;18;278;9796;10074;-314;105;55323;1162;66559;860788;791284
2021-05-28;PAT;3806;1768;2038;1399;2266;141;0;ITH;ITH2;4;Provincia Autonoma Trento;46.06893511;11.12123097;29;14;43;487;530;-57;45;43383;1354;45267;814322;211228
2021-05-28;CAM;73085;35335;37750;26265;46186;634;0;ITF;ITF3;15;Campania;40.83956555;14.25084984;761;69;830;67235;68065;-796;477;343021;7183;418269;4885080;3150757
2021-05-28;FVG;10667;5112;5555;6233;4149;285;0;ITH;ITH4;6;Friuli-Venezia Giulia;45.6494354;13.76813649;41;6;47;4905;4952;-62;21;98151;3785;106888;2013576;683922
2021-05-28;PIE;35144;16641;18503;18696;16030;418;0;ITC;ITC1;1;Piemonte;45.0732745;7.680687483;653;86;739;5134;5873;-460;279;342273;11620;359766;4490556;1837771
2021-05-28;EMR;41305;18966;22339;17270;23435;600;0;ITH;ITH5;8;Emilia-Romagna;44.49436681;11.3417208;560;109;669;15721;16390;-967;258;353718;13174;383282;6209517;1859256
2021-05-28;SAR;18013;8715;9298;13529;4297;187;0;ITG;ITG2;20;Sardegna;39.21531192;9.110616306;150;16;166;12697;12863;-86;52;42269;1459;56591;1298900;752798
2021-05-28;PAB;7473;3945;3528;5367;1896;210;0;ITH;ITH1;4;Provincia Autonoma Bolzano / Bozen;46.49933453;11.35662422;15;4;19;791;810;-28;17;70620;1175;72605;1512835;412850
2021-05-28;PUG;44184;20912;23272;27447;15933;804;0;ITF;ITF4;16;Puglia;41.12559576;16.86736689;648;74;722;25907;26629;-1256;250;216803;6486;249918;2476807;1185976
2021-05-28;LOM;93727;44886;48841;42038;50776;913;0;ITC;ITC4;3;Lombardia;45.46679409;9.190347404;1233;248;1481;31039;32520;-220;661;767807;33580;833907;10593480;4227530
2021-05-28;MAR;13964;6741;7223;8802;4864;298;0;ITI;ITI3;11;Marche;43.61675973;13.5188753;128;30;158;4067;4225;-78;103;95231;3012;102468;1229465;728482
2021-05-28;LIG;16328;8159;8169;11621;4562;145;0;ITC;ITC3;7;Liguria;44.41149315;8.9326992;126;37;163;1106;1269;-41;67;97009;4317;102595;1602254;637635
2021-05-28;ABR;14026;6311;7715;7491;6366;169;0;ITF;ITF1;13;Abruzzo;42.35122196;13.39843823;161;17;178;5441;5619;-66;64;65780;2475;73874;1564788;655100
2021-05-28;VEN;46997;22989;24008;23679;22108;1210;0;ITH;ITH3;5;Veneto;45.43490485;12.33845213;308;57;365;8678;9043;-334;189;402325;11551;422919;7940908;1760097
2021-05-28;TOS;30159;13960;16199;17428;12500;231;0;ITI;ITI1;9;Toscana;43.76923077;11.25588885;455;110;565;8566;9131;-352;301;224992;6689;240812;4691484;2207282
2021-05-28;MOL;2686;1377;1309;2062;549;75;0;ITF;ITF2;14;Molise;41.55774754;14.65916051;15;4;19;164;183;-14;1;12880;489;13552;226992;194422
2021-05-29;LIG;6890;3263;3627;3989;2874;27;0;ITC;ITC3;7;Liguria;44.41149315;8.9326992;117;33;150;1064;1214;-55;82;97145;4318;102677;1608785;639859
2021-05-29;LOM;88402;42446;45956;41395;46162;845;0;ITC;ITC4;3;Lombardia;45.46679409;9.190347404;1131;243;1374;31001;32375;-145;620;768559;33593;834527;10638368;4242337
2021-05-29;SAR;18031;8656;9375;13249;4611;171;0;ITG;ITG2;20;Sardegna;39.21531192;9.110616306;145;14;159;12644;12803;-60;22;42350;1460;56613;1301176;754697
2021-05-29;VEN;33074;16705;16369;24239;7707;1128;0;ITH;ITH3;5;Veneto;45.43490485;12.33845213;292;50;342;8419;8761;-282;198;402798;11558;423117;7971908;1762848
2021-05-29;TOS;31584;15268;16316;23183;8174;227;0;ITI;ITI1;9;Toscana;43.76923077;11.25588885;443;114;557;8061;8618;-513;200;225696;6698;241012;4711169;2213829
2021-05-29;PIE;32871;15258;17613;20311;12194;366;0;ITC;ITC1;1;Piemonte;45.0732745;7.680687483;628;84;712;4873;5585;-288;149;342707;11623;359915;4508565;1842902
2021-05-29;PAT;2448;1330;1118;783;1574;91;0;ITH;ITH2;4;Provincia Autonoma Trento;46.06893511;11.12123097;28;13;41;475;516;-14;46;43443;1354;45313;816524;212109
2021-05-29;MAR;12875;6239;6636;8117;4540;218;0;ITI;ITI3;11;Marche;43.61675973;13.5188753;120;30;150;3942;4092;-133;83;95447;3012;102551;1233360;729988
2021-05-29;PUG;30736;14489;16247;20624;9566;546;0;ITF;ITF4;16;Puglia;41.12559576;16.86736689;606;65;671;25552;26223;-406;269;217472;6492;250187;2484493;1187188
2021-05-29;MOL;2389;1244;1145;1949;395;45;0;ITF;ITF2;14;Molise;41.55774754;14.65916051;11;4;15;152;167;-16;9;12905;489;13561;227446;194870
2021-05-29;PAB;7342;3909;3433;4031;3144;167;0;ITH;ITH1;4;Provincia Autonoma Bolzano / Bozen;46.49933453;11.35662422;15;4;19;717;736;-74;16;70710;1175;72621;1514773;413172
2021-05-29;ABR;10318;4430;5888;4454;5772;92;0;ITF;ITF1;13;Abruzzo;42.35122196;13.39843823;146;17;163;5341;5504;-115;43;65935;2478;73917;1569445;656109
2021-05-29;LAZ;52127;23454;28673;40159;11065;903;0;ITI;ITI4;12;Lazio;41.89277044;12.48366722;933;155;1088;19708;20796;-963;307;312533;8165;341494;6954626;4311921
2021-05-29;EMR;37955;16522;21433;16660;20769;526;0;ITH;ITH5;8;Emilia-Romagna;44.49436681;11.3417208;532;104;636;15427;16063;-327;224;354260;13180;383503;6231259;1861040
2021-05-29;CAL;19307;8966;10341;9354;9878;75;0;ITF;ITF6;18;Calabria;38.90597598;16.59440194;250;18;268;9854;10122;48;177;55450;1164;66736;864017;794341
2021-05-29;CAM;67885;32284;35601;43048;23969;868;0;ITF;ITF3;15;Campania;40.83956555;14.25084984;749;63;812;67032;67844;-221;331;343566;7190;418600;4901041;3159000
2021-05-29;BAS;3061;1534;1527;825;2225;11;0;ITF;ITF5;17;Basilicata;40.63947052;15.80514834;60;3;63;3783;3846;-225;46;21867;578;26291;371973;202577
2021-05-29;VDA;800;436;364;554;239;7;0;ITC;ITC2;2;Valle d'Aosta / Vallée d'Aoste;45.73750286;7.320149366;9;0;9;226;235;-7;7;10834;472;11541;128372;62241
2021-05-29;UMB;7862;3614;4248;6177;1571;114;0;ITI;ITI2;10;Umbria;43.10675841;12.38824698;78;11;89;1685;1774;-142;35;53035;1392;56201;1318279;374669
2021-05-29;SIC;47221;21487;25734;23548;23224;449;0;ITG;ITG1;19;Sicilia;38.11569725;13.3623567;502;72;574;9414;9988;-627;385;209401;5814;225203;4487500;1717845
2021-05-29;FVG;12045;5858;6187;6782;4996;267;0;ITH;ITH4;6;Friuli-Venezia Giulia;45.6494354;13.76813649;38;5;43;4890;4933;-19;76;98244;3787;106964;2021244;685906
2021-05-30;VDA;865;429;436;682;171;12;0;ITC;ITC2;2;Valle d'Aosta / Vallée d'Aoste;45.73750286;7.320149366;8;0;8;212;220;-15;4;10853;472;11545;128668;62360
2021-05-30;ABR;8660;4109;4551;5325;3256;79;0;ITF;ITF1;13;Abruzzo;42.35122196;13.39843823;136;15;151;5358;5509;5;55;65983;2480;73972;1573998;657140
2021-05-30;BAS;2778;1421;1357;920;1853;5;0;ITF;ITF5;17;Basilicata;40.63947052;15.80514834;57;2;59;3741;3800;-46;19;21932;578;26310;372653;202816
2021-05-30;UMB;5982;2999;2983;5662;202;118;0;ITI;ITI2;10;Umbria;43.10675841;12.38824698;79;10;89;1606;1695;-79;24;53137;1393;56225;1324116;375272
2021-05-30;SIC;35790;16180;19610;17431;18063;296;0;ITG;ITG1;19;Sicilia;38.11569725;13.3623567;484;65;549;9334;9883;-105;348;209849;5819;225551;4503341;1722115
2021-05-30;LAZ;41296;17667;23629;33226;7384;686;0;ITI;ITI4;12;Lazio;41.89277044;12.48366722;913;152;1065;18750;19815;-981;278;313786;8171;341772;6974783;4318452
2021-05-30;PIE;27845;13240;14605;18063;9402;380;0;ITC;ITC1;1;Piemonte;45.0732745;7.680687483;625;80;705;4674;5379;-206;233;343145;11624;360148;4519022;1846467
2021-05-30;PAT;1777;876;901;864;843;70;0;ITH;ITH2;4;Provincia Autonoma Trento;46.06893511;11.12123097;22;14;36;482;518;2;40;43481;1354;45353;818564;212925
2021-05-30;FVG;11081;4998;6083;7237;3596;248;0;ITH;ITH4;6;Friuli-Venezia Giulia;45.6494354;13.76813649;36;5;41;4875;4916;-17;34;98295;3787;106998;2024787;687127
2021-05-30;MAR;9736;4691;5045;6546;2993;197;0;ITI;ITI3;11;Marche;43.61675973;13.5188753;113;28;141;3795;3936;-156;81;95683;3013;102632;1235590;731505
2021-05-30;CAL;11012;5309;5703;6822;4154;36;0;ITF;ITF6;18;Calabria;38.90597598;16.59440194;243;17;260;9739;9999;-123;139;55711;1165;66875;866229;796316
2021-05-30;LIG;3311;1616;1695;1339;1949;23;0;ITC;ITC3;7;Liguria;44.41149315;8.9326992;121;31;152;1024;1176;-38;41;97220;4322;102718;1612531;641259
2021-05-30;TOS;28708;13959;14749;21512;6954;242;0;ITI;ITI1;9;Toscana;43.76923077;11.25588885;422;110;532;7855;8387;-231;263;226182;6706;241275;4727717;2220142
2021-05-30;MOL;1893;949;944;1569;288;36;0;ITF;ITF2;14;Molise;41.55774754;14.65916051;11;4;15;147;162;-5;11;12921;489;13572;228167;195366
2021-05-30;PUG;21069;10079;10990;15735;5077;257;0;ITF;ITF4;16;Puglia;41.12559576;16.86736689;572;63;635;25048;25683;-540;90;218098;6496;250277;2489888;1187656
2021-05-30;PAB;4794;2532;2262;731;4031;32;0;ITH;ITH1;4;Provincia Autonoma Bolzano / Bozen;46.49933453;11.35662422;16;4;20;723;743;7;66;70769;1175;72687;1523167;413954
2021-05-30;VEN;22555;11275;11280;15205;6695;655;0;ITH;ITH3;5;Veneto;45.43490485;12.33845213;288;49;337;8373;8710;-51;150;402998;11559;423267;7987725;1764951
2021-05-30;EMR;27105;12809;14296;12988;13714;403;0;ITH;ITH5;8;Emilia-Romagna;44.49436681;11.3417208;521;99;620;15142;15762;-301;190;354748;13183;383693;6243169;1862743
2021-05-30;SAR;9746;4842;4904;7312;2366;68;0;ITG;ITG2;20;Sardegna;39.21531192;9.110616306;141;14;155;12629;12784;-19;30;42398;1461;56643;1302238;755580
2021-05-30;CAM;52175;25456;26719;37949;13330;896;0;ITF;ITF3;15;Campania;40.83956555;14.25084984;733;61;794;66560;67354;-490;385;344440;7191;418985;4914168;3166124
2021-05-30;LOM;74431;35617;38814;33795;40017;619;0;ITC;ITC4;3;Lombardia;45.46679409;9.190347404;1076;246;1322;30741;32063;-312;458;769324;33598;834985;10666563;4254477
2021-05-31;VEN;31656;16245;15411;20885;9936;835;0;ITH;ITH3;5;Veneto;45.43490485;12.33845213;281;50;331;8335;8666;-44;60;403101;11560;423327;7994220;1766200
2021-05-31;CAL;15304;7349;7955;7310;7912;82;0;ITF;ITF6;18;Calabria;38.90597598;16.59440194;240;17;257;9481;9738;-261;57;56027;1167;66932;867513;797522
2021-05-31;PAT;4808;2215;2593;1609;3088;111;0;ITH;ITH2;4;Provincia Autonoma Trento;46.06893511;11.12123097;20;14;34;495;529;11;36;43506;1354;45389;821317;214026
2021-05-31;LAZ;51836;23085;28751;30848;19940;1048;0;ITI;ITI4;12;Lazio;41.89277044;12.48366722;929;146;1075;17695;18770;-1045;251;315078;8175;342023;6984810;4322354
2021-05-31;SIC;38143;17173;20970;21287;16560;296;0;ITG;ITG1;19;Sicilia;38.11569725;13.3623567;475;59;534;9398;9932;49;258;210050;5827;225809;4514559;1726078
2021-05-31;UMB;5823;2847;2976;4852;886;85;0;ITI;ITI2;10;Umbria;43.10675841;12.38824698;73;8;81;1582;1663;-32;63;53228;1397;56288;1329752;375900
2021-05-31;LOM;95754;47436;48318;78390;16262;1102;0;ITC;ITC4;3;Lombardia;45.46679409;9.190347404;1051;234;1285;30212;31497;-566;132;770009;33611;835117;10675224;4260103
2021-05-31;EMR;29824;13781;16043;17735;11537;552;0;ITH;ITH5;8;Emilia-Romagna;44.49436681;11.3417208;530;100;630;14643;15273;-489;188;355420;13186;383879;6251675;1863767
2021-05-31;CAM;40827;20716;20111;29839;10402;586;0;ITF;ITF3;15;Campania;40.83956555;14.25084984;703;62;765;65914;66679;-675;284;345384;7206;419269;4920198;3169178
2021-05-31;FVG;8961;4449;4512;6474;2231;256;0;ITH;ITH4;6;Friuli-Venezia Giulia;45.6494354;13.76813649;38;5;43;4869;4912;-4;8;98307;3787;107006;2026264;687595
2021-05-31;TOS;30363;14652;15711;19271;10849;243;0;ITI;ITI1;9;Toscana;43.76923077;11.25588885;430;110;540;7562;8102;-285;147;226601;6719;241422;4734492;2222736
2021-05-31;SAR;11372;5409;5963;8162;3112;98;0;ITG;ITG2;20;Sardegna;39.21531192;9.110616306;139;13;152;12575;12727;-57;16;42468;1464;56659;1305138;756290
2021-05-31;PIE;29179;14090;15089;20176;8589;414;0;ITC;ITC1;1;Piemonte;45.0732745;7.680687483;594;81;675;4490;5165;-214;126;343478;11631;360274;4531468;1848850
2021-05-31;LIG;14757;7398;7359;9126;5547;84;0;ITC;ITC3;7;Liguria;44.41149315;8.9326992;129;30;159;994;1153;-23;43;97285;4323;102761;1615207;642315
2021-05-31;MOL;2394;1167;1227;1918;428;48;0;ITF;ITF2;14;Molise;41.55774754;14.65916051;11;4;15;142;157;-5;5;12931;489;13577;228478;195672
2021-05-31;ABR;11340;5116;6224;6770;4444;126;0;ITF;ITF1;13;Abruzzo;42.35122196;13.39843823;133;14;147;5412;5559;50;54;65986;2480;74025;1577916;658166
2021-05-31;MAR;11782;5944;5838;8599;2931;252;0;ITI;ITI3;11;Marche;43.61675973;13.5188753;110;27;137;3697;3834;-102;50;95833;3015;102682;1236664;731956
2021-05-31;BAS;4230;2010;2220;1713;2509;8;0;ITF;ITF5;17;Basilicata;40.63947052;15.80514834;57;1;58;3711;3769;-31;6;21968;579;26316;372841;202889
2021-05-31;PUG;38015;18333;19682;23188;14269;558;0;ITF;ITF4;16;Puglia;41.12559576;16.86736689;525;60;585;24339;24924;-759;142;218993;6502;250419;2493643;1189027
2021-05-31;PAB;3071;1517;1554;2083;868;120;0;ITH;ITH1;4;Provincia Autonoma Bolzano / Bozen;46.49933453;11.35662422;20;4;24;734;758;15;67;70821;1175;72754;1528800;414683
2021-05-31;VDA;881;396;485;490;380;11;0;ITC;ITC2;2;Valle d'Aosta / Vallée d'Aoste;45.73750286;7.320149366;6;0;6;221;227;7;22;10868;472;11567;129106;62531
2021-06-01;PUG;35076;17567;17509;21658;13020;398;0;ITF;ITF4;16;Puglia;41.12559576;16.86736689;499;56;555;23222;23777;-1147;227;220361;6508;250646;2501189;1191931
2021-06-01;PAB;3679;2387;1292;2053;1480;146;0;ITH;ITH1;4;Provincia Autonoma Bolzano / Bozen;46.49933453;11.35662422;17;4;21;708;729;-29;49;70899;1175;72803;1534130;415352
2021-06-01;MAR;12055;6157;5898;9679;2090;286;0;ITI;ITI3;11;Marche;43.61675973;13.5188753;103;23;126;3479;3605;-229;34;96094;3017;102716;1238999;732987
2021-06-01;MOL;2651;1347;1304;2486;117;48;0;ITF;ITF2;14;Molise;41.55774754;14.65916051;10;4;14;132;146;-11;2;12944;489;13579;228863;196044
2021-06-01;BAS;6137;2927;3210;3034;3076;27;0;ITF;ITF5;17;Basilicata;40.63947052;15.80514834;60;1;61;3573;3634;-135;24;22127;579;26340;373728;203265
2021-06-01;ABR;10997;4875;6122;6510;4366;121;0;ITF;ITF1;13;Abruzzo;42.35122196;13.39843823;137;13;150;5343;5493;-66;15;66065;2482;74040;1578759;658488
2021-06-01;FVG;10149;5133;5016;7691;2130;328;0;ITH;ITH4;6;Friuli-Venezia Giulia;45.6494354;13.76813649;36;5;41;4801;4842;-70;19;98395;3788;107025;2032361;688944
2021-06-01;UMB;4390;2090;2300;4162;156;72;0;ITI;ITI2;10;Umbria;43.10675841;12.38824698;68;6;74;1517;1591;-72;26;53323;1400;56314;1336248;376504
2021-06-01;VDA;874;471;403;511;354;9;0;ITC;ITC2;2;Valle d'Aosta / Vallée d'Aoste;45.73750286;7.320149366;6;1;7;221;228;1;16;10883;472;11583;129466;62674
2021-06-01;LAZ;49194;23739;25455;30078;18616;500;0;ITI;ITI4;12;Lazio;41.89277044;12.48366722;882;145;1027;15892;16919;-1851;195;317114;8185;342218;7010848;4331481
2021-06-01;PIE;29644;14885;14759;24517;4689;438;0;ITC;ITC1;1;Piemonte;45.0732745;7.680687483;557;81;638;4171;4809;-356;209;344031;11643;360483;4547655;1853768
2021-06-01;TOS;26970;13402;13568;22874;3838;258;0;ITI;ITI1;9;Toscana;43.76923077;11.25588885;397;107;504;7109;7613;-489;159;227243;6725;241581;4750692;2227845
2021-06-01;CAL;12890;5977;6913;7884;4946;60;0;ITF;ITF6;18;Calabria;38.90597598;16.59440194;233;15;248;9108;9356;-382;74;56478;1172;67006;870244;799229
2021-06-01;CAM;42315;20992;21323;31429;10553;333;0;ITF;ITF3;15;Campania;40.83956555;14.25084984;636;58;694;65294;65988;-691;375;346440;7216;419644;4936002;3176282
2021-06-01;VEN;26999;13571;13428;15786;10564;649;0;ITH;ITH3;5;Veneto;45.43490485;12.33845213;261;48;309;7828;8137;-529;106;403727;11569;423433;8020135;1768113
2021-06-01;PAT;4109;1926;2183;1080;2914;115;0;ITH;ITH2;4;Provincia Autonoma Trento;46.06893511;11.12123097;20;13;33;447;480;-49;28;43583;1354;45417;822981;214692
2021-06-01;LIG;16360;8240;8120;10903;5378;79;0;ITC;ITC3;7;Liguria;44.41149315;8.9326992;114;30;144;896;1040;-113;19;97416;4324;102780;1620409;643760
2021-06-01;SIC;38997;17731;21266;24596;14049;352;0;ITG;ITG1;19;Sicilia;38.11569725;13.3623567;451;56;507;8981;9488;-444;326;210808;5839;226135;4530416;1731696
2021-06-01;LOM;94051;46133;47918;75802;17134;1115;0;ITC;ITC4;3;Lombardia;45.46679409;9.190347404;1073;220;1293;29849;31142;-355;461;770816;33620;835578;10710940;4272409
2021-06-01;SAR;14328;6659;7669;9637;4595;96;0;ITG;ITG2;20;Sardegna;39.21531192;9.110616306;131;14;145;12515;12660;-67;36;42570;1465;56695;1308972;758225
2021-06-01;EMR;27200;13117;14083;16829;9930;441;0;ITH;ITH5;8;Emilia-Romagna;44.49436681;11.3417208;523;95;618;13800;14418;-855;107;356379;13189;383986;6272739;1865700
2021-06-02;UMB;3926;1886;2040;3804;42;80;0;ITI;ITI2;10;Umbria;43.10675841;12.38824698;62;6;68;1490;1558;-33;63;53418;1401;56377;1340407;377030
2021-06-02;EMR;24125;12072;12053;18681;4980;464;0;ITH;ITH5;8;Emilia-Romagna;44.49436681;11.3417208;489;90;579;13263;13842;-576;152;357105;13190;384137;6291496;1868144
2021-06-02;LIG;8545;4349;4196;5335;3177;33;0;ITC;ITC3;7;Liguria;44.41149315;8.9326992;107;29;136;857;993;-47;45;97507;4325;102825;1625727;645327
2021-06-02;CAM;42949;20186;22763;37603;4735;611;0;ITF;ITF3;15;Campania;40.83956555;14.25084984;624;55;679;64898;65577;-411;388;347234;7221;420032;4953254;3183734
2021-06-02;LOM;84731;43625;41106;76986;6420;1325;0;ITC;ITC4;3;Lombardia;45.46679409;9.190347404;980;207;1187;20566;21753;-9389;519;780714;33630;836097;10751688;4285911
2021-06-02;PIE;26792;13116;13676;21691;4648;453;0;ITC;ITC1;1;Piemonte;45.0732745;7.680687483;542;79;621;3942;4563;-246;190;344463;11647;360673;4561001;1858768
2021-06-02;PAT;2884;1383;1501;894;1916;74;0;ITH;ITH2;4;Provincia Autonoma Trento;46.06893511;11.12123097;18;13;31;442;473;-7;10;43599;1355;45427;823347;214838
2021-06-02;SAR;9786;4692;5094;8060;1640;86;0;ITG;ITG2;20;Sardegna;39.21531192;9.110616306;130;14;144;12480;12624;-36;40;42646;1465;56735;1311051;759957
2021-06-02;VEN;20318;10239;10079;15345;4347;626;0;ITH;ITH3;5;Veneto;45.43490485;12.33845213;232;45;277;7475;7752;-385;175;404284;11572;423608;8057393;1771578
2021-06-02;TOS;27617;13634;13983;21868;5512;237;0;ITI;ITI1;9;Toscana;43.76923077;11.25588885;374;103;477;6642;7119;-494;162;227895;6729;241743;4768386;2233627
2021-06-02;FVG;9436;4967;4469;8820;282;334;0;ITH;ITH4;6;Friuli-Venezia Giulia;45.6494354;13.76813649;36;2;38;4729;4767;-75;35;98505;3788;107060;2038622;690488
2021-06-02;MAR;11903;5939;5964;11028;679;196;0;ITI;ITI3;11;Marche;43.61675973;13.5188753;97;21;118;3348;3466;-139;125;96357;3018;102841;1242483;734661
2021-06-02;CAL;12116;5805;6311;8786;3279;51;0;ITF;ITF6;18;Calabria;38.90597598;16.59440194;222;14;236;8971;9207;-149;158;56784;1173;67164;874092;802206
2021-06-02;SIC;35284;16298;18986;27102;7782;400;0;ITG;ITG1;19;Sicilia;38.11569725;13.3623567;421;47;468;8230;8698;-790;289;211871;5855;226424;4543987;1736604
2021-06-02;LAZ;43595;21640;21955;31443;11578;574;0;ITI;ITI4;12;Lazio;41.89277044;12.48366722;838;143;981;14613;15594;-1325;211;318646;8189;342429;7033646;4339952
2021-06-02;MOL;2866;1377;1489;2731;100;35;0;ITF;ITF2;14;Molise;41.55774754;14.65916051;9;2;11;127;138;-8;7;12957;491;13586;229367;196537
2021-06-02;PUG;27121;13260;13861;21920;4845;356;0;ITF;ITF4;16;Puglia;41.12559576;16.86736689;490;50;540;21884;22424;-1353;196;221900;6518;250842;2507146;1192965
2021-06-02;ABR;9774;4750;5024;6834;2819;121;0;ITF;ITF1;13;Abruzzo;42.35122196;13.39843823;127;14;141;5199;5340;-153;35;66251;2484;74075;1584075;659671
2021-06-02;VDA;1217;689;528;809;402;6;0;ITC;ITC2;2;Valle d'Aosta / Vallée d'Aoste;45.73750286;7.320149366;6;1;7;229;236;8;10;10885;472;11593;129569;62700
2021-06-02;BAS;5962;2806;3156;4375;1544;43;0;ITF;ITF5;17;Basilicata;40.63947052;15.80514834;56;1;57;3531;3588;-46;37;22209;580;26377;374576;203633
2021-06-02;PAB;1468;824;644;973;459;36;0;ITH;ITH1;4;Provincia Autonoma Bolzano / Bozen;46.49933453;11.35662422;14;3;17;684;701;-28;41;70968;1175;72844;1541767;416196
2021-06-03;PUG;50751;24616;26135;30570;19454;727;0;ITF;ITF4;16;Puglia;41.12559576;16.86736689;479;44;523;20654;21177;-1247;44;223182;6527;250886;2510077;1194212
2021-06-03;TOS;32067;15457;16610;27151;4591;325;0;ITI;ITI1;9;Toscana;43.76923077;11.25588885;370;99;469;6325;6794;-325;186;228399;6736;241929;4777259;2237281
2021-06-03;LIG;15562;7712;7850;9109;6392;61;0;ITC;ITC3;7;Liguria;44.41149315;8.9326992;101;28;129;797;926;-67;30;97602;4327;102855;1629790;646713
2021-06-03;MAR;14638;7483;7155;12081;2252;305;0;ITI;ITI3;11;Marche;43.61675973;13.5188753;96;22;118;3343;3461;-5;35;96397;3018;102876;1243496;735081
2021-06-03;PAB;4897;2666;2231;3683;973;241;0;ITH;ITH1;4;Provincia Autonoma Bolzano / Bozen;46.49933453;11.35662422;16;3;19;667;686;-15;42;71025;1175;72886;1544737;416693
2021-06-03;ABR;13198;6285;6913;9244;3779;175;0;ITF;ITF1;13;Abruzzo;42.35122196;13.39843823;120;12;132;5199;5331;-9;67;66327;2484;74142;1588916;660786
2021-06-03;MOL;3348;1597;1751;2729;568;51;0;ITF;ITF2;14;Molise;41.55774754;14.65916051;9;2;11;120;131;-7;0;12964;491;13586;229608;196658
2021-06-03;BAS;4922;2258;2664;3703;1181;38;0;ITF;ITF5;17;Basilicata;40.63947052;15.80514834;59;2;61;3491;3552;-36;3;22248;580;26380;374753;203704
2021-06-03;VDA;1314;671;643;883;414;17;0;ITC;ITC2;2;Valle d'Aosta / Vallée d'Aoste;45.73750286;7.320149366;6;1;7;205;212;-24;8;10917;472;11601;130063;62838
2021-06-03;CAL;14263;6659;7604;9589;4620;54;0;ITF;ITF6;18;Calabria;38.90597598;16.59440194;224;16;240;8852;9092;-115;104;57001;1175;67268;875425;803108
2021-06-03;VEN;54544;28050;26494;40868;12011;1665;0;ITH;ITH3;5;Veneto;45.43490485;12.33845213;228;46;274;7426;7700;-52;63;404397;11574;423671;8067325;1772853
2021-06-03;SAR;16401;7647;8754;10566;5694;141;0;ITG;ITG2;20;Sardegna;39.21531192;9.110616306;127;14;141;12413;12554;-70;33;42746;1468;56768;1312259;760669
2021-06-03;LOM;97238;49760;47478;84617;10946;1675;0;ITC;ITC4;3;Lombardia;45.46679409;9.190347404;942;193;1135;20394;21529;-224;277;781208;33637;836374;10766438;4292889
2021-06-03;CAM;72656;35242;37414;60802;10683;1171;0;ITF;ITF3;15;Campania;40.83956555;14.25084984;594;54;648;64350;64998;-579;218;348023;7229;420250;4960301;3187998
2021-06-03;PAT;4845;2279;2566;1237;3515;93;0;ITH;ITH2;4;Provincia Autonoma Trento;46.06893511;11.12123097;15;9;24;456;480;7;32;43621;1358;45459;824989;215495
2021-06-03;FVG;12484;6769;5715;9903;2134;447;0;ITH;ITH4;6;Friuli-Venezia Giulia;45.6494354;13.76813649;38;1;39;4721;4760;-7;6;98516;3790;107066;2040349;690985
2021-06-03;EMR;37940;18447;19493;29686;7562;692;0;ITH;ITH5;8;Emilia-Romagna;44.49436681;11.3417208;473;88;561;12627;13188;-654;232;357984;13193;384365;6298652;1869106
2021-06-03;PIE;34876;18070;16806;29798;4522;556;0;ITC;ITC1;1;Piemonte;45.0732745;7.680687483;513;75;588;3798;4386;-177;219;344856;11650;360892;4571815;1861404
2021-06-03;LAZ;56958;28777;28181;38289;17911;758;0;ITI;ITI4;12;Lazio;41.89277044;12.48366722;843;134;977;13721;14698;-896;196;319732;8195;342625;7044078;4345277
2021-06-03;UMB;9051;4473;4578;8584;290;177;0;ITI;ITI2;10;Umbria;43.10675841;12.38824698;64;6;70;1453;1523;-35;6;53459;1401;56383;1341201;377195
2021-06-03;SIC;46009;21102;24907;33763;11720;526;0;ITG;ITG1;19;Sicilia;38.11569725;13.3623567;413;46;459;8304;8763;65;254;212057;5858;226678;4555703;1740734
2021-06-04;BAS;4833;2290;2543;3749;1046;38;0;ITF;ITF5;17;Basilicata;40.63947052;15.80514834;52;2;54;3445;3499;-53;51;22351;581;26431;375742;204046
2021-06-04;ABR;15650;7395;8255;10757;4703;190;0;ITF;ITF1;13;Abruzzo;42.35122196;13.39843823;119;12;131;5147;5278;-53;10;66387;2486;74151;1590472;661076
2021-06-04;VDA;910;385;525;467;435;8;0;ITC;ITC2;2;Valle d'Aosta / Vallée d'Aoste;45.73750286;7.320149366;6;1;7;197;204;-8;8;10933;472;11609;130411;62956
2021-06-04;EMR;45769;23029;22740;36802;8207;760;0;ITH;ITH5;8;Emilia-Romagna;44.49436681;11.3417208;448;78;526;11688;12214;-974;150;359102;13198;384514;6318150;1870710
2021-06-04;SIC;57873;26770;31103;45396;11962;515;0;ITG;ITG1;19;Sicilia;38.11569725;13.3623567;409;45;454;7864;8318;-445;337;212834;5863;227015;4570245;1746524
2021-06-04;SAR;14522;6949;7573;9787;4575;160;0;ITG;ITG2;20;Sardegna;39.21531192;9.110616306;122;13;135;12387;12522;-32;48;42823;1471;56816;1314129;761786
2021-06-04;CAM;74589;35845;38744;64390;9137;1062;0;ITF;ITF3;15;Campania;40.83956555;14.25084984;593;49;642;63541;64183;-815;300;349128;7239;420550;4973522;3193959
2021-06-04;FVG;12174;6237;5937;10267;1453;454;0;ITH;ITH4;6;Friuli-Venezia Giulia;45.6494354;13.76813649;34;1;35;4706;4741;-19;28;98562;3791;107094;2045987;692522
2021-06-04;LOM;104668;54326;50342;93200;9673;1795;0;ITC;ITC4;3;Lombardia;45.46679409;9.190347404;939;183;1122;20437;21559;30;417;781589;33643;836791;10801710;4305462
2021-06-04;PAB;6726;3392;3334;4934;1537;255;0;ITH;ITH1;4;Provincia Autonoma Bolzano / Bozen;46.49933453;11.35662422;17;3;20;657;677;-9;11;71045;1175;72897;1545855;416993
2021-06-04;CAL;17545;8159;9386;12949;4525;71;0;ITF;ITF6;18;Calabria;38.90597598;16.59440194;213;16;229;8876;9105;13;186;57170;1179;67454;878457;805939
2021-06-04;UMB;8931;4415;4516;7541;1206;184;0;ITI;ITI2;10;Umbria;43.10675841;12.38824698;62;6;68;1425;1493;-30;17;53505;1402;56400;1347918;377864
2021-06-04;PIE;37726;19735;17991;34117;2974;635;0;ITC;ITC1;1;Piemonte;45.0732745;7.680687483;484;70;554;3575;4129;-257;191;345302;11652;361083;4592933;1866151
2021-06-04;LAZ;62147;30300;31847;43566;17896;685;0;ITI;ITI4;12;Lazio;41.89277044;12.48366722;797;128;925;12855;13780;-918;197;320838;8204;342822;7070614;4352608
2021-06-04;PUG;52931;25614;27317;34238;17866;827;0;ITF;ITF4;16;Puglia;41.12559576;16.86736689;448;35;483;19765;20248;-929;196;224298;6536;251082;2518416;1197363
2021-06-04;PAT;5932;2653;3279;1730;4063;139;0;ITH;ITH2;4;Provincia Autonoma Trento;46.06893511;11.12123097;15;9;24;371;395;-85;27;43733;1358;45486;827097;216338
2021-06-04;LIG;14802;7268;7534;9213;5501;88;0;ITC;ITC3;7;Liguria;44.41149315;8.9326992;92;28;120;737;857;-69;20;97688;4330;102875;1635089;648346
2021-06-04;MAR;14338;7290;7048;11588;2440;310;0;ITI;ITI3;11;Marche;43.61675973;13.5188753;95;18;113;3322;3435;-26;71;96494;3018;102947;1246036;736241
2021-06-04;TOS;28348;13456;14892;20261;7815;272;0;ITI;ITI1;9;Toscana;43.76923077;11.25588885;344;101;445;5981;6426;-368;133;228895;6741;242062;4794780;2243332
2021-06-04;VEN;49658;25844;23814;39818;8157;1683;0;ITH;ITH3;5;Veneto;45.43490485;12.33845213;219;46;265;7152;7417;-283;121;404796;11579;423792;8096045;1774861
2021-06-04;MOL;3131;1540;1591;2625;463;43;0;ITF;ITF2;14;Molise;41.55774754;14.65916051;9;2;11;110;121;-10;4;12978;491;13590;229858;196904
2021-06-05;LOM;102451;52963;49488;91097;9837;1517;0;ITC;ITC4;3;Lombardia;45.46679409;9.190347404;887;170;1057;20286;21343;-216;436;782231;33653;837227;10841073;4318698
2021-06-05;SAR;17889;8441;9448;11285;6469;135;0;ITG;ITG2;20;Sardegna;39.21531192;9.110616306;111;12;123;12360;12483;-39;30;42891;1472;56846;1316278;763571
2021-06-05;LIG;8110;4132;3978;4917;3157;36;0;ITC;ITC3;7;Liguria;44.41149315;8.9326992;80;27;107;706;813;-44;23;97755;4330;102898;1639788;649799
2021-06-05;TOS;28458;13610;14848;20558;7623;277;0;ITI;ITI1;9;Toscana;43.76923077;11.25588885;311;96;407;5740;6147;-279;154;229320;6749;242216;4813402;2249351
2021-06-05;SIC;59964;28524;31440;48732;10603;629;0;ITG;ITG1;19;Sicilia;38.11569725;13.3623567;396;45;441;7454;7895;-423;234;213483;5871;227249;4585355;1752314
2021-06-05;PIE;37060;18969;18091;31937;4465;658;0;ITC;ITC1;1;Piemonte;45.0732745;7.680687483;467;61;528;3400;3928;-201;189;345690;11654;361272;4614639;1871060
2021-06-05;PAT;4137;1943;2194;690;3367;80;0;ITH;ITH2;4;Provincia Autonoma Trento;46.06893511;11.12123097;17;8;25;383;408;13;19;43739;1358;45505;827727;216590
2021-06-05;VEN;46888;24153;22735;37319;8105;1464;0;ITH;ITH3;5;Veneto;45.43490485;12.33845213;199;45;244;6746;6990;-427;130;405352;11580;423922;8124037;1777055
2021-06-05;CAM;77652;37596;40056;70529;6039;1084;0;ITF;ITF3;15;Campania;40.83956555;14.25084984;572;49;621;63192;63813;-370;307;349803;7241;420857;4988971;3202724
2021-06-05;LAZ;66464;32739;33725;42941;22824;699;0;ITI;ITI4;12;Lazio;41.89277044;12.48366722;750;126;876;12013;12889;-891;210;321930;8213;343032;7097580;4360908
2021-06-05;MAR;13944;7011;6933;11520;2058;366;0;ITI;ITI3;11;Marche;43.61675973;13.5188753;92;17;109;3297;3406;-29;98;96621;3018;103045;1248996;737856
2021-06-05;ABR;14617;6866;7751;10362;4051;204;0;ITF;ITF1;13;Abruzzo;42.35122196;13.39843823;105;10;115;5030;5145;-133;45;66561;2490;74196;1594700;662132
2021-06-05;BAS;4800;2210;2590;3823;941;36;0;ITF;ITF5;17;Basilicata;40.63947052;15.80514834;52;0;52;3326;3378;-121;31;22501;583;26462;376599;204390
2021-06-05;MOL;3047;1540;1507;2828;177;42;0;ITF;ITF2;14;Molise;41.55774754;14.65916051;8;1;9;107;116;-5;6;12989;491;13596;230428;197464
2021-06-05;PUG;42727;20931;21796;29230;12777;720;0;ITF;ITF4;16;Puglia;41.12559576;16.86736689;423;33;456;18750;19206;-1042;161;225500;6537;251243;2525636;1199523
2021-06-05;PAB;6088;3035;3053;4687;1097;304;0;ITH;ITH1;4;Provincia Autonoma Bolzano / Bozen;46.49933453;11.35662422;17;3;20;657;677;0;16;71061;1175;72913;1551841;417795
2021-06-05;EMR;44332;22387;21945;36622;6927;783;0;ITH;ITH5;8;Emilia-Romagna;44.49436681;11.3417208;423;68;491;11223;11714;-500;134;359726;13208;384648;6341111;1872509
2021-06-05;CAL;20806;9716;11090;17636;3089;81;0;ITF;ITF6;18;Calabria;38.90597598;16.59440194;207;14;221;8755;8976;-129;76;57373;1181;67530;880943;808254
2021-06-05;VDA;930;478;452;730;191;9;0;ITC;ITC2;2;Valle d'Aosta / Vallée d'Aoste;45.73750286;7.320149366;5;0;5;177;182;-22;2;10957;472;11611;130655;63012
2021-06-05;UMB;8232;3777;4455;5415;2656;161;0;ITI;ITI2;10;Umbria;43.10675841;12.38824698;55;7;62;1335;1397;-96;33;53634;1402;56433;1352360;378450
2021-06-05;FVG;10355;5352;5003;8391;1558;406;0;ITH;ITH4;6;Friuli-Venezia Giulia;45.6494354;13.76813649;30;1;31;4717;4748;7;70;98624;3792;107164;2053474;694688
2021-06-06;PAB;4553;2189;2364;809;3693;51;0;ITH;ITH1;4;Provincia Autonoma Bolzano / Bozen;46.49933453;11.35662422;16;3;19;621;640;-37;34;71131;1176;72947;1556585;418553
2021-06-06;MOL;2133;1094;1039;1773;329;31;0;ITF;ITF2;14;Molise;41.55774754;14.65916051;7;1;8;99;107;-9;3;13001;491;13599;230606;197641
2021-06-06;ABR;11152;5311;5841;8777;2241;134;0;ITF;ITF1;13;Abruzzo;42.35122196;13.39843823;98;11;109;5005;5114;-31;44;66634;2490;74238;1599929;663349
2021-06-06;LAZ;58328;28124;30204;35148;22555;625;0;ITI;ITI4;12;Lazio;41.89277044;12.48366722;690;125;815;11177;11992;-897;233;323055;8218;343265;7115916;4369076
2021-06-06;VDA;1161;582;579;779;374;8;0;ITC;ITC2;2;Valle d'Aosta / Vallée d'Aoste;45.73750286;7.320149366;5;0;5;162;167;-15;5;10977;472;11616;131054;63115
2021-06-06;SIC;49537;23925;25612;41145;7832;560;0;ITG;ITG1;19;Sicilia;38.11569725;13.3623567;382;44;426;7545;7971;76;275;213680;5873;227524;4592587;1755635
2021-06-06;BAS;4512;2074;2438;3695;779;38;0;ITF;ITF5;17;Basilicata;40.63947052;15.80514834;49;0;49;3289;3338;-40;31;22571;584;26493;377193;204591
2021-06-06;VEN;37453;19174;18279;31489;4732;1232;0;ITH;ITH3;5;Veneto;45.43490485;12.33845213;197;44;241;6639;6880;-110;80;405542;11580;424002;8141563;1778981
2021-06-06;PAT;2269;1080;1189;431;1817;21;0;ITH;ITH2;4;Provincia Autonoma Trento;46.06893511;11.12123097;16;5;21;374;395;-13;20;43772;1358;45525;829833;217433
2021-06-06;FVG;9509;4640;4869;7644;1568;297;0;ITH;ITH4;6;Friuli-Venezia Giulia;45.6494354;13.76813649;28;1;29;4696;4725;-23;13;98660;3792;107177;2056809;695781
2021-06-06;UMB;7611;3906;3705;6791;694;126;0;ITI;ITI2;10;Umbria;43.10675841;12.38824698;54;7;61;1321;1382;-15;6;53655;1402;56439;1352900;378527
2021-06-06;PIE;35182;18379;16803;32134;2491;557;0;ITC;ITC1;1;Piemonte;45.0732745;7.680687483;461;63;524;3289;3813;-115;129;345934;11654;361401;4624921;1874104
2021-06-06;SAR;10038;5002;5036;6314;3655;69;0;ITG;ITG2;20;Sardegna;39.21531192;9.110616306;110;8;118;12359;12477;-6;31;42927;1473;56877;1317843;764878
2021-06-06;TOS;28330;13665;14665;22586;5374;370;0;ITI;ITI1;9;Toscana;43.76923077;11.25588885;291;93;384;5601;5985;-162;193;229666;6758;242409;4828216;2255250
2021-06-06;PUG;30789;15504;15285;25389;5077;323;0;ITF;ITF4;16;Puglia;41.12559576;16.86736689;411;33;444;18386;18830;-376;139;226011;6541;251382;2530335;1200570
2021-06-06;EMR;36604;19003;17601;31537;4415;652;0;ITH;ITH5;8;Emilia-Romagna;44.49436681;11.3417208;412;70;482;10972;11454;-260;172;360157;13209;384820;6352755;1874482
2021-06-06;CAL;13814;6642;7172;12016;1725;73;0;ITF;ITF6;18;Calabria;38.90597598;16.59440194;191;14;205;8761;8966;-10;128;57506;1186;67658;882957;810022
2021-06-06;CAM;63236;31451;31785;61529;651;1056;0;ITF;ITF3;15;Campania;40.83956555;14.25084984;571;46;617;62866;63483;-330;255;350387;7242;421112;5000587;3209415
2021-06-06;LOM;90141;46354;43787;79535;9223;1383;0;ITC;ITC4;3;Lombardia;45.46679409;9.190347404;833;167;1000;19641;20641;-702;359;783276;33669;837586;10868733;4330488
2021-06-06;LIG;3814;2032;1782;2932;862;20;0;ITC;ITC3;7;Liguria;44.41149315;8.9326992;81;26;107;678;785;-28;36;97818;4331;102934;1643230;650969
2021-06-06;MAR;12454;6138;6316;10638;1579;237;0;ITI;ITI3;11;Marche;43.61675973;13.5188753;79;17;96;3281;3377;-29;75;96723;3020;103120;1251725;740585
2021-06-07;EMR;40578;20828;19750;33437;6268;873;0;ITH;ITH5;8;Emilia-Romagna;44.49436681;11.3417208;404;72;476;10486;10962;-492;155;360799;13212;384973;6360046;1875392
2021-06-07;SIC;49696;23420;26276;41115;8043;538;0;ITG;ITG1;19;Sicilia;38.11569725;13.3623567;392;43;435;7448;7883;-88;156;213921;5876;227680;4602346;1758779
2021-06-07;FVG;9235;4788;4447;7844;1001;390;0;ITH;ITH4;6;Friuli-Venezia Giulia;45.6494354;13.76813649;28;2;30;4686;4716;-9;10;98679;3792;107187;2058179;696239
2021-06-07;PIE;35009;17905;17104;29569;4810;630;0;ITC;ITC1;1;Piemonte;45.0732745;7.680687483;461;64;525;3114;3639;-174;100;346202;11660;361501;4636419;1876669
2021-06-07;CAM;57607;27732;29875;52485;4056;1066;0;ITF;ITF3;15;Campania;40.83956555;14.25084984;566;43;609;62318;62927;-556;177;351110;7252;421289;5005004;3211518
2021-06-07;SAR;12569;6145;6424;9437;3009;123;0;ITG;ITG2;20;Sardegna;39.21531192;9.110616306;105;7;112;12312;12424;-53;9;42986;1476;56886;1320784;766212
2021-06-07;UMB;6961;3436;3525;6087;696;178;0;ITI;ITI2;10;Umbria;43.10675841;12.38824698;52;6;58;1297;1355;-27;29;53710;1403;56468;1357850;378967
2021-06-07;LAZ;62710;29355;33355;32714;29381;615;0;ITI;ITI4;12;Lazio;41.89277044;12.48366722;686;124;810;10217;11027;-965;170;324185;8223;343435;7127092;4371793
2021-06-07;CAL;18009;8424;9585;14712;3215;82;0;ITF;ITF6;18;Calabria;38.90597598;16.59440194;189;15;204;8631;8835;-131;39;57670;1192;67697;884322;811263
2021-06-07;LOM;99051;50448;48603;84027;13392;1632;0;ITC;ITC4;3;Lombardia;45.46679409;9.190347404;799;167;966;19595;20561;-80;142;783492;33675;837728;10881430;4337282
2021-06-07;MOL;1995;878;1117;1143;825;27;0;ITF;ITF2;14;Molise;41.55774754;14.65916051;7;0;7;94;101;-6;0;13007;491;13599;230809;197844
2021-06-07;MAR;13322;6589;6733;10569;2450;303;0;ITI;ITI3;11;Marche;43.61675973;13.5188753;81;17;98;3272;3370;-7;20;96748;3022;103140;1252922;739590
2021-06-07;LIG;15722;7673;8049;8607;7041;74;0;ITC;ITC3;7;Liguria;44.41149315;8.9326992;77;23;100;613;713;-72;7;97894;4334;102941;1645690;651780
2021-06-07;VEN;44709;23325;21384;36173;7044;1492;0;ITH;ITH3;5;Veneto;45.43490485;12.33845213;190;43;233;6586;6819;-61;38;405640;11581;424040;8146181;1780227
2021-06-07;TOS;34983;17165;17818;30980;3655;348;0;ITI;ITI1;9;Toscana;43.76923077;11.25588885;298;88;386;5438;5824;-161;160;229981;6764;242569;4834643;2257888
2021-06-07;PAT;5895;2932;2963;2678;3031;186;0;ITH;ITH2;4;Provincia Autonoma Trento;46.06893511;11.12123097;18;6;24;361;385;-10;28;43810;1358;45553;832329;218431
2021-06-07;BAS;4239;1921;2318;3885;316;38;0;ITF;ITF5;17;Basilicata;40.63947052;15.80514834;48;0;48;3231;3279;-59;1;22630;585;26494;377380;204645
2021-06-07;ABR;11102;5290;5812;9069;1846;187;0;ITF;ITF1;13;Abruzzo;42.35122196;13.39843823;90;9;99;5053;5152;38;39;66634;2491;74277;1603695;664405
2021-06-07;PUG;44502;21727;22775;30397;13338;767;0;ITF;ITF4;16;Puglia;41.12559576;16.86736689;399;32;431;18108;18539;-291;56;226354;6545;251438;2533789;1201183
2021-06-07;PAB;2990;1555;1435;2517;325;148;0;ITH;ITH1;4;Provincia Autonoma Bolzano / Bozen;46.49933453;11.35662422;15;2;17;610;627;-13;28;71172;1176;72975;1557898;418907
2021-06-07;VDA;711;347;364;637;61;13;0;ITC;ITC2;2;Valle d'Aosta / Vallée d'Aoste;45.73750286;7.320149366;6;0;6;154;160;-7;5;10989;472;11621;131542;63269
2021-06-08;MAR;14098;7094;7004;11195;2611;292;0;ITI;ITI3;11;Marche;43.61675973;13.5188753;83;15;98;3146;3244;-126;33;96905;3024;103173;1255647;740819
2021-06-08;PUG;39427;19197;20230;20959;17903;565;0;ITF;ITF4;16;Puglia;41.12559576;16.86736689;343;29;372;16959;17331;-1208;134;227679;6562;251572;2542091;1203847
2021-06-08;PAB;4270;2186;2084;891;3346;33;0;ITH;ITH1;4;Provincia Autonoma Bolzano / Bozen;46.49933453;11.35662422;14;2;16;580;596;-31;12;71215;1176;72987;1562816;419454
2021-06-08;VDA;772;408;364;731;33;8;0;ITC;ITC2;2;Valle d'Aosta / Vallée d'Aoste;45.73750286;7.320149366;4;0;4;145;149;-11;5;11005;472;11626;131862;63391
2021-06-08;MOL;2908;1605;1303;2203;701;4;0;ITF;ITF2;14;Molise;41.55774754;14.65916051;5;0;5;95;100;-1;4;13012;491;13603;231377;198404
2021-06-08;ABR;12871;6623;6248;10431;2197;243;0;ITF;ITF1;13;Abruzzo;42.35122196;13.39843823;91;7;98;4477;4575;-577;13;67218;2496;74289;1604837;664706
2021-06-08;VEN;43861;22678;21183;36181;6154;1526;0;ITH;ITH3;5;Veneto;45.43490485;12.33845213;181;37;218;6289;6507;-312;130;406078;11585;424170;8174663;1781837
2021-06-08;BAS;4587;2195;2392;4191;358;38;0;ITF;ITF5;17;Basilicata;40.63947052;15.80514834;44;0;44;3122;3166;-113;35;22778;585;26529;378340;204973
2021-06-08;PIE;37786;19542;18244;34208;2857;721;0;ITC;ITC1;1;Piemonte;45.0732745;7.680687483;413;55;468;2977;3445;-194;96;346489;11663;361597;4650920;1880930
2021-06-08;PAT;6048;2920;3128;1781;4133;134;0;ITH;ITH2;4;Provincia Autonoma Trento;46.06893511;11.12123097;20;6;26;330;356;-29;15;43853;1359;45568;833857;219042
2021-06-08;TOS;32613;16732;15881;31737;491;385;0;ITI;ITI1;9;Toscana;43.76923077;11.25588885;290;84;374;5170;5544;-280;90;230340;6775;242659;4849400;2262780
2021-06-08;FVG;10564;5539;5025;9626;505;433;0;ITH;ITH4;6;Friuli-Venezia Giulia;45.6494354;13.76813649;29;3;32;4665;4697;-19;45;98742;3793;107232;2063809;697448
2021-06-08;UMB;7422;3659;3763;6656;558;208;0;ITI;ITI2;10;Umbria;43.10675841;12.38824698;52;5;57;1252;1309;-46;38;53794;1403;56506;1365650;379975
2021-06-08;CAL;16690;7906;8784;14513;2053;124;0;ITF;ITF6;18;Calabria;38.90597598;16.59440194;182;13;195;8524;8719;-116;61;57845;1194;67758;886934;813726
2021-06-08;LIG;18134;9047;9087;11379;6656;99;0;ITC;ITC3;7;Liguria;44.41149315;8.9326992;76;21;97;546;643;-70;21;97982;4337;102962;1650097;653121
2021-06-08;SIC;47711;22407;25304;40453;6714;544;0;ITG;ITG1;19;Sicilia;38.11569725;13.3623567;368;42;410;7296;7706;-177;337;214423;5888;228017;4624350;1764982
2021-06-08;LAZ;66867;31923;34944;36148;30041;678;0;ITI;ITI4;12;Lazio;41.89277044;12.48366722;645;108;753;9202;9955;-1072;139;325390;8229;343574;7153659;4379496
2021-06-08;SAR;14838;7072;7766;11168;3512;158;0;ITG;ITG2;20;Sardegna;39.21531192;9.110616306;100;6;106;12167;12273;-151;14;43148;1479;56900;1323121;767809
2021-06-08;LOM;102966;52324;50642;87170;14109;1687;0;ITC;ITC4;3;Lombardia;45.46679409;9.190347404;817;145;962;19445;20407;-154;291;783926;33686;838019;10915877;4349162
2021-06-08;CAM;53116;25878;27238;45212;7081;823;0;ITF;ITF3;15;Campania;40.83956555;14.25084984;553;42;595;61772;62367;-560;251;351905;7268;421540;5020098;3219382
2021-06-08;EMR;45157;23122;22035;36785;7553;819;0;ITH;ITH5;8;Emilia-Romagna;44.49436681;11.3417208;386;70;456;10503;10959;-3;99;360892;13219;385070;6380331;1877095
2021-06-09;BAS;4422;2071;2351;3966;423;33;0;ITF;ITF5;17;Basilicata;40.63947052;15.80514834;43;0;43;3091;3134;-32;31;22841;585;26560;379303;205320
2021-06-09;VDA;1056;560;496;1009;35;12;0;ITC;ITC2;2;Valle d'Aosta / Vallée d'Aoste;45.73750286;7.320149366;6;0;6;145;151;2;3;11006;472;11629;131963;63422
2021-06-09;TOS;34855;17586;17269;33959;463;433;0;ITI;ITI1;9;Toscana;43.76923077;11.25588885;261;80;341;4896;5237;-307;127;230765;6784;242786;4865298;2268503
2021-06-09;PAT;6336;3125;3211;2115;4135;86;0;ITH;ITH2;4;Provincia Autonoma Trento;46.06893511;11.12123097;21;6;27;327;354;-2;4;43859;1359;45572;834273;219209
2021-06-09;FVG;11373;5985;5388;9482;1401;490;0;ITH;ITH4;6;Friuli-Venezia Giulia;45.6494354;13.76813649;23;3;26;4645;4671;-26;25;98793;3793;107257;2069946;698795
2021-06-09;PIE;38771;20422;18349;35214;2751;806;0;ITC;ITC1;1;Piemonte;45.0732745;7.680687483;386;53;439;2752;3191;-254;137;346877;11666;361734;4665958;1885480
2021-06-09;EMR;43194;21938;21256;35728;6440;1026;0;ITH;ITH5;8;Emilia-Romagna;44.49436681;11.3417208;360;69;429;9894;10323;-636;107;361632;13221;385176;6399364;1879162
2021-06-09;CAL;18266;8628;9638;15895;2285;86;0;ITF;ITF6;18;Calabria;38.90597598;16.59440194;172;13;185;8375;8560;-159;114;58116;1196;67872;889518;816121
2021-06-09;LAZ;70581;33438;37143;35970;33938;673;0;ITI;ITI4;12;Lazio;41.89277044;12.48366722;587;107;694;8196;8890;-1065;179;326627;8236;343753;7175906;4383686
2021-06-09;CAM;53064;26052;27012;41396;10919;749;0;ITF;ITF3;15;Campania;40.83956555;14.25084984;518;43;561;61261;61822;-545;257;352687;7288;421797;5034692;3227546
2021-06-09;VEN;42849;21978;20871;33780;7509;1560;0;ITH;ITH3;5;Veneto;45.43490485;12.33845213;175;33;208;6119;6327;-180;126;406377;11592;424296;8203876;1784151
2021-06-09;MAR;14279;7417;6862;12108;1869;302;0;ITI;ITI3;11;Marche;43.61675973;13.5188753;79;11;90;3035;3125;-119;82;97106;3024;103255;1258651;742355
2021-06-09;LIG;19111;9592;9519;12431;6592;88;0;ITC;ITC3;7;Liguria;44.41149315;8.9326992;70;20;90;478;568;-75;20;98074;4340;102982;1655302;654749
2021-06-09;SIC;49788;23683;26105;41910;7267;611;0;ITG;ITG1;19;Sicilia;38.11569725;13.3623567;365;39;404;6918;7322;-384;320;215125;5890;228337;4639258;1771091
2021-06-09;LOM;103769;52263;51506;87433;14602;1734;0;ITC;ITC4;3;Lombardia;45.46679409;9.190347404;754;143;897;18095;18992;-1415;322;785653;33696;838341;10959148;4363053
2021-06-09;UMB;8163;3951;4212;7137;725;301;0;ITI;ITI2;10;Umbria;43.10675841;12.38824698;45;6;51;1182;1233;-76;24;53894;1403;56530;1369562;380482
2021-06-09;SAR;15479;7370;8109;11575;3753;151;0;ITG;ITG2;20;Sardegna;39.21531192;9.110616306;94;6;100;12104;12204;-69;37;43252;1481;56937;1326989;770384
2021-06-09;PUG;42061;20825;21236;29993;11352;716;0;ITF;ITF4;16;Puglia;41.12559576;16.86736689;332;25;357;16161;16518;-813;185;228669;6570;251757;2549087;1205065
2021-06-09;ABR;11593;6097;5496;9720;1688;185;0;ITF;ITF1;13;Abruzzo;42.35122196;13.39843823;88;6;94;2367;2461;-2114;25;69355;2498;74314;1608697;665720
2021-06-09;MOL;1844;928;916;876;936;32;0;ITF;ITF2;14;Molise;41.55774754;14.65916051;5;0;5;91;96;-4;4;13020;491;13607;231778;198792
2021-06-09;PAB;3870;1919;1951;1263;2498;109;0;ITH;ITH1;4;Provincia Autonoma Bolzano / Bozen;46.49933453;11.35662422;14;2;16;556;572;-24;34;71273;1176;73021;1568840;420138
2021-06-10;LOM;102739;52276;50463;86418;14509;1812;0;ITC;ITC4;3;Lombardia;45.46679409;9.190347404;721;130;851;18020;18871;-121;352;786120;33702;838693;10994844;4374982
2021-06-10;LIG;18908;9747;9161;13112;5682;114;0;ITC;ITC3;7;Liguria;44.41149315;8.9326992;68;20;88;440;528;-40;28;98141;4341;103010;1660407;656152
2021-06-10;PAT;6222;3032;3190;1811;4271;140;0;ITH;ITH2;4;Provincia Autonoma Trento;46.06893511;11.12123097;19;6;25;335;360;6;21;43874;1359;45593;835874;219849
2021-06-10;VEN;52420;27047;25373;41320;9385;1715;0;ITH;ITH3;5;Veneto;45.43490485;12.33845213;156;31;187;5998;6185;-142;88;406603;11596;424384;8237007;1785890
2021-06-10;MAR;14930;7695;7235;12573;2013;344;0;ITI;ITI3;11;Marche;43.61675973;13.5188753;76;10;86;2903;2989;-136;46;97288;3024;103301;1261295;743722
2021-06-10;TOS;26460;13573;12887;25550;560;350;0;ITI;ITI1;9;Toscana;43.76923077;11.25588885;255;76;331;4641;4972;-265;174;231192;6796;242960;4881399;2274623
2021-06-10;PUG;47304;23259;24045;29426;17158;720;0;ITF;ITF4;16;Puglia;41.12559576;16.86736689;308;24;332;14545;14877;-1641;123;230425;6578;251880;2555492;1207543
2021-06-10;ABR;12730;6325;6405;10313;2178;239;0;ITF;ITF1;13;Abruzzo;42.35122196;13.39843823;81;4;85;1750;1835;-626;48;70029;2498;74362;1613295;666676
2021-06-10;MOL;2642;1215;1427;1290;1301;51;0;ITF;ITF2;14;Molise;41.55774754;14.65916051;6;0;6;87;93;-3;3;13026;491;13610;232209;199009
2021-06-10;VDA;1059;612;447;1006;41;12;0;ITC;ITC2;2;Valle d'Aosta / Vallée d'Aoste;45.73750286;7.320149366;6;0;6;124;130;-21;8;11035;472;11637;132484;63569
2021-06-10;UMB;7570;3770;3800;6465;791;314;0;ITI;ITI2;10;Umbria;43.10675841;12.38824698;50;5;55;1159;1214;-19;6;53919;1403;56536;1370335;380630
2021-06-10;CAM;76020;36714;39306;67568;7111;1341;0;ITF;ITF3;15;Campania;40.83956555;14.25084984;482;43;525;60726;61251;-571;209;353440;7315;422006;5047606;3234038
2021-06-10;PAB;4498;2334;2164;1301;3098;99;0;ITH;ITH1;4;Provincia Autonoma Bolzano / Bozen;46.49933453;11.35662422;13;2;15;554;569;-3;39;71314;1177;73060;1571383;420632
2021-06-10;CAL;15899;7335;8564;12983;2814;102;0;ITF;ITF6;18;Calabria;38.90597598;16.59440194;168;12;180;8096;8276;-284;78;58472;1202;67950;891656;818098
2021-06-10;FVG;11603;6042;5561;9695;1489;419;0;ITH;ITH4;6;Friuli-Venezia Giulia;45.6494354;13.76813649;21;3;24;4633;4657;-14;42;98848;3794;107299;2075529;699849
2021-06-10;PIE;40633;21241;19392;37144;2593;896;0;ITC;ITC1;1;Piemonte;45.0732745;7.680687483;367;49;416;2604;3020;-171;137;347185;11666;361871;4681917;1890061
2021-06-10;EMR;45115;23172;21943;38677;5387;1051;0;ITH;ITH5;8;Emilia-Romagna;44.49436681;11.3417208;335;63;398;8822;9220;-1103;145;362876;13225;385321;6401646;1880973
2021-06-10;BAS;4346;2101;2245;3867;442;37;0;ITF;ITF5;17;Basilicata;40.63947052;15.80514834;42;0;42;2995;3037;-97;36;22974;585;26596;380267;205706
2021-06-10;SIC;53057;24909;28148;45145;7253;659;0;ITG;ITG1;19;Sicilia;38.11569725;13.3623567;362;38;400;6961;7361;39;284;215367;5893;228621;4653061;1776445
2021-06-10;SAR;17818;8481;9337;11644;6047;127;0;ITG;ITG2;20;Sardegna;39.21531192;9.110616306;87;5;92;12041;12133;-71;19;43342;1481;56956;1330921;773105
2021-06-10;LAZ;72333;34192;38141;37290;34154;889;0;ITI;ITI4;12;Lazio;41.89277044;12.48366722;543;108;651;7491;8142;-748;194;327563;8242;343947;7192680;4387674
2021-06-11;VDA;1048;484;564;752;283;13;0;ITC;ITC2;2;Valle d'Aosta / Vallée d'Aoste;45.73750286;7.320149366;5;0;5;113;118;-12;4;11051;472;11641;132931;63691
2021-06-11;BAS;4236;1982;2254;3166;1028;42;0;ITF;ITF5;17;Basilicata;40.63947052;15.80514834;38;0;38;2990;3028;-9;52;23035;585;26648;381034;206035
2021-06-11;EMR;46003;23877;22126;38326;6566;1111;0;ITH;ITH5;8;Emilia-Romagna;44.49436681;11.3417208;321;61;382;8322;8704;-516;139;363523;13230;385457;6421432;1882479
2021-06-11;VEN;47323;24620;22703;34706;11186;1431;0;ITH;ITH3;5;Veneto;45.43490485;12.33845213;146;31;177;5891;6068;-117;77;406794;11599;424461;8263994;1787175
2021-06-11;ABR;11794;5860;5934;8833;2773;188;0;ITF;ITF1;13;Abruzzo;42.35122196;13.39843823;81;4;85;1567;1652;-183;38;70248;2499;74399;1618102;667771
2021-06-11;CAL;17834;8762;9072;15128;2581;125;0;ITF;ITF6;18;Calabria;38.90597598;16.59440194;156;10;166;8068;8234;-42;130;58641;1205;68080;894045;820360
2021-06-11;PAT;7315;3480;3835;1493;5715;107;0;ITH;ITH2;4;Provincia Autonoma Trento;46.06893511;11.12123097;16;6;22;322;344;-16;33;43923;1359;45626;837832;220632
2021-06-11;UMB;7013;3519;3494;6003;772;238;0;ITI;ITI2;10;Umbria;43.10675841;12.38824698;44;5;49;1148;1197;-17;32;53966;1405;56568;1376011;381295
2021-06-11;LAZ;69872;32872;37000;36657;32526;689;0;ITI;ITI4;12;Lazio;41.89277044;12.48366722;512;103;615;6749;7364;-778;169;328498;8254;344116;7222500;4391443
2021-06-11;FVG;10950;5972;4978;9630;841;479;0;ITH;ITH4;6;Friuli-Venezia Giulia;45.6494354;13.76813649;17;3;20;4621;4641;-16;23;98887;3794;107322;2080998;700979
2021-06-11;PIE;43714;23126;20588;40040;2844;830;0;ITC;ITC1;1;Piemonte;45.0732745;7.680687483;351;47;398;2478;2876;-144;126;347451;11670;361997;4704535;1894998
2021-06-11;LIG;17876;9102;8774;11709;6084;83;0;ITC;ITC3;7;Liguria;44.41149315;8.9326992;57;18;75;419;494;-34;10;98184;4342;103020;1665142;657393
2021-06-11;SIC;49976;23848;26128;41591;7712;673;0;ITG;ITG1;19;Sicilia;38.11569725;13.3623567;337;38;375;6489;6864;-497;273;216133;5897;228894;4666428;1781750
2021-06-11;PUG;48094;23528;24566;33045;14137;912;0;ITF;ITF4;16;Puglia;41.12559576;16.86736689;272;22;294;14053;14347;-530;140;231088;6585;252020;2561176;1209336
2021-06-11;MAR;14003;7156;6847;11374;2324;305;0;ITI;ITI3;11;Marche;43.61675973;13.5188753;70;10;80;2893;2973;-16;43;97346;3025;103344;1263812;744979
2021-06-11;SAR;14786;7026;7760;9091;5539;156;0;ITG;ITG2;20;Sardegna;39.21531192;9.110616306;83;5;88;11985;12073;-60;21;43421;1483;56977;1334261;775155
2021-06-11;CAM;70850;34428;36422;63426;6058;1366;0;ITF;ITF3;15;Campania;40.83956555;14.25084984;467;40;507;60284;60791;-460;199;354088;7326;422205;5060549;3240186
2021-06-11;LOM;101544;51720;49824;84940;14704;1900;0;ITC;ITC4;3;Lombardia;45.46679409;9.190347404;660;122;782;17625;18407;-464;270;786849;33707;838963;11030822;4387880
2021-06-11;PAB;5843;3006;2837;2128;3488;227;0;ITH;ITH1;4;Provincia Autonoma Bolzano / Bozen;46.49933453;11.35662422;13;1;14;534;548;-21;4;71338;1178;73064;1572230;420859
2021-06-11;TOS;29767;15505;14262;24738;4662;367;0;ITI;ITI1;9;Toscana;43.76923077;11.25588885;232;73;305;4481;4786;-186;146;231515;6805;243106;4897021;2280436
2021-06-11;MOL;3498;1681;1817;2005;1440;53;0;ITF;ITF2;14;Molise;41.55774754;14.65916051;6;0;6;90;96;3;6;13029;491;13616;232530;199323
2021-06-12;EMR;41393;21890;19503;35459;4923;1011;0;ITH;ITH5;8;Emilia-Romagna;44.49436681;11.3417208;291;60;351;8162;8513;-191;105;363818;13230;385561;6438600;1884004
2021-06-12;PAT;5430;2718;2712;436;4944;50;0;ITH;ITH2;4;Provincia Autonoma Trento;46.06893511;11.12123097;14;4;18;307;325;-19;14;43956;1359;45640;839506;221302
2021-06-12;LAZ;69978;32135;37843;39879;29437;662;0;ITI;ITI4;12;Lazio;41.89277044;12.48366722;481;102;583;5984;6567;-797;164;329451;8262;344280;7249150;4395056
2021-06-12;CAL;13250;6301;6949;10781;2401;68;0;ITF;ITF6;18;Calabria;38.90597598;16.59440194;150;10;160;8091;8251;17;80;58702;1207;68160;896282;822434
2021-06-12;FVG;8241;4723;3518;6785;1163;293;0;ITH;ITH4;6;Friuli-Venezia Giulia;45.6494354;13.76813649;12;3;15;4593;4608;-33;36;98956;3794;107358;2088101;702355
2021-06-12;PIE;42739;22518;20221;39295;2630;814;0;ITC;ITC1;1;Piemonte;45.0732745;7.680687483;325;45;370;2386;2756;-120;90;347657;11674;362087;4726807;1900457
2021-06-12;TOS;29409;15160;14249;24657;4392;360;0;ITI;ITI1;9;Toscana;43.76923077;11.25588885;204;70;274;4299;4573;-213;146;231869;6810;243252;4913249;2285165
2021-06-12;UMB;7724;3690;4034;5961;1580;183;0;ITI;ITI2;10;Umbria;43.10675841;12.38824698;42;5;47;1104;1151;-46;21;54032;1406;56589;1380402;381904
2021-06-12;SIC;45804;22400;23404;39371;5897;536;0;ITG;ITG1;19;Sicilia;38.11569725;13.3623567;326;43;369;6329;6698;-166;263;216559;5900;229157;4680357;1786161
2021-06-12;SAR;14758;7196;7562;9935;4705;118;0;ITG;ITG2;20;Sardegna;39.21531192;9.110616306;85;5;90;11981;12071;-2;20;43443;1483;56997;1337986;777636
2021-06-12;PAB;5080;2754;2326;1649;3289;142;0;ITH;ITH1;4;Provincia Autonoma Bolzano / Bozen;46.49933453;11.35662422;12;1;13;506;519;-29;28;71395;1178;73092;1578058;421521
2021-06-12;VEN;48709;24506;24203;36402;10834;1473;0;ITH;ITH3;5;Veneto;45.43490485;12.33845213;137;29;166;5764;5930;-138;67;406998;11600;424528;8287138;1788521
2021-06-12;MAR;13781;7315;6466;12104;1346;331;0;ITI;ITI3;11;Marche;43.61675973;13.5188753;57;10;67;2803;2870;-103;34;97483;3025;103378;1266043;746049
2021-06-12;CAM;64002;31546;32456;55571;7216;1215;0;ITF;ITF3;15;Campania;40.83956555;14.25084984;440;31;471;59914;60385;-406;187;354673;7334;422392;5073647;3246290
2021-06-12;LOM;89335;48069;41266;84300;3182;1853;0;ITC;ITC4;3;Lombardia;45.46679409;9.190347404;633;118;751;17705;18456;49;255;787042;33720;839218;11067060;4401066
2021-06-12;LIG;10266;4994;5272;7437;2760;69;0;ITC;ITC3;7;Liguria;44.41149315;8.9326992;62;12;74;400;474;-20;21;98225;4342;103041;1670347;658767
2021-06-12;PUG;34690;17284;17406;25095;9000;595;0;ITF;ITF4;16;Puglia;41.12559576;16.86736689;268;21;289;13523;13812;-535;140;231760;6588;252160;2567120;1210616
2021-06-12;MOL;5968;3067;2901;5669;204;95;0;ITF;ITF2;14;Molise;41.55774754;14.65916051;7;0;7;81;88;-8;3;13040;491;13619;233010;199795
2021-06-12;VDA;1234;600;634;1057;167;10;0;ITC;ITC2;2;Valle d'Aosta / Vallée d'Aoste;45.73750286;7.320149366;5;0;5;111;116;-2;8;11061;472;11649;133343;63811
2021-06-12;ABR;11423;5915;5508;9887;1351;185;0;ITF;ITF1;13;Abruzzo;42.35122196;13.39843823;76;4;80;1452;1532;-120;28;70389;2500;74421;1621821;668706
2021-06-12;BAS;3687;1693;1994;2960;689;38;0;ITF;ITF5;17;Basilicata;40.63947052;15.80514834;38;0;38;2951;2989;-39;13;23087;585;26661;381918;206380
2021-06-13;ABR;9848;4925;4923;7847;1835;166;0;ITF;ITF1;13;Abruzzo;42.35122196;13.39843823;68;4;72;1444;1516;-16;29;70432;2502;74450;1626887;670041
2021-06-13;MOL;2953;1570;1383;2578;329;46;0;ITF;ITF2;14;Molise;41.55774754;14.65916051;8;0;8;82;90;2;6;13044;491;13625;233517;200300
2021-06-13;PAB;3691;2057;1634;452;3199;40;0;ITH;ITH1;4;Provincia Autonoma Bolzano / Bozen;46.49933453;11.35662422;12;1;13;502;515;-4;21;71419;1179;73113;1581963;422062
2021-06-13;PUG;21904;10970;10934;16389;5229;286;0;ITF;ITF4;16;Puglia;41.12559576;16.86736689;263;21;284;12933;13217;-595;73;232428;6588;252233;2571121;1211251
2021-06-13;VDA;857;403;454;370;482;5;0;ITC;ITC2;2;Valle d'Aosta / Vallée d'Aoste;45.73750286;7.320149366;5;0;5;107;112;-4;4;11069;472;11653;133824;63954
2021-06-13;BAS;3014;1440;1574;2678;308;28;0;ITF;ITF5;17;Basilicata;40.63947052;15.80514834;42;0;42;2937;2979;-10;27;23124;585;26688;382388;206564
2021-06-13;SAR;9503;4678;4825;6162;3261;80;0;ITG;ITG2;20;Sardegna;39.21531192;9.110616306;87;5;92;11959;12051;-20;11;43473;1484;57008;1339823;779170
2021-06-13;EMR;28782;15015;13767;23807;4290;685;0;ITH;ITH5;8;Emilia-Romagna;44.49436681;11.3417208;288;62;350;7995;8345;-168;123;364106;13233;385684;6448946;1885228
2021-06-13;PAT;3735;2062;1673;279;3430;26;0;ITH;ITH2;4;Provincia Autonoma Trento;46.06893511;11.12123097;14;4;18;296;314;-11;24;43991;1359;45664;841221;221988
2021-06-13;LOM;76007;40567;35440;72282;2132;1593;0;ITC;ITC4;3;Lombardia;45.46679409;9.190347404;628;114;742;17649;18391;-65;257;787358;33726;839475;11093902;4412535
2021-06-13;UMB;6767;3558;3209;6392;230;145;0;ITI;ITI2;10;Umbria;43.10675841;12.38824698;42;5;47;1078;1125;-26;30;54080;1414;56619;1384295;382477
2021-06-13;FVG;8722;4538;4184;5167;3331;224;0;ITH;ITH4;6;Friuli-Venezia Giulia;45.6494354;13.76813649;8;4;12;4577;4589;-19;11;98986;3794;107369;2091185;703255
2021-06-13;PIE;38237;20184;18053;33311;4138;788;0;ITC;ITC1;1;Piemonte;45.0732745;7.680687483;317;47;364;2305;2669;-87;59;347802;11675;362146;4734907;1903458
2021-06-13;SIC;34550;17168;17382;30604;3512;434;0;ITG;ITG1;19;Sicilia;38.11569725;13.3623567;310;47;357;6365;6722;24;183;216713;5905;229340;4687154;1789212
2021-06-13;LAZ;58483;26242;32241;33063;24890;530;0;ITI;ITI4;12;Lazio;41.89277044;12.48366722;450;98;548;5621;6169;-398;127;329976;8262;344407;7266571;4398135
2021-06-13;VEN;37345;19259;18086;29319;6957;1069;0;ITH;ITH3;5;Veneto;45.43490485;12.33845213;134;28;162;5758;5920;-10;87;407095;11600;424615;8303246;1789606
2021-06-13;TOS;24625;12357;12268;22602;1660;363;0;ITI;ITI1;9;Toscana;43.76923077;11.25588885;195;66;261;4197;4458;-115;123;232101;6816;243375;4925424;2289926
2021-06-13;CAM;43428;21243;22185;37844;4731;853;0;ITF;ITF3;15;Campania;40.83956555;14.25084984;410;29;439;59639;60078;-307;147;355124;7337;422539;5083781;3250298
2021-06-13;CAL;6864;3369;3495;5730;1078;56;0;ITF;ITF6;18;Calabria;38.90597598;16.59440194;149;9;158;7937;8095;-156;72;58929;1208;68232;897867;823877
2021-06-13;LIG;5645;2707;2938;5121;456;68;0;ITC;ITC3;7;Liguria;44.41149315;8.9326992;59;12;71;368;439;-35;10;98270;4342;103051;1673065;659507
2021-06-13;MAR;10753;5566;5187;9203;1300;250;0;ITI;ITI3;11;Marche;43.61675973;13.5188753;52;9;61;2738;2799;-71;33;97587;3025;103411;1268226;747092
2021-06-14;LAZ;63143;29590;33553;32335;30234;574;0;ITI;ITI4;12;Lazio;41.89277044;12.48366722;454;94;548;5298;5846;-323;111;330404;8268;344518;7275693;4400283
2021-06-14;CAL;14360;6512;7848;9627;4656;77;0;ITF;ITF6;18;Calabria;38.90597598;16.59440194;146;8;154;7745;7899;-196;18;59139;1212;68250;898766;824709
2021-06-14;UMB;5388;2750;2638;3253;2016;119;0;ITI;ITI2;10;Umbria;43.10675841;12.38824698;40;5;45;1057;1102;-23;16;54118;1415;56635;1389380;383051
2021-06-14;CAM;37136;17921;19215;18686;18024;426;0;ITF;ITF3;15;Campania;40.83956555;14.25084984;379;24;403;59426;59829;-249;80;355448;7342;422619;5087072;3250708
2021-06-14;SIC;43495;20660;22835;28166;14899;430;0;ITG;ITG1;19;Sicilia;38.11569725;13.3623567;319;39;358;6273;6631;-91;163;216960;5912;229503;4697065;1792048
2021-06-14;TOS;31838;16353;15485;27429;4109;300;0;ITI;ITI1;9;Toscana;43.76923077;11.25588885;190;63;253;3953;4206;-252;82;232432;6819;243457;4930492;2291947
2021-06-14;SAR;13752;6645;7107;9790;3819;143;0;ITG;ITG2;20;Sardegna;39.21531192;9.110616306;83;6;89;11883;11972;-79;31;43583;1484;57039;1340983;780145
2021-06-14;LOM;94894;48213;46681;49131;44644;1119;0;ITC;ITC4;3;Lombardia;45.46679409;9.190347404;596;109;705;17667;18372;-19;102;787476;33729;839577;11105601;4419071
2021-06-14;EMR;41349;21378;19971;27453;13088;808;0;ITH;ITH5;8;Emilia-Romagna;44.49436681;11.3417208;291;62;353;7665;8018;-327;137;364569;13234;385821;6457057;1885996
2021-06-14;LIG;15178;7327;7851;8200;6893;85;0;ITC;ITC3;7;Liguria;44.41149315;8.9326992;55;12;67;351;418;-21;5;98295;4343;103056;1675032;660158
2021-06-14;VEN;42636;21564;21072;26293;15322;1021;0;ITH;ITH3;5;Veneto;45.43490485;12.33845213;134;26;160;5720;5880;-40;19;407154;11600;424634;8309695;1790269
2021-06-14;PAT;5821;3010;2811;2042;3657;122;0;ITH;ITH2;4;Provincia Autonoma Trento;46.06893511;11.12123097;13;4;17;262;279;-35;12;44037;1360;45676;843450;222880
2021-06-14;FVG;10329;5014;5315;5185;4842;302;0;ITH;ITH4;6;Friuli-Venezia Giulia;45.6494354;13.76813649;9;4;13;4569;4582;-7;4;98997;3794;107373;2092714;703636
2021-06-14;PAB;2984;1617;1367;570;2361;53;0;ITH;ITH1;4;Provincia Autonoma Bolzano / Bozen;46.49933453;11.35662422;12;1;13;469;482;-33;28;71479;1180;73141;1585359;422644
2021-06-14;PIE;38105;19622;18483;30281;7099;725;0;ITC;ITC1;1;Piemonte;45.0732745;7.680687483;303;45;348;2257;2605;-64;87;347950;11678;362233;4746399;1906298
2021-06-14;MOL;1657;824;833;549;1091;17;0;ITF;ITF2;14;Molise;41.55774754;14.65916051;8;0;8;77;85;-5;1;13050;491;13626;234520;200704
2021-06-14;MAR;12838;6486;6352;9256;3310;272;0;ITI;ITI3;11;Marche;43.61675973;13.5188753;52;9;61;2643;2704;-95;3;97685;3025;103414;1268945;747366
2021-06-14;BAS;4825;2156;2669;2090;2711;24;0;ITF;ITF5;17;Basilicata;40.63947052;15.80514834;40;0;40;2913;2953;-26;1;23150;586;26689;382592;206650
2021-06-14;ABR;10988;5433;5555;7429;3383;176;0;ITF;ITF1;13;Abruzzo;42.35122196;13.39843823;69;4;73;1456;1529;13;14;70433;2502;74464;1630279;671035
2021-06-14;PUG;42179;20637;21542;28871;12511;797;0;ITF;ITF4;16;Puglia;41.12559576;16.86736689;263;20;283;12301;12584;-633;47;233106;6590;252280;2574526;1212980
2021-06-14;VDA;1017;523;494;575;428;14;0;ITC;ITC2;2;Valle d'Aosta / Vallée d'Aoste;45.73750286;7.320149366;3;0;3;98;101;-11;2;11082;472;11655;134156;64079
2021-06-15;MAR;13200;6574;6626;9828;3052;320;0;ITI;ITI3;11;Marche;43.61675973;13.5188753;51;9;60;2611;2671;-33;16;97733;3026;103430;1271275;748479
2021-06-15;PAB;2045;1184;861;480;1534;31;0;ITH;ITH1;4;Provincia Autonoma Bolzano / Bozen;46.49933453;11.35662422;14;1;15;429;444;-38;10;71527;1180;73151;1588944;423098
2021-06-15;PUG;42780;20909;21871;22397;19789;594;0;ITF;ITF4;16;Puglia;41.12559576;16.86736689;247;22;269;11042;11311;-1273;169;234546;6592;252449;2582579;1215153
2021-06-15;LIG;17447;8476;8971;9257;8098;92;0;ITC;ITC3;7;Liguria;44.41149315;8.9326992;51;12;63;321;384;-34;8;98337;4343;103064;1681244;661488
2021-06-15;MOL;2257;1063;1194;780;1459;18;0;ITF;ITF2;14;Molise;41.55774754;14.65916051;8;0;8;74;82;-3;4;13057;491;13630;234874;201052
2021-06-15;VDA;925;508;417;654;258;13;0;ITC;ITC2;2;Valle d'Aosta / Vallée d'Aoste;45.73750286;7.320149366;3;0;3;92;95;-6;1;11089;472;11656;134498;64234
2021-06-15;ABR;11329;5562;5767;8681;2439;209;0;ITF;ITF1;13;Abruzzo;42.35122196;13.39843823;71;4;75;1398;1473;-56;5;70494;2502;74469;1631164;671270
2021-06-15;BAS;3222;1417;1805;2225;976;21;0;ITF;ITF5;17;Basilicata;40.63947052;15.80514834;38;0;38;2858;2896;-57;28;23234;587;26717;383403;206958
2021-06-15;TOS;31240;16081;15159;26312;4578;350;0;ITI;ITI1;9;Toscana;43.76923077;11.25588885;186;54;240;3816;4056;-150;57;232632;6826;243514;4945348;2297161
2021-06-15;UMB;5993;3018;2975;3798;2075;120;0;ITI;ITI2;10;Umbria;43.10675841;12.38824698;41;5;46;1012;1058;-44;21;54181;1417;56656;1393675;383483
2021-06-15;LAZ;66277;32041;34236;33369;32318;590;0;ITI;ITI4;12;Lazio;41.89277044;12.48366722;430;90;520;4982;5502;-344;118;330853;8281;344636;7300232;4404273
2021-06-15;FVG;12185;6199;5986;5354;6544;287;0;ITH;ITH4;6;Friuli-Venezia Giulia;45.6494354;13.76813649;10;3;13;4534;4547;-35;12;99043;3795;107385;2098242;704730
2021-06-15;PIE;39050;20104;18946;26552;11798;700;0;ITC;ITC1;1;Piemonte;45.0732745;7.680687483;291;47;338;2040;2378;-227;75;348249;11681;362308;4763941;1911754
2021-06-15;PAT;6336;3343;2993;1629;4567;140;0;ITH;ITH2;4;Provincia Autonoma Trento;46.06893511;11.12123097;13;4;17;229;246;-33;11;44081;1360;45687;844689;223375
2021-06-15;SIC;46191;21770;24421;28204;17549;438;0;ITG;ITG1;19;Sicilia;38.11569725;13.3623567;309;34;343;6024;6367;-264;200;217416;5920;229703;4712325;1798205
2021-06-15;CAL;15167;7055;8112;10240;4834;93;0;ITF;ITF6;18;Calabria;38.90597598;16.59440194;148;10;158;7605;7763;-136;32;59306;1213;68282;900887;826734
2021-06-15;SAR;14693;6812;7881;9813;4744;136;0;ITG;ITG2;20;Sardegna;39.21531192;9.110616306;73;6;79;11788;11867;-105;22;43710;1484;57061;1343732;781712
2021-06-15;LOM;96104;48906;47198;49021;46011;1072;0;ITC;ITC4;3;Lombardia;45.46679409;9.190347404;590;100;690;17636;18326;-46;182;787696;33737;839759;11137474;4430976
2021-06-15;CAM;18691;9096;9595;10974;7426;291;0;ITF;ITF3;15;Campania;40.83956555;14.25084984;366;23;389;11348;11737;-48092;136;403661;7357;422755;5101362;3251460
2021-06-15;EMR;43882;22644;21238;27907;15076;899;0;ITH;ITH5;8;Emilia-Romagna;44.49436681;11.3417208;279;56;335;6913;7248;-770;48;365384;13236;385868;6475668;1888062
2021-06-15;VEN;47853;24307;23546;29142;17555;1156;0;ITH;ITH3;5;Veneto;45.43490485;12.33845213;127;24;151;5565;5716;-164;74;407392;11600;424708;8341724;1797105
2021-06-16;BAS;4606;2086;2520;2126;2460;20;0;ITF;ITF5;17;Basilicata;40.63947052;15.80514834;37;0;37;2804;2841;-55;16;23305;587;26733;383995;207195
2021-06-16;VDA;1067;567;500;662;395;10;0;ITC;ITC2;2;Valle d'Aosta / Vallée d'Aoste;45.73750286;7.320149366;3;0;3;93;96;1;2;11090;472;11658;134605;64273
2021-06-16;SIC;40449;18809;21640;21270;18820;359;0;ITG;ITG1;19;Sicilia;38.11569725;13.3623567;292;36;328;5675;6003;-364;168;217940;5928;229871;4726745;1804496
2021-06-16;UMB;6326;3095;3231;3072;3100;154;0;ITI;ITI2;10;Umbria;43.10675841;12.38824698;44;4;48;989;1037;-21;11;54213;1417;56667;1396958;383913
2021-06-16;VEN;47803;23582;24221;25241;21461;1101;0;ITH;ITH3;5;Veneto;45.43490485;12.33845213;108;24;132;5477;5609;-107;84;407582;11601;424792;8367234;1799426
2021-06-16;CAM;31653;15011;16642;20345;10777;531;0;ITF;ITF3;15;Campania;40.83956555;14.25084984;337;23;360;11074;11434;-303;167;404125;7363;422922;5115546;3252481
2021-06-16;MAR;13756;6913;6843;9125;4366;265;0;ITI;ITI3;11;Marche;43.61675973;13.5188753;41;8;49;2601;2650;-21;29;97783;3026;103459;1274072;749818
2021-06-16;SAR;17641;8279;9362;12167;5313;161;0;ITG;ITG2;20;Sardegna;39.21531192;9.110616306;70;6;76;11688;11764;-103;24;43836;1485;57085;1345469;783111
2021-06-16;EMR;45966;23539;22427;25235;19971;760;0;ITH;ITH5;8;Emilia-Romagna;44.49436681;11.3417208;269;51;320;6351;6671;-577;73;366031;13239;385941;6492972;1889917
2021-06-16;LOM;99391;50491;48900;49850;48383;1158;0;ITC;ITC4;3;Lombardia;45.46679409;9.190347404;534;92;626;16618;17244;-1082;256;789029;33742;840015;11172472;4443012
2021-06-16;LAZ;64803;31128;33675;32078;32069;656;0;ITI;ITI4;12;Lazio;41.89277044;12.48366722;392;85;477;4767;5244;-258;143;331243;8292;344779;7325939;4408066
2021-06-16;CAL;18347;8477;9870;12127;6129;91;0;ITF;ITF6;18;Calabria;38.90597598;16.59440194;140;10;150;7267;7417;-346;66;59717;1214;68348;903303;829013
2021-06-16;LIG;16419;7934;8485;9176;7138;105;0;ITC;ITC3;7;Liguria;44.41149315;8.9326992;37;11;48;269;317;-67;21;98425;4343;103085;1689059;663351
2021-06-16;MOL;2150;1063;1087;1171;959;20;0;ITF;ITF2;14;Molise;41.55774754;14.65916051;8;0;8;74;82;0;2;13059;491;13632;235187;201360
2021-06-16;ABR;10894;5452;5442;7988;2689;217;0;ITF;ITF1;13;Abruzzo;42.35122196;13.39843823;65;4;69;1308;1377;-96;28;70616;2503;74496;1635653;672436
2021-06-16;TOS;31802;16280;15522;26286;5190;326;0;ITI;ITI1;9;Toscana;43.76923077;11.25588885;173;50;223;3638;3861;-195;106;232927;6832;243620;4960539;2302302
2021-06-16;PUG;42212;20775;21437;26931;14550;731;0;ITF;ITF4;16;Puglia;41.12559576;16.86736689;231;21;252;10777;11029;-282;112;234937;6595;252561;2590229;1216918
2021-06-16;PAB;3826;2029;1797;11;3810;5;0;ITH;ITH1;4;Provincia Autonoma Bolzano / Bozen;46.49933453;11.35662422;13;2;15;405;420;-24;34;71585;1180;73185;1593578;424321
2021-06-16;FVG;12206;5923;6283;3900;8040;266;0;ITH;ITH4;6;Friuli-Venezia Giulia;45.6494354;13.76813649;8;2;10;4530;4540;-7;23;99073;3795;107408;2104300;705558
2021-06-16;PIE;40509;20289;20220;23580;16287;642;0;ITC;ITC1;1;Piemonte;45.0732745;7.680687483;272;39;311;1888;2199;-179;59;348484;11684;362367;4776560;1915294
2021-06-16;PAT;6329;3418;2911;1990;4215;124;0;ITH;ITH2;4;Provincia Autonoma Trento;46.06893511;11.12123097;13;4;17;225;242;-4;2;44087;1360;45689;844955;223482
2021-06-17;VEN;51802;25950;25852;25567;25074;1161;0;ITH;ITH3;5;Veneto;45.43490485;12.33845213;105;23;128;5379;5507;-102;61;407745;11601;424853;8391407;1801501
2021-06-17;PAT;6754;3565;3189;2045;4539;170;0;ITH;ITH2;4;Provincia Autonoma Trento;46.06893511;11.12123097;10;3;13;189;202;-40;7;44134;1360;45696;846346;224038
2021-06-17;TOS;32625;16715;15910;26714;5565;346;0;ITI;ITI1;9;Toscana;43.76923077;11.25588885;158;42;200;3441;3641;-220;60;233201;6838;243680;4974633;2307737
2021-06-17;LOM;108689;52761;55928;50165;57339;1185;0;ITC;ITC4;3;Lombardia;45.46679409;9.190347404;496;90;586;16540;17126;-118;232;789375;33746;840247;11210125;4455908
2021-06-17;LIG;16712;7942;8770;9072;7547;93;0;ITC;ITC3;7;Liguria;44.41149315;8.9326992;32;9;41;247;288;-29;18;98472;4343;103103;1693468;664558
2021-06-17;MOL;2328;1027;1301;924;1373;31;0;ITF;ITF2;14;Molise;41.55774754;14.65916051;8;0;8;71;79;-3;4;13066;491;13636;234739;201507
2021-06-17;MAR;15207;7566;7641;8796;6113;298;0;ITI;ITI3;11;Marche;43.61675973;13.5188753;40;8;48;2385;2433;-217;21;98019;3028;103480;1276337;751003
2021-06-17;PIE;41263;20712;20551;24256;16376;631;0;ITC;ITC1;1;Piemonte;45.0732745;7.680687483;245;37;282;1777;2059;-140;72;348696;11684;362439;4794057;1920204
2021-06-17;VDA;994;530;464;638;342;14;0;ITC;ITC2;2;Valle d'Aosta / Vallée d'Aoste;45.73750286;7.320149366;4;0;4;86;90;-6;3;11099;472;11661;134997;64436
2021-06-17;PAB;1773;982;791;617;1078;78;0;ITH;ITH1;4;Provincia Autonoma Bolzano / Bozen;46.49933453;11.35662422;13;2;15;388;403;-17;8;71610;1180;73193;1595344;424364
2021-06-17;PUG;43002;21010;21992;21405;21035;562;0;ITF;ITF4;16;Puglia;41.12559576;16.86736689;218;19;237;9994;10231;-798;90;235823;6597;252651;2597073;1218638
2021-06-17;UMB;6980;3545;3435;4751;2082;147;0;ITI;ITI2;10;Umbria;43.10675841;12.38824698;41;5;46;967;1013;-24;4;54241;1417;56671;1397886;384109
2021-06-17;CAL;15822;7229;8593;9595;6171;56;0;ITF;ITF6;18;Calabria;38.90597598;16.59440194;123;11;134;7202;7336;-81;69;59864;1217;68417;905603;831163
2021-06-17;CAM;60218;28867;31351;32666;26801;751;0;ITF;ITF3;15;Campania;40.83956555;14.25084984;334;23;357;10723;11080;-354;131;404602;7371;423053;5130276;3253933
2021-06-17;SIC;41896;19506;22390;20362;21159;375;0;ITG;ITG1;19;Sicilia;38.11569725;13.3623567;283;35;318;5583;5901;-102;228;218270;5928;230099;4739951;1809647
2021-06-17;FVG;11447;5792;5655;2279;9051;117;0;ITH;ITH4;6;Friuli-Venezia Giulia;45.6494354;13.76813649;7;1;8;4526;4534;-6;23;99100;3797;107431;2109803;706694
2021-06-17;EMR;46717;23670;23047;21762;24239;716;0;ITH;ITH5;8;Emilia-Romagna;44.49436681;11.3417208;254;49;303;5935;6238;-433;89;366551;13239;386028;6509781;1891302
2021-06-17;SAR;18471;8533;9938;9916;8433;122;0;ITG;ITG2;20;Sardegna;39.21531192;9.110616306;72;6;78;11565;11643;-121;3;43960;1485;57088;1348621;785145
2021-06-17;BAS;4443;2045;2398;2088;2330;25;0;ITF;ITF5;17;Basilicata;40.63947052;15.80514834;37;0;37;2739;2776;-65;31;23401;587;26764;384771;207502
2021-06-17;ABR;10913;5457;5456;7297;3452;164;0;ITF;ITF1;13;Abruzzo;42.35122196;13.39843823;61;3;64;1295;1359;-18;27;70658;2506;74523;1639943;673399
2021-06-17;LAZ;67116;32303;34813;31801;34569;746;0;ITI;ITI4;12;Lazio;41.89277044;12.48366722;368;81;449;4445;4894;-350;119;331704;8300;344898;7350141;4412129
2021-06-18;ABR;10195;5006;5189;6551;3495;149;0;ITF;ITF1;13;Abruzzo;42.35122196;13.39843823;56;1;57;1245;1302;-57;22;70736;2507;74545;1643679;674385
2021-06-18;VDA;1004;446;558;589;401;14;0;ITC;ITC2;2;Valle d'Aosta / Vallée d'Aoste;45.73750286;7.320149366;2;0;2;79;81;-9;1;11109;472;11662;135248;64540
2021-06-18;BAS;4465;2066;2399;2179;2259;27;0;ITF;ITF5;17;Basilicata;40.63947052;15.80514834;35;0;35;2700;2735;-41;14;23456;587;26778;385514;207790
2021-06-18;EMR;42795;21459;21336;16272;25941;582;0;ITH;ITH5;8;Emilia-Romagna;44.49436681;11.3417208;246;40;286;5708;5994;-244;71;366860;13245;386099;6532281;1892833
2021-06-18;UMB;4814;2374;2440;1569;3166;79;0;ITI;ITI2;10;Umbria;43.10675841;12.38824698;41;5;46;978;1024;11;21;54251;1417;56692;1402962;384735
2021-06-18;TOS;30836;16273;14563;25003;5414;419;0;ITI;ITI1;9;Toscana;43.76923077;11.25588885;152;37;189;3281;3470;-171;67;233436;6841;243747;4990129;2312776
2021-06-18;LAZ;64499;31073;33426;30296;33431;772;0;ITI;ITI4;12;Lazio;41.89277044;12.48366722;337;77;414;4060;4474;-420;147;332268;8303;345045;7374435;4415322
2021-06-18;VEN;53664;26783;26881;23970;28645;1049;0;ITH;ITH3;5;Veneto;45.43490485;12.33845213;102;23;125;5260;5385;-122;72;407939;11601;424925;8421309;1803480
2021-06-18;CAL;18927;8815;10112;11284;7520;123;0;ITF;ITF6;18;Calabria;38.90597598;16.59440194;112;10;122;6899;7021;-315;77;60256;1217;68494;907924;833336
2021-06-18;LOM;107745;52915;54830;51778;54720;1247;0;ITC;ITC4;3;Lombardia;45.46679409;9.190347404;427;91;518;13314;13832;-3294;114;792781;33748;840361;11245195;4469167
2021-06-18;SAR;16491;7509;8982;8603;7772;116;0;ITG;ITG2;20;Sardegna;39.21531192;9.110616306;70;5;75;11531;11606;-37;8;44005;1485;57096;1350852;786762
2021-06-18;CAM;65900;31406;34494;34781;30314;805;0;ITF;ITF3;15;Campania;40.83956555;14.25084984;314;22;336;10436;10772;-308;107;405009;7379;423160;5143071;3256125
2021-06-18;PUG;47932;23594;24338;28882;18122;928;0;ITF;ITF4;16;Puglia;41.12559576;16.86736689;207;18;225;9118;9343;-888;106;236813;6601;252757;2603966;1220871
2021-06-18;SIC;43611;20149;23462;18859;24380;372;0;ITG;ITG1;19;Sicilia;38.11569725;13.3623567;259;30;289;5413;5702;-199;170;218636;5931;230269;4754159;1813148
2021-06-18;FVG;10993;5431;5562;3405;7319;269;0;ITH;ITH4;6;Friuli-Venezia Giulia;45.6494354;13.76813649;4;1;5;4509;4514;-20;23;99142;3798;107454;2114842;707749
2021-06-18;PIE;40762;20378;20384;25813;14251;698;0;ITC;ITC1;1;Piemonte;45.0732745;7.680687483;233;36;269;1636;1905;-154;58;348906;11686;362497;4816154;1926153
2021-06-18;PAT;7069;3761;3308;1782;5190;97;0;ITH;ITH2;4;Provincia Autonoma Trento;46.06893511;11.12123097;10;3;13;180;193;-9;4;44147;1360;45700;848323;224829
2021-06-18;MOL;2795;1264;1531;1304;1462;29;0;ITF;ITF2;14;Molise;41.55774754;14.65916051;8;0;8;75;83;4;10;13072;491;13646;235117;201881
2021-06-18;LIG;15428;7510;7918;8104;7226;98;0;ITC;ITC3;7;Liguria;44.41149315;8.9326992;35;8;43;243;286;-2;16;98489;4344;103119;1698259;665593
2021-06-18;MAR;15348;7649;7699;8294;6753;301;0;ITI;ITI3;11;Marche;43.61675973;13.5188753;36;8;44;2157;2201;-232;28;98277;3030;103508;1278764;752113
2021-06-18;PAB;4545;2351;2194;1448;2913;184;0;ITH;ITH1;4;Provincia Autonoma Bolzano / Bozen;46.49933453;11.35662422;15;2;17;371;388;-15;0;71625;1180;73193;1597508;424479
2021-06-19;SAR;15351;7517;7834;9117;6133;101;0;ITG;ITG2;20;Sardegna;39.21531192;9.110616306;68;5;73;11524;11597;-9;13;44027;1485;57109;1353439;788540
2021-06-19;CAM;62408;29712;32696;24050;37771;587;0;ITF;ITF3;15;Campania;40.83956555;14.25084984;296;20;316;10305;10621;-151;139;405295;7383;423299;5158527;3258292
2021-06-19;PIE;40165;20366;19799;22917;16689;559;0;ITC;ITC1;1;Piemonte;45.0732745;7.680687483;225;30;255;1543;1798;-107;66;349077;11688;362563;4841564;1933686
2021-06-19;UMB;4590;2207;2383;2462;2034;94;0;ITI;ITI2;10;Umbria;43.10675841;12.38824698;32;5;37;926;963;-61;12;54323;1418;56704;1407023;385268
2021-06-19;SIC;44309;21066;23243;18761;25225;323;0;ITG;ITG1;19;Sicilia;38.11569725;13.3623567;240;28;268;5347;5615;-87;183;218901;5936;230452;4767684;1817563
2021-06-19;VEN;49314;25087;24227;25674;22605;1035;0;ITH;ITH3;5;Veneto;45.43490485;12.33845213;88;22;110;5175;5285;-100;58;408096;11602;424983;8455687;1805189
2021-06-19;LOM;104418;52037;52381;56227;46765;1426;0;ITC;ITC4;3;Lombardia;45.46679409;9.190347404;402;80;482;13105;13587;-245;183;793206;33751;840544;11288625;4486360
2021-06-19;CAL;15858;7421;8437;8498;7292;68;0;ITF;ITF6;18;Calabria;38.90597598;16.59440194;100;11;111;6794;6905;-116;111;60481;1219;68605;910298;835580
2021-06-19;PAT;3147;1723;1424;236;2880;31;0;ITH;ITH2;4;Provincia Autonoma Trento;46.06893511;11.12123097;9;2;11;180;191;-2;11;44159;1361;45711;849931;225472
2021-06-19;EMR;36699;18367;18332;16735;19413;551;0;ITH;ITH5;8;Emilia-Romagna;44.49436681;11.3417208;233;39;272;5490;5762;-232;93;367185;13245;386192;6556503;1894310
2021-06-19;LAZ;66616;31431;35185;35276;30512;828;0;ITI;ITI4;12;Lazio;41.89277044;12.48366722;320;77;397;3962;4359;-115;101;332483;8304;345146;7401796;4419215
2021-06-19;LIG;7418;3777;3641;5685;1675;58;0;ITC;ITC3;7;Liguria;44.41149315;8.9326992;35;8;43;248;291;5;14;98497;4345;103133;1703688;665770
2021-06-19;FVG;8576;4469;4107;1353;7157;66;0;ITH;ITH4;6;Friuli-Venezia Giulia;45.6494354;13.76813649;4;1;5;4473;4478;-36;15;99192;3799;107469;2121754;709382
2021-06-19;PUG;34863;17486;17377;22238;11969;656;0;ITF;ITF4;16;Puglia;41.12559576;16.86736689;186;17;203;8706;8909;-434;61;237305;6604;252818;2611108;1221931
2021-06-19;MAR;14699;7405;7294;7750;6684;265;0;ITI;ITI3;11;Marche;43.61675973;13.5188753;32;8;40;2029;2069;-132;16;98424;3031;103524;1282111;753292
2021-06-19;TOS;26528;13933;12595;21395;4791;342;0;ITI;ITI1;9;Toscana;43.76923077;11.25588885;144;38;182;3106;3288;-182;62;233679;6842;243809;5009084;2317378
2021-06-19;ABR;10558;5202;5356;6483;3901;174;0;ITF;ITF1;13;Abruzzo;42.35122196;13.39843823;52;1;53;1224;1277;-25;25;70786;2507;74570;1648576;675788
2021-06-19;MOL;2381;1182;1199;1308;1026;47;0;ITF;ITF2;14;Molise;41.55774754;14.65916051;9;0;9;69;78;-5;1;13078;491;13647;235516;202274
2021-06-19;BAS;4466;2178;2288;2370;2074;22;0;ITF;ITF5;17;Basilicata;40.63947052;15.80514834;33;0;33;1799;1832;-903;13;24371;588;26791;386267;208086
2021-06-19;VDA;1295;671;624;658;621;16;0;ITC;ITC2;2;Valle d'Aosta / Vallée d'Aoste;45.73750286;7.320149366;3;0;3;71;74;-7;3;11119;472;11665;135553;64639
2021-06-19;PAB;5673;3024;2649;555;5043;75;0;ITH;ITH1;4;Provincia Autonoma Bolzano / Bozen;46.49933453;11.35662422;9;2;11;350;361;-27;9;71661;1180;73202;1601686;425115
2021-06-20;PAB;5252;2854;2398;591;4606;55;0;ITH;ITH1;4;Provincia Autonoma Bolzano / Bozen;46.49933453;11.35662422;9;2;11;347;358;-3;8;71672;1180;73210;1604883;425295
2021-06-20;PUG;21643;10874;10769;14067;7250;326;0;ITF;ITF4;16;Puglia;41.12559576;16.86736689;187;17;204;8655;8859;-50;45;237399;6605;252863;2615098;1222521
2021-06-20;MOL;424;174;250;48;372;4;0;ITF;ITF2;14;Molise;41.55774754;14.65916051;6;0;6;67;73;-5;4;13087;491;13651;235697;202454
2021-06-20;BAS;4010;1883;2127;1939;2036;35;0;ITF;ITF5;17;Basilicata;40.63947052;15.80514834;33;0;33;1267;1300;-532;36;24938;589;26827;386912;208358
2021-06-20;VDA;1134;545;589;476;644;14;0;ITC;ITC2;2;Valle d'Aosta / Vallée d'Aoste;45.73750286;7.320149366;3;0;3;61;64;-10;2;11131;472;11667;135890;64779
2021-06-20;LAZ;55357;25459;29898;29596;24982;779;0;ITI;ITI4;12;Lazio;41.89277044;12.48366722;300;77;377;3862;4239;-120;68;332671;8304;345214;7423680;4422078
2021-06-20;FVG;6530;3242;3288;1488;4941;101;0;ITH;ITH4;6;Friuli-Venezia Giulia;45.6494354;13.76813649;6;1;7;4472;4479;1;7;99198;3799;107476;2125342;710533
2021-06-20;ABR;8445;4237;4208;5408;2933;104;0;ITF;ITF1;13;Abruzzo;42.35122196;13.39843823;42;1;43;1212;1255;-22;35;70837;2509;74601;1654456;677828
2021-06-20;PAT;1901;1051;850;31;1865;5;0;ITH;ITH2;4;Provincia Autonoma Trento;46.06893511;11.12123097;8;2;10;168;178;-13;8;44180;1361;45719;851536;226114
2021-06-20;SIC;33453;15829;17624;15110;18080;263;0;ITG;ITG1;19;Sicilia;38.11569725;13.3623567;239;26;265;5295;5560;-55;135;219091;5936;230587;4773519;1820106
2021-06-20;UMB;6225;3007;3218;1577;4605;43;0;ITI;ITI2;10;Umbria;43.10675841;12.38824698;33;5;38;915;953;-10;19;54352;1418;56723;1410875;385737
2021-06-20;CAM;47619;22751;24868;14186;33001;432;0;ITF;ITF3;15;Campania;40.83956555;14.25084984;287;23;310;10062;10372;-249;82;405623;7386;423381;5171077;3259141
2021-06-20;VEN;41215;20068;21147;18920;21545;750;0;ITH;ITH3;5;Veneto;45.43490485;12.33845213;88;20;108;5104;5212;-73;26;408194;11603;425009;8472946;1806562
2021-06-20;SAR;6295;2807;3488;3635;2628;32;0;ITG;ITG2;20;Sardegna;39.21531192;9.110616306;68;5;73;11505;11578;-19;9;44055;1485;57118;1354772;789648
2021-06-20;EMR;30756;15603;15153;15588;14677;491;0;ITH;ITH5;8;Emilia-Romagna;44.49436681;11.3417208;223;38;261;5329;5590;-172;73;367429;13246;386265;6569590;1895524
2021-06-20;PIE;34153;17124;17029;18799;14785;569;0;ITC;ITC1;1;Piemonte;45.0732745;7.680687483;220;32;252;1446;1698;-100;31;349206;11690;362594;4850955;1937455
2021-06-20;LOM;89055;44377;44678;52785;35024;1246;0;ITC;ITC4;3;Lombardia;45.46679409;9.190347404;408;77;485;13172;13657;70;145;793279;33753;840689;11317204;4498922
2021-06-20;TOS;25188;12488;12700;15420;9524;244;0;ITI;ITI1;9;Toscana;43.76923077;11.25588885;134;38;172;3098;3270;-18;55;233747;6847;243864;5021816;2321363
2021-06-20;MAR;11161;5547;5614;5989;4989;183;0;ITI;ITI3;11;Marche;43.61675973;13.5188753;33;6;39;1973;2012;-57;15;98496;3031;103539;1283518;754261
2021-06-20;CAL;6652;3151;3501;3816;2808;28;0;ITF;ITF6;18;Calabria;38.90597598;16.59440194;89;11;100;6769;6869;-36;54;60571;1219;68659;911859;837033
2021-06-20;LIG;1336;658;678;1044;275;17;0;ITC;ITC3;7;Liguria;44.41149315;8.9326992;34;8;42;236;278;-13;18;98527;4346;103151;1707196;667008
2021-06-21;EMR;37602;19010;18592;16076;20898;628;0;ITH;ITH5;8;Emilia-Romagna;44.49436681;11.3417208;223;37;260;4986;5246;-344;81;367852;13248;386346;6577851;1896352
2021-06-21;CAL;15420;7106;8314;7999;7382;39;0;ITF;ITF6;18;Calabria;38.90597598;16.59440194;87;11;98;6698;6796;-73;20;60664;1219;68679;912801;837923
2021-06-21;LOM;113411;58100;55311;78187;33045;2179;0;ITC;ITC4;3;Lombardia;45.46679409;9.190347404;391;77;468;13179;13647;-10;83;793368;33757;840772;11327674;4504991
2021-06-21;LAZ;62074;28845;33229;28485;32960;629;0;ITI;ITI4;12;Lazio;41.89277044;12.48366722;295;76;371;3774;4145;-94;71;332833;8307;345285;7433902;4424199
2021-06-21;SAR;14039;6740;7299;5125;8838;76;0;ITG;ITG2;20;Sardegna;39.21531192;9.110616306;65;5;70;2422;2492;-9086;4;53145;1485;57122;1355601;790226
2021-06-21;PAB;3168;1615;1553;259;2868;41;0;ITH;ITH1;4;Provincia Autonoma Bolzano / Bozen;46.49933453;11.35662422;9;2;11;317;328;-30;19;71721;1180;73229;1607903;425528
2021-06-21;LIG;14854;7043;7811;8494;6261;99;0;ITC;ITC3;7;Liguria;44.41149315;8.9326992;34;8;42;201;243;-35;8;98569;4347;103159;1709438;667729
2021-06-21;TOS;31213;15501;15712;18142;12804;267;0;ITI;ITI1;9;Toscana;43.76923077;11.25588885;133;38;171;2856;3027;-243;45;234035;6847;243909;5026703;2323316
2021-06-21;PUG;42017;20488;21529;21482;19896;639;0;ITF;ITF4;16;Puglia;41.12559576;16.86736689;179;16;195;8225;8420;-439;19;237853;6609;252882;2619454;1223665
2021-06-21;PIE;38550;19273;19277;17186;20791;573;0;ITC;ITC1;1;Piemonte;45.0732745;7.680687483;213;30;243;1375;1618;-80;20;349305;11691;362614;4860609;1939628
2021-06-21;VEN;44344;22194;22150;20460;22974;910;0;ITH;ITH3;5;Veneto;45.43490485;12.33845213;87;20;107;5093;5200;-12;8;408214;11603;425017;8478184;1807590
2021-06-21;FVG;9224;4513;4711;1829;7258;137;0;ITH;ITH4;6;Friuli-Venezia Giulia;45.6494354;13.76813649;9;1;10;4471;4481;2;2;99198;3799;107478;2126484;710822
2021-06-21;CAM;46924;22687;24237;11188;35296;440;0;ITF;ITF3;15;Campania;40.83956555;14.25084984;282;24;306;9892;10198;-174;31;405824;7390;423412;5174322;3259390
2021-06-21;MOL;2943;1368;1575;1656;1239;48;0;ITF;ITF2;14;Molise;41.55774754;14.65916051;6;0;6;76;82;9;12;13090;491;13663;236278;203028
2021-06-21;MAR;12606;6183;6423;5479;6881;246;0;ITI;ITI3;11;Marche;43.61675973;13.5188753;29;6;35;1904;1939;-73;0;98569;3031;103539;1283702;754570
2021-06-21;PAT;6261;3387;2874;3644;2426;191;0;ITH;ITH2;4;Provincia Autonoma Trento;46.06893511;11.12123097;9;2;11;155;166;-12;8;44200;1361;45727;853890;227056
2021-06-21;BAS;4258;2045;2213;2142;2095;21;0;ITF;ITF5;17;Basilicata;40.63947052;15.80514834;33;0;33;1231;1264;-36;4;24978;589;26831;387140;208440
2021-06-21;ABR;11060;5390;5670;4940;5990;130;0;ITF;ITF1;13;Abruzzo;42.35122196;13.39843823;44;1;45;1230;1275;20;27;70844;2509;74628;1658875;679371
2021-06-21;UMB;7553;3953;3600;5068;2338;147;0;ITI;ITI2;10;Umbria;43.10675841;12.38824698;33;5;38;888;926;-27;13;54392;1418;56736;1415374;386146
2021-06-21;SIC;40253;18633;21620;18418;21505;330;0;ITG;ITG1;19;Sicilia;38.11569725;13.3623567;237;25;262;5247;5509;-51;85;219225;5938;230672;4789615;1822473
2021-06-21;VDA;1124;600;524;607;507;10;0;ITC;ITC2;2;Valle d'Aosta / Vallée d'Aoste;45.73750286;7.320149366;3;0;3;58;61;-3;3;11137;472;11670;136302;64960
2021-06-22;LIG;15822;7469;8353;7607;8142;73;0;ITC;ITC3;7;Liguria;44.41149315;8.9326992;27;8;35;190;225;-18;10;98596;4348;103169;1714641;669018
2021-06-22;TOS;31074;15640;15434;22470;8224;380;0;ITI;ITI1;9;Toscana;43.76923077;11.25588885;126;38;164;2687;2851;-176;25;234234;6849;243934;5040242;2328124
2021-06-22;MAR;13219;6482;6737;6475;6461;283;0;ITI;ITI3;11;Marche;43.61675973;13.5188753;30;6;36;1763;1799;-140;17;98724;3033;103556;1285822;755505
2021-06-22;ABR;10409;4877;5532;5381;4846;182;0;ITF;ITF1;13;Abruzzo;42.35122196;13.39843823;43;2;45;1172;1217;-58;5;70896;2509;74622;1659778;679570
2021-06-22;PAB;2472;1423;1049;315;2127;30;0;ITH;ITH1;4;Provincia Autonoma Bolzano / Bozen;46.49933453;11.35662422;9;2;11;294;305;-23;9;71753;1180;73238;1611203;425668
2021-06-22;PUG;42607;20671;21936;19065;22969;573;0;ITF;ITF4;16;Puglia;41.12559576;16.86736689;173;16;189;6874;7063;-1357;92;239301;6610;252974;2627487;1226120
2021-06-22;BAS;4355;2061;2294;2223;2100;32;0;ITF;ITF5;17;Basilicata;40.63947052;15.80514834;29;0;29;1207;1236;-28;13;25019;589;26844;387904;208685
2021-06-22;VDA;1192;666;526;531;649;12;0;ITC;ITC2;2;Valle d'Aosta / Vallée d'Aoste;45.73750286;7.320149366;4;0;4;53;57;-4;4;11145;472;11674;136736;65165
2021-06-22;EMR;36547;18202;18345;16252;19646;649;0;ITH;ITH5;8;Emilia-Romagna;44.49436681;11.3417208;210;34;244;4659;4903;-343;44;368236;13250;386389;6593740;1898050
2021-06-22;LOM;111270;58117;53153;79175;29967;2128;0;ITC;ITC4;3;Lombardia;45.46679409;9.190347404;389;73;462;12993;13455;-192;126;793685;33758;840898;11354963;4515333
2021-06-22;SAR;19343;8993;10350;7166;12076;101;0;ITG;ITG2;20;Sardegna;39.21531192;9.110616306;53;4;57;2384;2441;-51;6;53199;1488;57128;1360214;792858
2021-06-22;UMB;8092;4105;3987;5145;2801;146;0;ITI;ITI2;10;Umbria;43.10675841;12.38824698;30;4;34;860;894;-32;8;54432;1418;56744;1420999;386550
2021-06-22;PIE;40735;20143;20592;17817;22342;576;0;ITC;ITC1;1;Piemonte;45.0732745;7.680687483;208;25;233;1228;1461;-157;45;349505;11693;362659;4878386;1944998
2021-06-22;PAT;6387;3479;2908;3628;2568;191;0;ITH;ITH2;4;Provincia Autonoma Trento;46.06893511;11.12123097;9;2;11;138;149;-17;4;44221;1361;45731;855808;227823
2021-06-22;FVG;11615;5981;5634;2361;9114;140;0;ITH;ITH4;6;Friuli-Venezia Giulia;45.6494354;13.76813649;9;0;9;4370;4379;-102;15;99315;3799;107493;2131439;711840
2021-06-22;SIC;40060;18410;21650;18341;21340;379;0;ITG;ITG1;19;Sicilia;38.11569725;13.3623567;226;25;251;4958;5209;-300;133;219651;5945;230805;4802925;1828065
2021-06-22;LAZ;62893;29101;33792;28586;33571;736;0;ITI;ITI4;12;Lazio;41.89277044;12.48366722;285;75;360;3641;4001;-144;74;333050;8308;345359;7459999;4427576
2021-06-22;CAM;52455;25016;27439;13058;39005;392;0;ITF;ITF3;15;Campania;40.83956555;14.25084984;274;23;297;9677;9974;-224;94;406141;7391;423506;5189615;3260631
2021-06-22;CAL;14628;6919;7709;7379;7152;97;0;ITF;ITF6;18;Calabria;38.90597598;16.59440194;85;11;96;6317;6413;-383;17;61063;1220;68696;915264;840302
2021-06-22;MOL;2985;1378;1607;676;2289;20;0;ITF;ITF2;14;Molise;41.55774754;14.65916051;6;0;6;75;81;-1;7;13098;491;13670;236681;203425
2021-06-22;VEN;43749;21631;22118;18501;24390;858;0;ITH;ITH3;5;Veneto;45.43490485;12.33845213;75;13;88;4964;5052;-148;96;408452;11609;425113;8500633;1809926
2021-06-23;BAS;3240;1522;1718;2331;876;33;0;ITF;ITF5;17;Basilicata;40.63947052;15.80514834;31;0;31;877;908;-328;12;25359;589;26856;388677;208977
2021-06-23;VDA;1045;551;494;423;617;5;0;ITC;ITC2;2;Valle d'Aosta / Vallée d'Aoste;45.73750286;7.320149366;3;0;3;49;52;-5;0;11150;472;11674;136837;65201
2021-06-23;CAL;17258;7880;9378;8147;9026;85;0;ITF;ITF6;18;Calabria;38.90597598;16.59440194;83;7;90;6087;6177;-236;67;61365;1221;68763;918171;842853
2021-06-23;ABR;11016;5284;5732;5577;5292;147;0;ITF;ITF1;13;Abruzzo;42.35122196;13.39843823;41;2;43;1093;1136;-81;13;70990;2509;74635;1663271;680690
2021-06-23;TOS;31589;15321;16268;19821;11400;368;0;ITI;ITI1;9;Toscana;43.76923077;11.25588885;118;32;150;2503;2653;-198;50;234478;6853;243984;5054045;2332742
2021-06-23;EMR;38085;19099;18986;18455;18892;738;0;ITH;ITH5;8;Emilia-Romagna;44.49436681;11.3417208;203;32;235;4203;4438;-465;55;368752;13250;386440;6610169;1899737
2021-06-23;VEN;49383;24467;24916;14539;34040;804;0;ITH;ITH3;5;Veneto;45.43490485;12.33845213;68;13;81;4815;4896;-156;49;408655;11608;425162;8523931;1812035
2021-06-23;LAZ;62406;29403;33003;28429;33467;510;0;ITI;ITI4;12;Lazio;41.89277044;12.48366722;256;75;331;3561;3892;-109;97;333254;8310;345456;7483403;4430922
2021-06-23;UMB;11360;5806;5554;7678;3412;270;0;ITI;ITI2;10;Umbria;43.10675841;12.38824698;26;4;30;860;890;-4;27;54463;1418;56771;1425179;386953
2021-06-23;CAM;46779;22097;24682;10570;35806;403;0;ITF;ITF3;15;Campania;40.83956555;14.25084984;263;22;285;9465;9750;-224;110;406473;7393;423616;5204105;3262082
2021-06-23;SAR;20549;9669;10880;6192;14264;93;0;ITG;ITG2;20;Sardegna;39.21531192;9.110616306;53;4;57;2349;2406;-35;18;53251;1489;57146;1364083;795014
2021-06-23;SIC;44523;20716;23807;17926;26258;339;0;ITG;ITG1;19;Sicilia;38.11569725;13.3623567;206;25;231;4677;4908;-301;158;220104;5951;230963;4815390;1832077
2021-06-23;LOM;111096;57471;53625;76633;32318;2145;0;ITC;ITC4;3;Lombardia;45.46679409;9.190347404;350;72;422;12229;12651;-804;131;794617;33761;841029;11387943;4526437
2021-06-23;LIG;14354;6868;7486;9042;5211;101;0;ITC;ITC3;7;Liguria;44.41149315;8.9326992;25;8;33;181;214;-11;10;98809;4349;103372;1726201;674008
2021-06-23;MAR;13892;6818;7074;6626;7010;256;0;ITI;ITI3;11;Marche;43.61675973;13.5188753;27;5;32;1639;1671;-128;15;98866;3034;103571;1288484;756880
2021-06-23;MOL;2820;1299;1521;223;2587;10;0;ITF;ITF2;14;Molise;41.55774754;14.65916051;6;0;6;84;90;9;12;13101;491;13682;237156;203894
2021-06-23;PAB;1153;595;558;332;768;53;0;ITH;ITH1;4;Provincia Autonoma Bolzano / Bozen;46.49933453;11.35662422;8;3;11;286;297;-8;8;71769;1180;73246;1615236;425847
2021-06-23;PUG;29484;14407;15077;16945;11926;613;0;ITF;ITF4;16;Puglia;41.12559576;16.86736689;170;16;186;5751;5937;-1126;63;240487;6613;253037;2634171;1227508
2021-06-23;FVG;12106;5860;6246;1989;9963;154;0;ITH;ITH4;6;Friuli-Venezia Giulia;45.6494354;13.76813649;9;0;9;4345;4354;-25;9;99348;3785;107502;2136884;712836
2021-06-23;PIE;39848;19792;20056;16428;22908;512;0;ITC;ITC1;1;Piemonte;45.0732745;7.680687483;200;23;223;1110;1333;-128;51;349684;11693;362710;4892628;1949538
2021-06-23;PAT;6696;3547;3149;4626;1872;198;0;ITH;ITH2;4;Provincia Autonoma Trento;46.06893511;11.12123097;9;2;11;133;144;-5;2;44228;1361;45733;856225;227990
2021-06-24;FVG;11132;5681;5451;1892;9123;117;0;ITH;ITH4;6;Friuli-Venezia Giulia;45.6494354;13.76813649;10;0;10;227;237;-4117;25;102843;3787;106867;2132449;676428
2021-06-24;SIC;42373;19674;22699;17635;24377;361;0;ITG;ITG1;19;Sicilia;38.11569725;13.3623567;185;27;212;4541;4753;-155;119;220372;5957;231082;4832352;1837126
2021-06-24;CAM;66130;31870;34260;13268;52319;543;0;ITF;ITF3;15;Campania;40.83956555;14.25084984;252;20;272;9304;9576;-174;112;406752;7400;423728;5218264;3263503
2021-06-24;LOM;109779;56745;53034;78369;29020;2390;0;ITC;ITC4;3;Lombardia;45.46679409;9.190347404;321;65;386;12116;12502;-149;155;794917;33765;841184;11420780;4538111
2021-06-24;TOS;29474;14636;14838;19322;9754;398;0;ITI;ITI1;9;Toscana;43.76923077;11.25588885;113;29;142;2413;2555;-98;73;234648;6854;244057;5067998;2337929
2021-06-24;PIE;39344;19744;19600;18372;20358;614;0;ITC;ITC1;1;Piemonte;45.0732745;7.680687483;202;17;219;1048;1267;-66;36;349785;11694;362746;4906505;1953901
2021-06-24;LIG;11179;5454;5725;6213;4878;88;0;ITC;ITC3;7;Liguria;44.41149315;8.9326992;21;8;29;180;209;-5;10;98824;4349;103382;1734904;677053
2021-06-24;LAZ;64107;30578;33529;28606;34826;675;0;ITI;ITI4;12;Lazio;41.89277044;12.48366722;254;74;328;3323;3651;-241;97;333589;8313;345553;7505198;4434406
2021-06-24;VEN;56243;28486;27757;17627;37916;700;0;ITH;ITH3;5;Veneto;45.43490485;12.33845213;59;12;71;4756;4827;-69;35;408762;11608;425197;8550289;1813875
2021-06-24;SAR;19205;9214;9991;8111;10988;106;0;ITG;ITG2;20;Sardegna;39.21531192;9.110616306;42;5;47;2330;2377;-29;16;53296;1489;57162;1367138;797319
2021-06-24;MAR;13844;6678;7166;6186;7387;271;0;ITI;ITI3;11;Marche;43.61675973;13.5188753;27;6;33;1587;1620;-51;12;98929;3034;103583;1290342;757778
2021-06-24;PAT;6058;3172;2886;3646;2210;202;0;ITH;ITH2;4;Provincia Autonoma Trento;46.06893511;11.12123097;8;3;11;113;124;-20;3;44251;1361;45736;857699;228579
2021-06-24;PUG;53131;25700;27431;23609;28735;787;0;ITF;ITF4;16;Puglia;41.12559576;16.86736689;165;16;181;5131;5312;-625;42;241154;6613;253079;2640463;1229352
2021-06-24;MOL;3365;1566;1799;445;2882;38;0;ITF;ITF2;14;Molise;41.55774754;14.65916051;6;0;6;77;83;-7;0;13108;491;13682;237329;204066
2021-06-24;PAB;3947;2043;1904;1551;2205;191;0;ITH;ITH1;4;Provincia Autonoma Bolzano / Bozen;46.49933453;11.35662422;6;3;9;267;276;-21;8;71798;1180;73254;1616983;425998
2021-06-24;VDA;1227;631;596;381;837;9;0;ITC;ITC2;2;Valle d'Aosta / Vallée d'Aoste;45.73750286;7.320149366;1;0;1;44;45;-7;1;11157;473;11675;137188;65305
2021-06-24;CAL;15425;7026;8399;6983;8361;81;0;ITF;ITF6;18;Calabria;38.90597598;16.59440194;78;9;87;5932;6019;-158;30;61551;1223;68793;920745;845087
2021-06-24;UMB;10268;5169;5099;6025;4014;229;0;ITI;ITI2;10;Umbria;43.10675841;12.38824698;26;4;30;853;883;-7;4;54474;1418;56775;1426496;387233
2021-06-24;EMR;40661;20423;20238;20261;19577;823;0;ITH;ITH5;8;Emilia-Romagna;44.49436681;11.3417208;196;30;226;3973;4199;-239;72;369062;13251;386512;6626830;1901228
2021-06-24;BAS;4090;1939;2151;2151;1901;38;0;ITF;ITF5;17;Basilicata;40.63947052;15.80514834;27;0;27;870;897;-11;28;25398;589;26884;389439;209281
2021-06-24;ABR;10871;5411;5460;5720;4979;172;0;ITF;ITF1;13;Abruzzo;42.35122196;13.39843823;35;2;37;1047;1084;-52;20;71060;2511;74655;1667761;681806
2021-06-25;ABR;11061;5479;5582;4902;6015;144;0;ITF;ITF1;13;Abruzzo;42.35122196;13.39843823;31;2;33;1004;1037;-47;40;71145;2512;74694;1672175;682817
2021-06-25;MOL;3465;1706;1759;1480;1922;63;0;ITF;ITF2;14;Molise;41.55774754;14.65916051;7;0;7;78;85;2;1;13107;491;13683;237688;204422
2021-06-25;SIC;39812;18685;21127;17384;22086;342;0;ITG;ITG1;19;Sicilia;38.11569725;13.3623567;175;23;198;4233;4431;-322;67;220755;5963;231149;4843984;1839745
2021-06-25;VEN;51729;26171;25558;15075;36012;642;0;ITH;ITH3;5;Veneto;45.43490485;12.33845213;61;11;72;4698;4770;-57;35;408854;11608;425232;8571941;1815258
2021-06-25;UMB;10245;5321;4924;5255;4787;203;0;ITI;ITI2;10;Umbria;43.10675841;12.38824698;26;3;29;848;877;-6;7;54487;1418;56782;1430855;387733
2021-06-25;BAS;3317;1571;1746;2444;839;34;0;ITF;ITF5;17;Basilicata;40.63947052;15.80514834;25;0;25;831;856;-41;8;25447;589;26892;390159;209572
2021-06-25;LOM;108345;56263;52082;78359;27674;2312;0;ITC;ITC4;3;Lombardia;45.46679409;9.190347404;298;63;361;12187;12548;46;134;795003;33767;841318;11454108;4550436
2021-06-25;PIE;45646;22743;22903;20299;24606;741;0;ITC;ITC1;1;Piemonte;45.0732745;7.680687483;195;16;211;990;1201;-66;35;349886;11694;362781;4928409;1958936
2021-06-25;SAR;16519;7815;8704;3893;12568;58;0;ITG;ITG2;20;Sardegna;39.21531192;9.110616306;40;4;44;2316;2360;-17;11;53324;1489;57173;1370160;798948
2021-06-25;EMR;42871;21817;21054;19736;22319;816;0;ITH;ITH5;8;Emilia-Romagna;44.49436681;11.3417208;188;29;217;3762;3979;-220;57;369334;13256;386569;6645777;1902480
2021-06-25;LAZ;63501;30676;32825;28123;34761;617;0;ITI;ITI4;12;Lazio;41.89277044;12.48366722;224;64;288;3326;3614;-37;91;333712;8318;345644;7528916;4437373
2021-06-25;TOS;33659;16835;16824;12105;21270;284;0;ITI;ITI1;9;Toscana;43.76923077;11.25588885;105;27;132;2314;2446;-109;42;234793;6860;244099;5080841;2342012
2021-06-25;CAM;65518;31804;33714;13588;51347;583;0;ITF;ITF3;15;Campania;40.83956555;14.25084984;240;20;260;9121;9381;-195;77;407016;7408;423805;5230884;3264997
2021-06-25;MAR;14344;7171;7173;6418;7637;289;0;ITI;ITI3;11;Marche;43.61675973;13.5188753;24;6;30;1509;1539;-81;13;99022;3035;103596;1292676;758595
2021-06-25;CAL;18839;8747;10092;8061;10689;89;0;ITF;ITF6;18;Calabria;38.90597598;16.59440194;72;7;79;5853;5932;-87;39;61676;1224;68832;923227;847233
2021-06-25;LIG;13853;6623;7230;6844;6924;85;0;ITC;ITC3;7;Liguria;44.41149315;8.9326992;22;8;30;171;201;-8;6;98838;4349;103388;1737976;677932
2021-06-25;PAT;7805;4162;3643;4155;3449;201;0;ITH;ITH2;4;Provincia Autonoma Trento;46.06893511;11.12123097;7;3;10;119;129;5;8;44254;1361;45744;859159;229163
2021-06-25;FVG;11019;5537;5482;2358;8569;92;0;ITH;ITH4;6;Friuli-Venezia Giulia;45.6494354;13.76813649;13;0;13;222;235;-2;20;102864;3787;106886;2137984;677461
2021-06-25;PAB;4182;2310;1872;1022;3014;146;0;ITH;ITH1;4;Provincia Autonoma Bolzano / Bozen;46.49933453;11.35662422;6;3;9;240;249;-27;3;71828;1180;73257;1617828;426064
2021-06-25;VDA;980;445;535;321;654;5;0;ITC;ITC2;2;Valle d'Aosta / Vallée d'Aoste;45.73750286;7.320149366;1;0;1;37;38;-7;1;11165;473;11676;137485;65402
2021-06-25;PUG;50997;25116;25881;23845;26248;904;0;ITF;ITF4;16;Puglia;41.12559576;16.86736689;150;17;167;4334;4501;-811;68;242011;6635;253147;2645845;1230965
2021-06-26;LAZ;56267;26528;29739;24703;30954;610;0;ITI;ITI4;12;Lazio;41.89277044;12.48366722;194;60;254;3244;3498;-116;79;333904;8321;345723;7555559;4440856
2021-06-26;CAL;15587;7204;8383;7574;7942;71;0;ITF;ITF6;18;Calabria;38.90597598;16.59440194;65;7;72;5587;5659;-273;37;61986;1224;68869;925269;849057
2021-06-26;FVG;10402;5308;5094;4106;6176;120;0;ITH;ITH4;6;Friuli-Venezia Giulia;45.6494354;13.76813649;14;0;14;209;223;-12;19;102895;3787;106905;2143959;678890
2021-06-26;PIE;41308;21017;20291;21981;18604;723;0;ITC;ITC1;1;Piemonte;45.0732745;7.680687483;180;17;197;907;1104;-97;37;350020;11694;362818;4952162;1966575
2021-06-26;SIC;37270;17782;19488;16349;20613;308;0;ITG;ITG1;19;Sicilia;38.11569725;13.3623567;166;20;186;4186;4372;-59;111;220924;5964;231260;4857295;1843817
2021-06-26;SAR;19164;9012;10152;5449;13637;78;0;ITG;ITG2;20;Sardegna;39.21531192;9.110616306;37;3;40;2316;2356;-4;19;53346;1490;57192;1373052;800702
2021-06-26;CAM;62953;30696;32257;14494;47864;595;0;ITF;ITF3;15;Campania;40.83956555;14.25084984;236;22;258;8898;9156;-225;127;407348;7428;423932;5244992;3267101
2021-06-26;UMB;9381;4758;4623;5579;3639;163;0;ITI;ITI2;10;Umbria;43.10675841;12.38824698;23;2;25;856;881;4;15;54497;1419;56797;1434732;388430
2021-06-26;EMR;37495;19003;18492;21009;15545;941;0;ITH;ITH5;8;Emilia-Romagna;44.49436681;11.3417208;185;27;212;3623;3835;-144;65;369543;13256;386634;6668894;1903927
2021-06-26;TOS;34589;16775;17814;9989;24366;234;0;ITI;ITI1;9;Toscana;43.76923077;11.25588885;96;28;124;2294;2418;-28;52;234873;6860;244151;5097801;2346342
2021-06-26;PAT;1439;756;683;676;727;36;0;ITH;ITH2;4;Provincia Autonoma Trento;46.06893511;11.12123097;8;3;11;95;106;-23;4;44281;1361;45748;860696;229778
2021-06-26;VEN;48093;24519;23574;13592;34008;493;0;ITH;ITH3;5;Veneto;45.43490485;12.33845213;59;11;70;4636;4706;-64;38;408953;11611;425270;8598059;1817290
2021-06-26;MOL;3144;1546;1598;531;2598;15;0;ITF;ITF2;14;Molise;41.55774754;14.65916051;6;0;6;76;82;-3;2;13112;491;13685;238191;204919
2021-06-26;PAB;4550;2332;2218;1350;3078;122;0;ITH;ITH1;4;Provincia Autonoma Bolzano / Bozen;46.49933453;11.35662422;7;3;10;225;235;-14;3;71845;1180;73260;1620880;426253
2021-06-26;MAR;13578;6907;6671;5689;7672;217;0;ITI;ITI3;11;Marche;43.61675973;13.5188753;23;6;29;1436;1465;-74;5;99100;3036;103601;1294583;759482
2021-06-26;LOM;105936;55459;50477;77782;25747;2407;0;ITC;ITC4;3;Lombardia;45.46679409;9.190347404;269;64;333;11502;11835;-713;115;795826;33772;841433;11490807;4564734
2021-06-26;LIG;7230;3366;3864;4428;2724;78;0;ITC;ITC3;7;Liguria;44.41149315;8.9326992;15;8;23;157;180;-21;8;98867;4349;103396;1743764;680039
2021-06-26;PUG;32492;16368;16124;15890;16029;573;0;ITF;ITF4;16;Puglia;41.12559576;16.86736689;146;15;161;3720;3881;-620;58;242684;6640;253205;2652289;1232938
2021-06-26;VDA;1066;512;554;351;707;8;0;ITC;ITC2;2;Valle d'Aosta / Vallée d'Aoste;45.73750286;7.320149366;1;0;1;34;35;-3;2;11170;473;11678;138002;65515
2021-06-26;ABR;10052;5018;5034;5688;4201;163;0;ITF;ITF1;13;Abruzzo;42.35122196;13.39843823;28;1;29;996;1025;-12;19;71175;2512;74712;1677066;684151
2021-06-26;BAS;3337;1614;1723;2750;558;29;0;ITF;ITF5;17;Basilicata;40.63947052;15.80514834;22;0;22;809;831;-25;19;25490;590;26911;391058;209949
2021-06-27;MAR;9950;4819;5131;4486;5293;171;0;ITI;ITI3;11;Marche;43.61675973;13.5188753;23;6;29;1386;1415;-50;13;99163;3036;103614;1295886;760452
2021-06-27;PAB;4429;2315;2114;567;3810;52;0;ITH;ITH1;4;Provincia Autonoma Bolzano / Bozen;46.49933453;11.35662422;6;3;9;208;217;-18;10;71873;1180;73270;1623273;426460
2021-06-27;MOL;2389;1129;1260;1141;1237;11;0;ITF;ITF2;14;Molise;41.55774754;14.65916051;8;0;8;80;88;6;6;13112;491;13691;238519;205247
2021-06-27;PUG;18585;9231;9354;9951;8367;267;0;ITF;ITF4;16;Puglia;41.12559576;16.86736689;145;14;159;3716;3875;-6;33;242723;6640;253238;2656229;1233586
2021-06-27;ABR;8367;4299;4068;5018;3208;141;0;ITF;ITF1;13;Abruzzo;42.35122196;13.39843823;25;1;26;981;1007;-18;20;71213;2512;74732;1683645;686360
2021-06-27;BAS;3007;1477;1530;2377;616;14;0;ITF;ITF5;17;Basilicata;40.63947052;15.80514834;23;0;23;820;843;12;22;25500;590;26933;391776;210225
2021-06-27;CAL;8426;3949;4477;4984;3400;42;0;ITF;ITF6;18;Calabria;38.90597598;16.59440194;64;6;70;5439;5509;-150;36;62172;1224;68905;926941;850353
2021-06-27;CAM;43561;21452;22109;13969;29073;519;0;ITF;ITF3;15;Campania;40.83956555;14.25084984;220;23;243;8758;9001;-155;95;407593;7433;424027;5256789;3268552
2021-06-27;LOM;90961;46826;44135;69777;18879;2305;0;ITC;ITC4;3;Lombardia;45.46679409;9.190347404;258;62;320;11527;11847;12;119;795931;33774;841552;11517245;4576420
2021-06-27;EMR;29602;14897;14705;16190;12737;675;0;ITH;ITH5;8;Emilia-Romagna;44.49436681;11.3417208;185;28;213;3510;3723;-112;61;369715;13257;386695;6681109;1905171
2021-06-27;VDA;1254;609;645;311;931;12;0;ITC;ITC2;2;Valle d'Aosta / Vallée d'Aoste;45.73750286;7.320149366;1;0;1;36;37;2;5;11173;473;11683;138266;65618
2021-06-27;LIG;1951;896;1055;679;1254;18;0;ITC;ITC3;7;Liguria;44.41149315;8.9326992;15;8;23;151;174;-6;10;98882;4350;103406;1746879;681286
2021-06-27;LAZ;47277;21624;25653;20563;26207;507;0;ITI;ITI4;12;Lazio;41.89277044;12.48366722;209;57;266;3205;3471;-27;93;334023;8322;345816;7573753;4443406
2021-06-27;FVG;7681;3838;3843;3691;3863;127;0;ITH;ITH4;6;Friuli-Venezia Giulia;45.6494354;13.76813649;14;0;14;203;217;-6;8;102907;3787;106911;2147073;679861
2021-06-27;SIC;25313;12202;13111;12097;12984;232;0;ITG;ITG1;19;Sicilia;38.11569725;13.3623567;162;23;185;4183;4368;-4;111;221038;5965;231371;4861815;1846120
2021-06-27;SAR;9020;4311;4709;2957;6035;28;0;ITG;ITG2;20;Sardegna;39.21531192;9.110616306;37;3;40;2315;2355;-1;15;53362;1490;57207;1374665;802033
2021-06-27;UMB;7480;3738;3742;1731;5671;78;0;ITI;ITI2;10;Umbria;43.10675841;12.38824698;21;2;23;813;836;-45;9;54551;1419;56806;1438100;388897
2021-06-27;PIE;37607;18632;18975;15220;21774;613;0;ITC;ITC1;1;Piemonte;45.0732745;7.680687483;174;15;189;872;1061;-43;31;350094;11694;362849;4961203;1969887
2021-06-27;PAT;1369;736;633;395;961;13;0;ITH;ITH2;4;Provincia Autonoma Trento;46.06893511;11.12123097;8;3;11;84;95;-11;6;44298;1361;45754;862045;230318
2021-06-27;VEN;40243;20558;19685;15346;24313;584;0;ITH;ITH3;5;Veneto;45.43490485;12.33845213;59;11;70;4642;4712;6;43;408989;11612;425313;8614165;1818749
2021-06-27;TOS;33314;16085;17229;5912;27268;134;0;ITI;ITI1;9;Toscana;43.76923077;11.25588885;89;31;120;2265;2385;-33;35;234940;6861;244186;5109341;2350088
2021-06-28;VDA;994;499;495;327;662;5;0;ITC;ITC2;2;Valle d'Aosta / Vallée d'Aoste;45.73750286;7.320149366;1;0;1;36;37;0;0;11173;473;11683;138733;65854
2021-06-28;BAS;3641;1747;1894;2113;1509;19;0;ITF;ITF5;17;Basilicata;40.63947052;15.80514834;23;0;23;754;777;-66;0;25566;590;26933;392020;210331
2021-06-28;PIE;38516;19125;19391;15148;22757;611;0;ITC;ITC1;1;Piemonte;45.0732745;7.680687483;164;14;178;815;993;-68;14;350174;11696;362863;4971363;1972662
2021-06-28;PAT;6965;3602;3363;2934;3869;162;0;ITH;ITH2;4;Provincia Autonoma Trento;46.06893511;11.12123097;7;2;9;81;90;-5;3;44306;1361;45757;864042;231116
2021-06-28;EMR;40083;19670;20413;19626;19581;876;0;ITH;ITH5;8;Emilia-Romagna;44.49436681;11.3417208;191;28;219;3253;3472;-251;64;370027;13258;386757;6689488;1905902
2021-06-28;FVG;9929;5004;4925;2108;7715;106;0;ITH;ITH4;6;Friuli-Venezia Giulia;45.6494354;13.76813649;14;0;14;201;215;-2;3;102911;3788;106914;2148527;680224
2021-06-28;SAR;14994;7041;7953;3048;11879;67;0;ITG;ITG2;20;Sardegna;39.21531192;9.110616306;40;3;43;2295;2338;-17;1;53380;1490;57208;1376144;802667
2021-06-28;LOM;108112;55071;53041;74294;31201;2617;0;ITC;ITC4;3;Lombardia;45.46679409;9.190347404;250;61;311;10914;11225;-622;46;796598;33775;841598;11526703;4582099
2021-06-28;CAM;46536;22742;23794;20363;25414;759;0;ITF;ITF3;15;Campania;40.83956555;14.25084984;216;23;239;8345;8584;-417;48;408041;7450;424075;5260068;3269298
2021-06-28;TOS;37713;18149;19564;8435;29106;172;0;ITI;ITI1;9;Toscana;43.76923077;11.25588885;92;30;122;1993;2115;-270;33;235242;6862;244219;5113862;2351935
2021-06-28;PUG;48788;23658;25130;21668;26324;796;0;ITF;ITF4;16;Puglia;41.12559576;16.86736689;143;14;157;3315;3472;-403;9;243135;6640;253247;2660485;1234825
2021-06-28;ABR;10056;4837;5219;5309;4577;170;0;ITF;ITF1;13;Abruzzo;42.35122196;13.39843823;26;1;27;1002;1029;22;29;71220;2512;74761;1688315;687924
2021-06-28;VEN;47682;24131;23551;18417;28558;707;0;ITH;ITH3;5;Veneto;45.43490485;12.33845213;58;11;69;4647;4716;4;20;409005;11612;425333;8618714;1819506
2021-06-28;CAL;13311;6129;7182;5371;7871;69;0;ITF;ITF6;18;Calabria;38.90597598;16.59440194;66;6;72;5373;5445;-64;7;62243;1224;68912;927962;851319
2021-06-28;LIG;11631;5630;6001;7200;4317;114;0;ITC;ITC3;7;Liguria;44.41149315;8.9326992;16;7;23;136;159;-15;0;98897;4350;103406;1748480;681684
2021-06-28;MAR;12364;6026;6338;4614;7512;238;0;ITI;ITI3;11;Marche;43.61675973;13.5188753;24;6;30;1342;1372;-43;3;99209;3036;103617;1296682;760809
2021-06-28;MOL;2939;1370;1569;1019;1896;24;0;ITF;ITF2;14;Molise;41.55774754;14.65916051;8;0;8;81;89;1;4;13115;491;13695;238910;205633
2021-06-28;PAB;4617;2309;2308;213;4376;28;0;ITH;ITH1;4;Provincia Autonoma Bolzano / Bozen;46.49933453;11.35662422;6;3;9;197;206;-11;4;71888;1180;73274;1625889;426624
2021-06-28;UMB;9832;4844;4988;3712;5991;129;0;ITI;ITI2;10;Umbria;43.10675841;12.38824698;18;3;21;785;806;-30;11;54592;1419;56817;1441712;389214
2021-06-28;SIC;31951;14882;17069;14908;16749;294;0;ITG;ITG1;19;Sicilia;38.11569725;13.3623567;171;24;195;4157;4352;-16;84;221138;5965;231455;4874707;1849332
2021-06-28;LAZ;59011;28216;30795;27491;31049;471;0;ITI;ITI4;12;Lazio;41.89277044;12.48366722;190;55;245;3081;3326;-145;52;334215;8327;345868;7582360;4444956
2021-06-29;PAT;6437;3245;3192;2745;3535;157;0;ITH;ITH2;4;Provincia Autonoma Trento;46.06893511;11.12123097;7;0;7;69;76;-14;1;44320;1362;45758;865059;231523
2021-06-29;VEN;45589;22741;22848;19048;25848;693;0;ITH;ITH3;5;Veneto;45.43490485;12.33845213;53;8;61;4547;4608;-108;38;409148;11615;425371;8640807;1821567
2021-06-29;TOS;37066;18048;19018;7977;28933;156;0;ITI;ITI1;9;Toscana;43.76923077;11.25588885;98;28;126;1846;1972;-143;18;235401;6864;244237;5126271;2356561
2021-06-29;LIG;15197;7241;7956;8615;6472;110;0;ITC;ITC3;7;Liguria;44.41149315;8.9326992;18;7;25;125;150;-9;17;98922;4351;103423;1754927;683616
2021-06-29;PAB;1896;1022;874;245;1629;22;0;ITH;ITH1;4;Provincia Autonoma Bolzano / Bozen;46.49933453;11.35662422;4;4;8;181;189;-17;5;71910;1180;73279;1628732;426789
2021-06-29;PUG;46810;22450;24360;15357;30759;694;0;ITF;ITF4;16;Puglia;41.12559576;16.86736689;131;15;146;2977;3123;-349;59;243541;6642;253306;2668808;1236521
2021-06-29;MAR;13371;6599;6772;4926;8215;230;0;ITI;ITI3;11;Marche;43.61675973;13.5188753;21;4;25;1318;1343;-29;8;99246;3036;103625;1297684;761811
2021-06-29;LOM;107336;53224;54112;57424;47899;2013;0;ITC;ITC4;3;Lombardia;45.46679409;9.190347404;248;52;300;10902;11202;-23;98;796716;33778;841696;11556788;4593092
2021-06-29;VDA;782;390;392;236;543;3;0;ITC;ITC2;2;Valle d'Aosta / Vallée d'Aoste;45.73750286;7.320149366;1;0;1;35;36;-1;2;11176;473;11685;139159;66054
2021-06-29;EMR;37730;18607;19123;18129;18800;801;0;ITH;ITH5;8;Emilia-Romagna;44.49436681;11.3417208;194;27;221;3055;3276;-196;36;370254;13261;386791;6707402;1907497
2021-06-29;LAZ;59568;28311;31257;27729;31221;618;0;ITI;ITI4;12;Lazio;41.89277044;12.48366722;191;54;245;2995;3240;-86;46;334345;8329;345914;7606520;4447506
2021-06-29;ABR;11430;5639;5791;5245;5997;188;0;ITF;ITF1;13;Abruzzo;42.35122196;13.39843823;26;1;27;966;993;-36;1;71257;2512;74762;1689380;688171
2021-06-29;BAS;3856;1880;1976;2785;1043;28;0;ITF;ITF5;17;Basilicata;40.63947052;15.80514834;18;0;18;654;672;-105;7;25678;590;26940;392734;210604
2021-06-29;FVG;11392;5812;5580;1233;10050;109;0;ITH;ITH4;6;Friuli-Venezia Giulia;45.6494354;13.76813649;10;0;10;192;202;-13;16;102939;3789;106930;2153227;681155
2021-06-29;PIE;40695;20325;20370;19236;20733;726;0;ITC;ITC1;1;Piemonte;45.0732745;7.680687483;162;14;176;724;900;-93;31;350298;11696;362894;4986305;1977341
2021-06-29;UMB;9974;5082;4892;4112;5702;160;0;ITI;ITI2;10;Umbria;43.10675841;12.38824698;17;3;20;785;805;-1;14;54607;1419;56831;1447074;389656
2021-06-29;SIC;31459;14737;16722;15725;15326;408;0;ITG;ITG1;19;Sicilia;38.11569725;13.3623567;162;24;186;4041;4227;-125;99;221360;5967;231554;4889132;1853917
2021-06-29;SAR;17901;8609;9292;3759;14093;49;0;ITG;ITG2;20;Sardegna;39.21531192;9.110616306;31;3;34;2288;2322;-16;11;53406;1491;57219;1378824;804728
2021-06-29;CAL;13080;6042;7038;5352;7676;52;0;ITF;ITF6;18;Calabria;38.90597598;16.59440194;68;6;74;5213;5287;-158;25;62426;1224;68937;930258;853319
2021-06-29;CAM;49364;24017;25347;19651;29152;561;0;ITF;ITF3;15;Campania;40.83956555;14.25084984;209;21;230;8048;8278;-306;117;408442;7472;424192;5274911;3270670
2021-06-29;MOL;2513;1168;1345;386;2096;31;0;ITF;ITF2;14;Molise;41.55774754;14.65916051;8;0;8;81;89;0;4;13119;491;13699;239305;206028
2021-06-30;BAS;3452;1668;1784;2315;1111;26;0;ITF;ITF5;17;Basilicata;40.63947052;15.80514834;17;0;17;640;657;-15;8;25701;590;26948;393347;210844
2021-06-30;ABR;11172;5433;5739;4495;6510;167;0;ITF;ITF1;13;Abruzzo;42.35122196;13.39843823;25;1;26;874;900;-93;30;71380;2512;74792;1693241;689244
2021-06-30;EMR;34265;17291;16974;17704;15667;894;0;ITH;ITH5;8;Emilia-Romagna;44.49436681;11.3417208;184;27;211;2739;2950;-326;36;370615;13262;386827;6723711;1909091
2021-06-30;VDA;1121;544;577;417;695;9;0;ITC;ITC2;2;Valle d'Aosta / Vallée d'Aoste;45.73750286;7.320149366;1;0;1;34;35;-1;0;11177;473;11685;139265;66120
2021-06-30;UMB;10553;5326;5227;3675;6727;151;0;ITI;ITI2;10;Umbria;43.10675841;12.38824698;18;3;21;770;791;-14;6;54627;1419;56837;1450999;390086
2021-06-30;CAL;16396;7510;8886;7014;9280;102;0;ITF;ITF6;18;Calabria;38.90597598;16.59440194;69;5;74;5027;5101;-186;25;62635;1226;68962;932484;854708
2021-06-30;CAM;47676;22778;24898;18186;28661;829;0;ITF;ITF3;15;Campania;40.83956555;14.25084984;218;20;238;7885;8123;-155;120;408712;7477;424312;5288092;3272434
2021-06-30;LIG;15108;7208;7900;8172;6834;102;0;ITC;ITC3;7;Liguria;44.41149315;8.9326992;19;7;26;120;146;-4;10;98936;4351;103433;1760165;684985
2021-06-30;LAZ;63088;29696;33392;29766;32758;564;0;ITI;ITI4;12;Lazio;41.89277044;12.48366722;190;49;239;2829;3068;-172;51;334561;8336;345965;7623651;4449641
2021-06-30;SIC;32623;15043;17580;11445;20855;323;0;ITG;ITG1;19;Sicilia;38.11569725;13.3623567;155;20;175;3856;4031;-196;142;221695;5970;231696;4904513;1858901
2021-06-30;VEN;45827;23107;22720;17869;27204;754;0;ITH;ITH3;5;Veneto;45.43490485;12.33845213;45;7;52;4523;4575;-33;52;409233;11615;425423;8663890;1823483
2021-06-30;TOS;38293;18531;19762;8461;29611;221;0;ITI;ITI1;9;Toscana;43.76923077;11.25588885;90;24;114;1696;1810;-162;37;235596;6868;244274;5139195;2361374
2021-06-30;MOL;3029;1435;1594;883;2060;86;0;ITF;ITF2;14;Molise;41.55774754;14.65916051;8;0;8;90;98;9;18;13128;491;13717;240201;206921
2021-06-30;LOM;107022;53017;54005;56571;48324;2127;0;ITC;ITC4;3;Lombardia;45.46679409;9.190347404;218;51;269;10205;10474;-728;129;797571;33780;841825;11589134;4604075
2021-06-30;SAR;17772;8514;9258;4804;12886;82;0;ITG;ITG2;20;Sardegna;39.21531192;9.110616306;36;3;39;2277;2316;-6;17;53429;1491;57236;1383369;806647
2021-06-30;PAB;3064;1565;1499;394;2608;62;0;ITH;ITH1;4;Provincia Autonoma Bolzano / Bozen;46.49933453;11.35662422;6;4;10;175;185;-4;8;71922;1180;73287;1631769;426983
2021-06-30;MAR;13653;6666;6987;4455;8986;212;0;ITI;ITI3;11;Marche;43.61675973;13.5188753;16;4;20;1267;1287;-56;15;99317;3036;103640;1301122;763038
2021-06-30;PUG;47993;23281;24712;18847;28286;860;0;ITF;ITF4;16;Puglia;41.12559576;16.86736689;120;11;131;2807;2938;-185;35;243761;6642;253341;2676021;1238235
2021-06-30;FVG;13210;6723;6487;1386;11651;173;0;ITH;ITH4;6;Friuli-Venezia Giulia;45.6494354;13.76813649;8;0;8;184;192;-10;12;102961;3789;106942;2158371;682075
2021-06-30;PIE;41382;20228;21154;18504;21983;895;0;ITC;ITC1;1;Piemonte;45.0732745;7.680687483;152;14;166;668;834;-66;30;350394;11696;362924;4999624;1981187
2021-06-30;PAT;6887;3538;3349;2680;4058;149;0;ITH;ITH2;4;Provincia Autonoma Trento;46.06893511;11.12123097;5;0;5;59;64;-12;1;44333;1362;45759;865546;231718
2021-07-01;UMB;9751;4822;4929;3303;6294;154;0;ITI;ITI2;10;Umbria;43.10675841;12.38824698;18;3;21;756;777;-14;0;54641;1419;56837;1451669;390244
2021-07-01;SIC;31039;14100;16939;10778;20003;258;0;ITG;ITG1;19;Sicilia;38.11569725;13.3623567;151;18;169;3716;3885;-146;137;221974;5974;231833;4914973;1863365
2021-07-01;SAR;19834;9764;10070;7255;12484;95;0;ITG;ITG2;20;Sardegna;39.21531192;9.110616306;43;2;45;2270;2315;-1;10;53440;1491;57246;1386259;808407
2021-07-01;VEN;51026;26060;24966;20692;29319;1015;0;ITH;ITH3;5;Veneto;45.43490485;12.33845213;45;6;51;4523;4574;-1;55;409288;11616;425478;8687243;1825833
2021-07-01;TOS;32094;15541;16553;10722;21087;285;0;ITI;ITI1;9;Toscana;43.76923077;11.25588885;86;23;109;1635;1744;-66;53;235713;6870;244327;5152512;2366108
2021-07-01;CAL;12398;5838;6560;5473;6840;85;0;ITF;ITF6;18;Calabria;38.90597598;16.59440194;59;6;65;4909;4974;-127;27;62787;1228;68989;934639;856566
2021-07-01;CAM;61548;29873;31675;19679;41035;834;0;ITF;ITF3;15;Campania;40.83956555;14.25084984;217;19;236;7625;7861;-262;107;409074;7484;424419;5300961;3274587
2021-07-01;LAZ;48597;23248;25349;7172;41201;224;0;ITI;ITI4;12;Lazio;41.89277044;12.48366722;181;47;228;2800;3028;-40;72;334670;8339;346037;7648335;4452477
2021-07-01;EMR;34547;16886;17661;14810;18856;881;0;ITH;ITH5;8;Emilia-Romagna;44.49436681;11.3417208;179;24;203;2654;2857;-93;61;370769;13262;386888;6740587;1910485
2021-07-01;PAT;7156;3740;3416;3582;3367;207;0;ITH;ITH2;4;Provincia Autonoma Trento;46.06893511;11.12123097;5;0;5;57;62;-2;4;44339;1362;45763;866862;232244
2021-07-01;FVG;12400;6454;5946;2642;9501;257;0;ITH;ITH4;6;Friuli-Venezia Giulia;45.6494354;13.76813649;8;0;8;184;192;0;15;102976;3789;106957;2163140;682803
2021-07-01;LOM;105156;52902;52254;53331;49419;2406;0;ITC;ITC4;3;Lombardia;45.46679409;9.190347404;201;49;250;10192;10442;-32;136;797737;33782;841961;11624979;4616536
2021-07-01;PIE;42045;21034;21011;19829;21171;1045;0;ITC;ITC1;1;Piemonte;45.0732745;7.680687483;145;11;156;629;785;-49;20;350463;11696;362944;5013035;1985566
2021-07-01;PAB;4640;2305;2335;1291;3167;182;0;ITH;ITH1;4;Provincia Autonoma Bolzano / Bozen;46.49933453;11.35662422;6;3;9;167;176;-9;1;71932;1180;73288;1633092;427079
2021-07-01;PUG;48589;22750;25839;11446;36508;635;0;ITF;ITF4;16;Puglia;41.12559576;16.86736689;119;11;130;2597;2727;-211;40;244012;6642;253381;2682225;1239521
2021-07-01;VDA;962;473;489;328;621;13;0;ITC;ITC2;2;Valle d'Aosta / Vallée d'Aoste;45.73750286;7.320149366;1;0;1;36;37;2;3;11178;473;11688;139636;66289
2021-07-01;BAS;3711;1856;1855;2563;1114;34;0;ITF;ITF5;17;Basilicata;40.63947052;15.80514834;15;0;15;648;663;6;16;25711;590;26964;393936;211068
2021-07-01;MOL;2687;1306;1381;277;2391;19;0;ITF;ITF2;14;Molise;41.55774754;14.65916051;8;0;8;80;88;-10;0;13138;491;13717;240317;207037
2021-07-01;LIG;13578;6548;7030;7276;6181;121;0;ITC;ITC3;7;Liguria;44.41149315;8.9326992;16;6;22;107;129;-17;12;98965;4351;103445;1765394;686561
2021-07-01;MAR;14699;7368;7331;4658;9763;278;0;ITI;ITI3;11;Marche;43.61675973;13.5188753;12;3;15;1268;1283;-4;46;99367;3036;103686;1303084;764026
2021-07-01;ABR;12764;6282;6482;5767;6770;227;0;ITF;ITF1;13;Abruzzo;42.35122196;13.39843823;25;1;26;849;875;-25;35;71440;2512;74827;1698285;690507
2021-07-02;MOL;2721;1320;1401;137;2572;12;0;ITF;ITF2;14;Molise;41.55774754;14.65916051;8;0;8;77;85;-3;0;13141;491;13717;240640;207358
2021-07-02;PAB;3203;1659;1544;843;2172;188;0;ITH;ITH1;4;Provincia Autonoma Bolzano / Bozen;46.49933453;11.35662422;7;3;10;154;164;-12;3;71947;1180;73291;1633813;427173
2021-07-02;ABR;11836;5948;5888;4829;6822;185;0;ITF;ITF1;13;Abruzzo;42.35122196;13.39843823;24;1;25;859;884;9;50;71478;2512;74874;1702893;691572
2021-07-02;PUG;47524;22589;24935;17375;29219;930;0;ITF;ITF4;16;Puglia;41.12559576;16.86736689;118;11;129;2560;2689;-38;43;244093;6642;253424;2688193;1241224
2021-07-02;BAS;3692;1841;1851;2486;1177;29;0;ITF;ITF5;17;Basilicata;40.63947052;15.80514834;16;0;16;651;667;4;4;25711;590;26968;394585;211341
2021-07-02;EMR;34765;17097;17668;12374;21733;658;0;ITH;ITH5;8;Emilia-Romagna;44.49436681;11.3417208;175;22;197;2510;2707;-150;46;370963;13264;386934;6759161;1911813
2021-07-02;CAL;16280;7538;8742;6235;9957;88;0;ITF;ITF6;18;Calabria;38.90597598;16.59440194;52;6;58;4600;4658;-316;13;63116;1228;69002;936672;858341
2021-07-02;LAZ;48589;23282;25307;6602;41789;198;0;ITI;ITI4;12;Lazio;41.89277044;12.48366722;162;42;204;2731;2935;-93;64;334822;8344;346101;7671816;4454996
2021-07-02;UMB;8757;4330;4427;2966;5610;181;0;ITI;ITI2;10;Umbria;43.10675841;12.38824698;17;3;20;759;779;2;8;54647;1419;56845;1456323;390816
2021-07-02;SAR;18946;8894;10052;4402;14444;100;0;ITG;ITG2;20;Sardegna;39.21531192;9.110616306;42;2;44;2268;2312;-3;25;53468;1491;57271;1389269;810528
2021-07-02;TOS;28320;14213;14107;10815;17206;299;0;ITI;ITI1;9;Toscana;43.76923077;11.25588885;83;18;101;1585;1686;-58;58;235828;6871;244385;5165031;2370280
2021-07-02;CAM;55895;27013;28882;14322;40965;608;0;ITF;ITF3;15;Campania;40.83956555;14.25084984;212;18;230;7360;7590;-271;98;409432;7495;424517;5313243;3276341
2021-07-02;SIC;30580;14241;16339;9940;20353;287;0;ITG;ITG1;19;Sicilia;38.11569725;13.3623567;154;19;173;3552;3725;-160;115;222244;5979;231948;4928454;1866747
2021-07-02;LIG;13010;6380;6630;6355;6533;122;0;ITC;ITC3;7;Liguria;44.41149315;8.9326992;14;6;20;105;125;-4;11;98980;4351;103456;1769980;688068
2021-07-02;VEN;49579;25148;24431;16286;32504;789;0;ITH;ITH3;5;Veneto;45.43490485;12.33845213;43;5;48;4522;4570;-4;57;409347;11618;425535;8711510;1827682
2021-07-02;LOM;104048;52148;51900;48871;52973;2204;0;ITC;ITC4;3;Lombardia;45.46679409;9.190347404;195;47;242;9782;10024;-418;143;798298;33782;842104;11661912;4629796
2021-07-02;MAR;14553;7178;7375;4674;9648;231;0;ITI;ITI3;11;Marche;43.61675973;13.5188753;10;2;12;1268;1280;-3;28;99397;3037;103714;1304872;764967
2021-07-02;FVG;11118;5748;5370;2116;8810;192;0;ITH;ITH4;6;Friuli-Venezia Giulia;45.6494354;13.76813649;6;0;6;183;189;-3;21;103000;3789;106978;2167864;683528
2021-07-02;PIE;43876;22075;21801;17392;25606;878;0;ITC;ITC1;1;Piemonte;45.0732745;7.680687483;139;11;150;614;764;-21;25;350509;11696;362969;5033996;1991446
2021-07-02;PAT;7433;4041;3392;3575;3598;260;0;ITH;ITH2;4;Provincia Autonoma Trento;46.06893511;11.12123097;5;0;5;57;62;0;7;44346;1362;45770;868008;232703
2021-07-02;VDA;873;387;486;304;563;6;0;ITC;ITC2;2;Valle d'Aosta / Vallée d'Aoste;45.73750286;7.320149366;1;0;1;34;35;-2;3;11183;473;11691;139962;66391
2021-07-03;UMB;6481;3248;3233;2831;3498;152;0;ITI;ITI2;10;Umbria;43.10675841;12.38824698;15;1;16;711;727;-52;8;54707;1419;56853;1459932;391407
2021-07-03;CAM;67284;32500;34784;8106;58722;456;0;ITF;ITF3;15;Campania;40.83956555;14.25084984;208;19;227;7366;7593;3;139;409559;7504;424656;5326093;3278308
2021-07-03;EMR;32130;15938;16192;11410;20027;693;0;ITH;ITH5;8;Emilia-Romagna;44.49436681;11.3417208;161;22;183;2490;2673;-34;65;371061;13264;386998;6781717;1913224
2021-07-03;CAL;15185;7149;8036;5282;9825;78;0;ITF;ITF6;18;Calabria;38.90597598;16.59440194;54;6;60;3320;3380;-1278;56;64450;1228;69058;938688;860032
2021-07-03;SIC;33886;16289;17597;9028;24611;247;0;ITG;ITG1;19;Sicilia;38.11569725;13.3623567;145;17;162;3513;3675;-50;134;222428;5979;232082;4937286;1870528
2021-07-03;VEN;38710;20120;18590;11028;27105;577;0;ITH;ITH3;5;Veneto;45.43490485;12.33845213;40;5;45;4499;4544;-26;66;409438;11619;425601;8746789;1833294
2021-07-03;FVG;11443;6099;5344;1099;10196;148;0;ITH;ITH4;6;Friuli-Venezia Giulia;45.6494354;13.76813649;8;0;8;181;189;0;10;103009;3789;106987;2171553;684225
2021-07-03;LIG;8831;4381;4450;5424;3333;74;0;ITC;ITC3;7;Liguria;44.41149315;8.9326992;14;6;20;108;128;3;7;98983;4352;103463;1775495;690000
2021-07-03;LAZ;53272;25086;28186;4642;48479;151;0;ITI;ITI4;12;Lazio;41.89277044;12.48366722;155;40;195;2642;2837;-98;85;335002;8347;346186;7698300;4458216
2021-07-03;LOM;102548;51737;50811;44561;55873;2114;0;ITC;ITC4;3;Lombardia;45.46679409;9.190347404;208;45;253;9201;9454;-570;140;799005;33785;842244;11701986;4645156
2021-07-03;TOS;29443;14834;14609;11879;17179;385;0;ITI;ITI1;9;Toscana;43.76923077;11.25588885;85;18;103;1498;1601;-85;50;235960;6874;244435;5181192;2374336
2021-07-03;PIE;40170;20158;20012;15351;24055;764;0;ITC;ITC1;1;Piemonte;45.0732745;7.680687483;97;9;106;648;754;-10;35;350554;11696;363004;5058814;1999010
2021-07-03;PAT;1268;681;587;78;1185;5;0;ITH;ITH2;4;Provincia Autonoma Trento;46.06893511;11.12123097;4;0;4;58;62;0;5;44351;1362;45775;869457;233282
2021-07-03;SAR;15846;7564;8282;3233;12579;34;0;ITG;ITG2;20;Sardegna;39.21531192;9.110616306;41;1;42;2263;2305;-7;8;53482;1492;57279;1392561;812762
2021-07-03;MOL;2769;1393;1376;582;2165;22;0;ITF;ITF2;14;Molise;41.55774754;14.65916051;4;0;4;73;77;-8;2;13151;491;13719;241172;207882
2021-07-03;PUG;33351;16712;16639;13465;19380;506;0;ITF;ITF4;16;Puglia;41.12559576;16.86736689;113;10;123;2541;2664;-25;47;244165;6642;253471;2694462;1243148
2021-07-03;PAB;5640;2793;2847;925;4566;149;0;ITH;ITH1;4;Provincia Autonoma Bolzano / Bozen;46.49933453;11.35662422;6;3;9;150;159;-5;8;71960;1180;73299;1636890;427370
2021-07-03;VDA;937;486;451;390;537;10;0;ITC;ITC2;2;Valle d'Aosta / Vallée d'Aoste;45.73750286;7.320149366;1;0;1;35;36;1;2;11184;473;11693;140373;66580
2021-07-03;MAR;13844;6992;6852;4136;9395;313;0;ITI;ITI3;11;Marche;43.61675973;13.5188753;5;2;7;1247;1254;-26;32;99455;3037;103746;1306605;765861
2021-07-03;BAS;3948;2104;1844;2757;1145;46;0;ITF;ITF5;17;Basilicata;40.63947052;15.80514834;17;0;17;661;678;11;11;25711;590;26979;395185;211559
2021-07-03;ABR;10194;5149;5045;3500;6546;148;0;ITF;ITF1;13;Abruzzo;42.35122196;13.39843823;21;1;22;851;873;-11;23;71512;2512;74897;1707743;692908
2021-07-04;LIG;4868;2585;2283;3798;1001;69;0;ITC;ITC3;7;Liguria;44.41149315;8.9326992;14;7;21;104;125;-3;13;98999;4352;103476;1779379;691664
2021-07-04;MOL;2162;1091;1071;585;1554;23;0;ITF;ITF2;14;Molise;41.55774754;14.65916051;4;0;4;61;65;-12;1;13164;491;13720;241440;208150
2021-07-04;PUG;19968;9713;10255;7935;11748;285;0;ITF;ITF4;16;Puglia;41.12559576;16.86736689;108;10;118;2542;2660;-4;25;244192;6644;253496;2698172;1243616
2021-07-04;MAR;10896;5445;5451;3204;7531;161;0;ITI;ITI3;11;Marche;43.61675973;13.5188753;8;2;10;1262;1272;18;41;99478;3037;103787;1308855;767011
2021-07-04;PAB;4425;2133;2292;155;4237;33;0;ITH;ITH1;4;Provincia Autonoma Bolzano / Bozen;46.49933453;11.35662422;6;3;9;154;163;4;2;71958;1180;73301;1639158;427566
2021-07-04;VDA;1193;531;662;350;829;14;0;ITC;ITC2;2;Valle d'Aosta / Vallée d'Aoste;45.73750286;7.320149366;1;0;1;33;34;-2;0;11186;473;11693;140609;66672
2021-07-04;BAS;3112;1563;1549;2164;922;26;0;ITF;ITF5;17;Basilicata;40.63947052;15.80514834;16;0;16;667;683;5;6;25711;591;26985;395612;211717
2021-07-04;ABR;8371;4216;4155;3330;4915;126;0;ITF;ITF1;13;Abruzzo;42.35122196;13.39843823;22;1;23;863;886;13;28;71526;2512;74924;1714104;694980
2021-07-04;CAL;5959;2824;3135;1991;3932;36;0;ITF;ITF6;18;Calabria;38.90597598;16.59440194;51;6;57;3094;3151;-229;24;64701;1230;69082;940479;861578
2021-07-04;UMB;3411;1741;1670;2342;971;98;0;ITI;ITI2;10;Umbria;43.10675841;12.38824698;15;1;16;699;715;-12;3;54722;1419;56856;1464397;392084
2021-07-04;FVG;9363;4799;4564;2891;6215;257;0;ITH;ITH4;6;Friuli-Venezia Giulia;45.6494354;13.76813649;6;0;6;180;186;-3;9;103021;3789;106996;2173532;684717
2021-07-04;SAR;8207;3988;4219;2066;6126;15;0;ITG;ITG2;20;Sardegna;39.21531192;9.110616306;42;1;43;2277;2320;15;21;53488;1492;57300;1393892;813866
2021-07-04;LAZ;46641;21718;24923;4113;42434;94;0;ITI;ITI4;12;Lazio;41.89277044;12.48366722;155;37;192;2581;2773;-64;83;335147;8349;346269;7719482;4461386
2021-07-04;VEN;33887;17580;16307;14989;18289;609;0;ITH;ITH3;5;Veneto;45.43490485;12.33845213;38;5;43;4527;4570;26;53;409465;11619;425654;8766162;1835435
2021-07-04;CAM;48825;23767;25058;6152;42322;351;0;ITF;ITF3;15;Campania;40.83956555;14.25084984;211;19;230;7353;7583;-10;110;409679;7504;424766;5331848;3280237
2021-07-04;SIC;26521;12807;13714;7606;18737;178;0;ITG;ITG1;19;Sicilia;38.11569725;13.3623567;143;15;158;3405;3563;-112;102;222640;5981;232184;4943683;1874059
2021-07-04;PIE;33871;17068;16803;11249;21989;633;0;ITC;ITC1;1;Piemonte;45.0732745;7.680687483;94;10;104;673;777;23;40;350571;11696;363044;5070235;2003173
2021-07-04;LOM;86776;43401;43375;40191;44625;1960;0;ITC;ITC4;3;Lombardia;45.46679409;9.190347404;195;44;239;8737;8976;-478;131;799613;33786;842375;11727852;4656966
2021-07-04;EMR;24277;12071;12206;10172;13612;493;0;ITH;ITH5;8;Emilia-Romagna;44.49436681;11.3417208;161;22;183;2410;2593;-80;52;371191;13264;387048;6793633;1914353
2021-07-04;TOS;31555;15323;16232;9363;21893;299;0;ITI;ITI1;9;Toscana;43.76923077;11.25588885;79;16;95;1472;1567;-34;49;236042;6875;244484;5192871;2378474
2021-07-04;PAT;227;127;100;67;158;2;0;ITH;ITH2;4;Provincia Autonoma Trento;46.06893511;11.12123097;3;0;3;58;61;-1;7;44359;1362;45782;871160;233964
2021-07-05;VDA;836;357;479;312;511;13;0;ITC;ITC2;2;Valle d'Aosta / Vallée d'Aoste;45.73750286;7.320149366;1;0;1;33;34;0;3;11189;473;11696;141073;66886
2021-07-05;CAL;13387;6254;7133;4260;9061;66;0;ITF;ITF6;18;Calabria;38.90597598;16.59440194;55;6;61;2820;2881;-270;11;64982;1230;69093;941198;862117
2021-07-05;MAR;13167;6510;6657;2918;10077;172;0;ITI;ITI3;11;Marche;43.61675973;13.5188753;9;1;10;1253;1263;-9;4;99490;3038;103791;1309610;767352
2021-07-05;EMR;33246;16212;17034;11199;21390;657;0;ITH;ITH5;8;Emilia-Romagna;44.49436681;11.3417208;163;22;185;2304;2489;-104;58;371353;13264;387106;6799828;1915058
2021-07-05;VEN;39149;20287;18862;14144;24202;803;0;ITH;ITH3;5;Veneto;45.43490485;12.33845213;38;4;42;4564;4606;36;45;409474;11619;425699;8771268;1836720
2021-07-05;UMB;8424;4083;4341;152;8258;14;0;ITI;ITI2;10;Umbria;43.10675841;12.38824698;12;1;13;685;698;-17;9;54748;1419;56865;1468449;392581
2021-07-05;FVG;9684;4925;4759;1332;8209;143;0;ITH;ITH4;6;Friuli-Venezia Giulia;45.6494354;13.76813649;6;0;6;179;185;-1;2;103024;3789;106998;2174755;685064
2021-07-05;PIE;35652;17839;17813;11707;23245;700;0;ITC;ITC1;1;Piemonte;45.0732745;7.680687483;83;8;91;657;748;-29;15;350615;11696;363059;5081576;2005484
2021-07-05;CAM;63326;30528;32798;12603;49902;821;0;ITF;ITF3;15;Campania;40.83956555;14.25084984;221;17;238;7314;7552;-31;68;409762;7520;424834;5340262;3281110
2021-07-05;PUG;39009;18302;20707;7216;31237;556;0;ITF;ITF4;16;Puglia;41.12559576;16.86736689;107;10;117;2490;2607;-53;15;244260;6644;253511;2701954;1244668
2021-07-05;PAT;5436;2850;2586;3789;1394;253;0;ITH;ITH2;4;Provincia Autonoma Trento;46.06893511;11.12123097;2;0;2;49;51;-10;3;44372;1362;45785;873336;234834
2021-07-05;LIG;11959;5782;6177;5287;6570;102;0;ITC;ITC3;7;Liguria;44.41149315;8.9326992;15;7;22;97;119;-6;8;99013;4352;103484;1781637;692392
2021-07-05;MOL;2749;1289;1460;43;2704;2;0;ITF;ITF2;14;Molise;41.55774754;14.65916051;3;0;3;61;64;-1;0;13164;492;13720;241842;208546
2021-07-05;ABR;10910;5349;5561;4039;6676;195;0;ITF;ITF1;13;Abruzzo;42.35122196;13.39843823;21;1;22;889;911;25;25;71526;2512;74949;1719227;696692
2021-07-05;PAB;2939;1408;1531;813;1987;139;0;ITH;ITH1;4;Provincia Autonoma Bolzano / Bozen;46.49933453;11.35662422;7;2;9;128;137;-26;14;71998;1180;73315;1641818;427817
2021-07-05;TOS;30539;15097;15442;10342;19963;234;0;ITI;ITI1;9;Toscana;43.76923077;11.25588885;85;15;100;1409;1509;-58;41;236133;6883;244525;5197195;2380105
2021-07-05;BAS;3270;1615;1655;2214;1021;35;0;ITF;ITF5;17;Basilicata;40.63947052;15.80514834;17;0;17;667;684;1;1;25711;591;26986;395713;211763
2021-07-05;LAZ;61779;29741;32038;25584;35102;1093;0;ITI;ITI4;12;Lazio;41.89277044;12.48366722;155;36;191;2589;2780;7;83;335218;8354;346352;7728995;4463874
2021-07-05;SAR;15584;7571;8013;3327;12208;49;0;ITG;ITG2;20;Sardegna;39.21531192;9.110616306;33;1;34;2280;2314;-6;9;53503;1492;57309;1394623;814475
2021-07-05;SIC;37553;17627;19926;8919;28393;241;0;ITG;ITG1;19;Sicilia;38.11569725;13.3623567;140;17;157;3421;3578;15;58;222683;5981;232242;4951486;1876630
2021-07-05;LOM;101941;49796;52145;31495;68555;1891;0;ITC;ITC4;3;Lombardia;45.46679409;9.190347404;164;44;208;8201;8409;-567;51;800231;33786;842426;11736896;4662994
2021-07-06;SAR;15933;7721;8212;4657;11175;101;0;ITG;ITG2;20;Sardegna;39.21531192;9.110616306;34;1;35;2273;2308;-6;21;53530;1492;57330;1396645;816159
2021-07-06;LIG;12385;6077;6308;5619;6666;100;0;ITC;ITC3;7;Liguria;44.41149315;8.9326992;14;7;21;97;118;-1;7;99021;4352;103491;1786872;693970
2021-07-06;PIE;38352;19406;18946;8653;29136;563;0;ITC;ITC1;1;Piemonte;45.0732745;7.680687483;84;9;93;622;715;-33;38;350686;11696;363097;5097505;2009976
2021-07-06;VEN;36164;18631;17533;13201;22322;641;0;ITH;ITH3;5;Veneto;45.43490485;12.33845213;37;4;41;4611;4652;46;97;409525;11619;425796;8796444;1839821
2021-07-06;LOM;102189;50890;51299;23086;77687;1416;0;ITC;ITC4;3;Lombardia;45.46679409;9.190347404;158;45;203;8265;8468;59;129;800296;33791;842555;11767397;4674204
2021-07-06;PAT;5243;2765;2478;3114;1932;197;0;ITH;ITH2;4;Provincia Autonoma Trento;46.06893511;11.12123097;2;0;2;54;56;5;6;44373;1362;45791;874729;235391
2021-07-06;TOS;25798;13040;12758;11036;14532;230;0;ITI;ITI1;9;Toscana;43.76923077;11.25588885;75;16;91;1390;1481;-28;59;236217;6886;244584;5209299;2384376
2021-07-06;PAB;1725;927;798;663;984;78;0;ITH;ITH1;4;Provincia Autonoma Bolzano / Bozen;46.49933453;11.35662422;8;2;10;118;128;-9;4;72011;1180;73319;1644557;427940
2021-07-06;PUG;42472;19555;22917;6091;35964;417;0;ITF;ITF4;16;Puglia;41.12559576;16.86736689;94;8;102;2476;2578;-29;60;244347;6646;253571;2709076;1246049
2021-07-06;VDA;886;481;405;158;723;5;0;ITC;ITC2;2;Valle d'Aosta / Vallée d'Aoste;45.73750286;7.320149366;1;0;1;31;32;-2;0;11191;473;11696;141476;67064
2021-07-06;MAR;13963;6920;7043;3140;10598;225;0;ITI;ITI3;11;Marche;43.61675973;13.5188753;8;1;9;1263;1272;9;39;99520;3038;103830;1312033;768242
2021-07-06;ABR;10463;5200;5263;4299;5988;176;0;ITF;ITF1;13;Abruzzo;42.35122196;13.39843823;23;1;24;851;875;-36;7;71569;2512;74956;1720707;697066
2021-07-06;BAS;4210;2008;2202;2114;2060;36;0;ITF;ITF5;17;Basilicata;40.63947052;15.80514834;16;0;16;669;685;1;7;25717;591;26993;396302;211970
2021-07-06;EMR;36821;18514;18307;12917;23205;699;0;ITH;ITH5;8;Emilia-Romagna;44.49436681;11.3417208;164;19;183;2137;2320;-169;51;371573;13264;387157;6818174;1916745
2021-07-06;UMB;8599;4093;4506;148;8428;23;0;ITI;ITI2;10;Umbria;43.10675841;12.38824698;9;1;10;681;691;-7;5;54759;1420;56870;1473321;392986
2021-07-06;SIC;37163;17181;19982;10304;26545;314;0;ITG;ITG1;19;Sicilia;38.11569725;13.3623567;137;18;155;3323;3478;-100;144;222923;5985;232386;4965613;1880813
2021-07-06;CAM;56708;27080;29628;15773;40115;820;0;ITF;ITF3;15;Campania;40.83956555;14.25084984;211;18;229;7267;7496;-56;108;409924;7522;424942;5353081;3283159
2021-07-06;CAL;12500;5754;6746;3824;8610;66;0;ITF;ITF6;18;Calabria;38.90597598;16.59440194;52;5;57;2588;2645;-236;26;65242;1232;69119;943484;864109
2021-07-06;LAZ;62670;30416;32254;28557;33600;513;0;ITI;ITI4;12;Lazio;41.89277044;12.48366722;135;33;168;2248;2416;-364;58;335636;8358;346410;7754809;4467933
2021-07-06;FVG;11223;5858;5365;1351;9758;114;0;ITH;ITH4;6;Friuli-Venezia Giulia;45.6494354;13.76813649;7;1;8;185;193;8;13;103029;3789;107011;2179063;685864
2021-07-06;MOL;3073;1433;1640;38;3030;5;0;ITF;ITF2;14;Molise;41.55774754;14.65916051;3;0;3;61;64;0;1;13165;492;13721;242175;208879
2021-07-07;VDA;795;442;353;414;364;17;0;ITC;ITC2;2;Valle d'Aosta / Vallée d'Aoste;45.73750286;7.320149366;1;0;1;31;32;0;0;11191;473;11696;141550;67101
2021-07-07;BAS;5203;2470;2733;2019;3169;15;0;ITF;ITF5;17;Basilicata;40.63947052;15.80514834;16;0;16;637;653;-32;12;25761;591;27005;396927;212197
2021-07-07;ABR;12073;5909;6164;4021;7807;245;0;ITF;ITF1;13;Abruzzo;42.35122196;13.39843823;23;1;24;850;874;-1;33;71603;2512;74989;1724792;698197
2021-07-07;UMB;9499;4502;4997;88;9380;31;0;ITI;ITI2;10;Umbria;43.10675841;12.38824698;11;0;11;673;684;-7;11;54776;1421;56881;1476819;393401
2021-07-07;PAT;4533;2435;2098;2920;1410;203;0;ITH;ITH2;4;Provincia Autonoma Trento;46.06893511;11.12123097;1;0;1;52;53;-3;0;44375;1363;45791;875068;235527
2021-07-07;FVG;11336;5804;5532;1449;9756;131;0;ITH;ITH4;6;Friuli-Venezia Giulia;45.6494354;13.76813649;6;1;7;190;197;4;22;103047;3789;107033;2184292;686760
2021-07-07;EMR;37927;19154;18773;13394;23729;804;0;ITH;ITH5;8;Emilia-Romagna;44.49436681;11.3417208;160;18;178;2029;2207;-113;62;371748;13264;387219;6833676;1918254
2021-07-07;PIE;38083;18927;19156;9709;27770;604;0;ITC;ITC1;1;Piemonte;45.0732745;7.680687483;69;6;75;624;699;-16;31;350733;11696;363128;5109324;2013097
2021-07-07;CAL;13978;6585;7393;3901;10000;77;0;ITF;ITF6;18;Calabria;38.90597598;16.59440194;53;4;57;2541;2598;-47;38;65327;1232;69157;945588;865983
2021-07-07;VEN;41001;21332;19669;15640;24556;805;0;ITH;ITH3;5;Veneto;45.43490485;12.33845213;38;6;44;4609;4653;1;80;409604;11619;425876;8825698;1840369
2021-07-07;SAR;15910;7730;8180;4084;11773;53;0;ITG;ITG2;20;Sardegna;39.21531192;9.110616306;33;1;34;2292;2326;18;25;53537;1492;57355;1399309;818379
2021-07-07;CAM;52318;24825;27493;7089;44646;583;0;ITF;ITF3;15;Campania;40.83956555;14.25084984;218;17;235;7055;7290;-206;208;410335;7525;425150;5366514;3285000
2021-07-07;TOS;25648;12611;13037;9330;16123;195;0;ITI;ITI1;9;Toscana;43.76923077;11.25588885;69;17;86;1354;1440;-41;41;236298;6887;244625;5218358;2389198
2021-07-07;LOM;112080;56180;55900;17999;92918;1163;0;ITC;ITC4;3;Lombardia;45.46679409;9.190347404;150;44;194;8332;8526;58;100;800338;33791;842655;11799337;4685494
2021-07-07;MOL;2971;1375;1596;58;2909;4;0;ITF;ITF2;14;Molise;41.55774754;14.65916051;3;0;3;61;64;0;3;13168;492;13724;242618;209319
2021-07-07;LAZ;62761;31085;31676;28388;33758;615;0;ITI;ITI4;12;Lazio;41.89277044;12.48366722;144;29;173;2093;2266;-150;104;335883;8365;346514;7776357;4470762
2021-07-07;PUG;38825;18584;20241;6074;32239;512;0;ITF;ITF4;16;Puglia;41.12559576;16.86736689;88;8;96;2389;2485;-93;49;244488;6647;253620;2714846;1247647
2021-07-07;LIG;11814;5655;6159;4913;6808;93;0;ITC;ITC3;7;Liguria;44.41149315;8.9326992;11;7;18;105;123;5;20;99036;4352;103511;1791427;695324
2021-07-07;MAR;14259;7067;7192;2933;11083;243;0;ITI;ITI3;11;Marche;43.61675973;13.5188753;7;1;8;1272;1280;8;52;99564;3038;103882;1314699;769374
2021-07-07;SIC;35434;16210;19224;6033;29159;242;0;ITG;ITG1;19;Sicilia;38.11569725;13.3623567;129;19;148;3209;3357;-121;109;223151;5987;232495;4976504;1884834
2021-07-07;PAB;1997;1036;961;581;1337;79;0;ITH;ITH1;4;Provincia Autonoma Bolzano / Bozen;46.49933453;11.35662422;6;2;8;113;121;-7;7;72025;1180;73326;1648310;428159
2021-07-08;LAZ;64414;31630;32784;28160;35546;708;0;ITI;ITI4;12;Lazio;41.89277044;12.48366722;139;27;166;2076;2242;-24;112;336015;8369;346626;7797734;4473282
2021-07-08;FVG;13129;7095;6034;1365;11583;181;0;ITH;ITH4;6;Friuli-Venezia Giulia;45.6494354;13.76813649;5;1;6;197;203;6;19;103059;3789;107051;2188304;687431
2021-07-08;EMR;41354;20602;20752;4724;36209;421;0;ITH;ITH5;8;Emilia-Romagna;44.49436681;11.3417208;157;17;174;2014;2188;-19;94;371857;13266;387311;6848823;1919638
2021-07-08;SAR;18446;8972;9474;3831;14530;85;0;ITG;ITG2;20;Sardegna;39.21531192;9.110616306;33;1;34;2305;2339;13;28;53552;1492;57383;1405815;820089
2021-07-08;LOM;114730;58463;56267;13224;100480;1026;0;ITC;ITC4;3;Lombardia;45.46679409;9.190347404;134;43;177;8508;8685;159;215;800393;33792;842870;11830609;4696266
2021-07-08;PAT;4168;2215;1953;2511;1484;173;0;ITH;ITH2;4;Provincia Autonoma Trento;46.06893511;11.12123097;1;0;1;47;48;-5;1;44381;1363;45792;876237;235994
2021-07-08;VEN;46736;24318;22418;4504;41930;302;0;ITH;ITH3;5;Veneto;45.43490485;12.33845213;40;6;46;4714;4760;107;149;409646;11619;426025;8846758;1845787
2021-07-08;PIE;41063;20997;20066;7462;33016;585;0;ITC;ITC1;1;Piemonte;45.0732745;7.680687483;64;4;68;633;701;2;42;350772;11697;363170;5124352;2015628
2021-07-08;UMB;9577;4634;4943;179;9350;48;0;ITI;ITI2;10;Umbria;43.10675841;12.38824698;12;0;12;662;674;-10;3;54789;1421;56884;1477494;393559
2021-07-08;CAL;12057;5618;6439;2692;9319;46;0;ITF;ITF6;18;Calabria;38.90597598;16.59440194;51;4;55;2407;2462;-136;54;65516;1233;69211;947651;867802
2021-07-08;PUG;41678;19330;22348;5418;35800;460;0;ITF;ITF4;16;Puglia;41.12559576;16.86736689;84;9;93;2258;2351;-134;58;244679;6648;253678;2720973;1248976
2021-07-08;SIC;38406;17497;20909;6528;31651;227;0;ITG;ITG1;19;Sicilia;38.11569725;13.3623567;128;20;148;3309;3457;100;219;223270;5987;232714;4988354;1889650
2021-07-08;TOS;21103;10374;10729;9272;11590;241;0;ITI;ITI1;9;Toscana;43.76923077;11.25588885;67;16;83;1403;1486;46;94;236346;6887;244719;5227859;2393576
2021-07-08;ABR;13500;6685;6815;3407;9927;166;0;ITF;ITF1;13;Abruzzo;42.35122196;13.39843823;23;1;24;845;869;-5;35;71643;2512;75024;1728746;699219
2021-07-08;PAB;5514;2785;2729;533;4889;92;0;ITH;ITH1;4;Provincia Autonoma Bolzano / Bozen;46.49933453;11.35662422;5;2;7;111;118;-3;4;72032;1180;73330;1650129;428264
2021-07-08;VDA;1276;709;567;339;926;11;0;ITC;ITC2;2;Valle d'Aosta / Vallée d'Aoste;45.73750286;7.320149366;0;0;0;22;22;-10;0;11201;473;11696;142106;67312
2021-07-08;MOL;3449;1661;1788;109;3317;23;0;ITF;ITF2;14;Molise;41.55774754;14.65916051;3;0;3;57;60;-4;0;13172;492;13724;242708;209409
2021-07-08;BAS;5137;2429;2708;1852;3260;25;0;ITF;ITF5;17;Basilicata;40.63947052;15.80514834;15;0;15;645;660;7;15;25769;591;27020;397587;212445
2021-07-08;CAM;61136;29427;31709;5588;55164;384;0;ITF;ITF3;15;Campania;40.83956555;14.25084984;215;20;235;6474;6709;-581;162;411075;7528;425312;5378510;3287109
2021-07-08;MAR;15041;7539;7502;2788;12027;226;0;ITI;ITI3;11;Marche;43.61675973;13.5188753;9;2;11;1280;1291;11;42;99595;3038;103924;1316626;770186
2021-07-08;LIG;13691;6726;6965;6119;7443;129;0;ITC;ITC3;7;Liguria;44.41149315;8.9326992;11;7;18;120;138;15;16;99037;4352;103527;1796427;696869
2021-07-09;MAR;14903;7502;7401;2557;12132;214;0;ITI;ITI3;11;Marche;43.61675973;13.5188753;8;2;10;1274;1284;-7;19;99621;3038;103943;1318414;771081
2021-07-09;PAB;5236;2616;2620;887;4174;175;0;ITH;ITH1;4;Provincia Autonoma Bolzano / Bozen;46.49933453;11.35662422;6;2;8;105;113;-5;1;72038;1180;73331;1650811;428345
2021-07-09;MOL;3450;1659;1791;168;3264;18;0;ITF;ITF2;14;Molise;41.55774754;14.65916051;2;0;2;57;59;-1;0;13173;492;13724;242912;209613
2021-07-09;ABR;13615;6795;6820;2883;10591;141;0;ITF;ITF1;13;Abruzzo;42.35122196;13.39843823;25;1;26;893;919;50;49;71642;2512;75073;1732441;700168
2021-07-09;BAS;5339;2608;2731;1697;3633;9;0;ITF;ITF5;17;Basilicata;40.63947052;15.80514834;13;1;14;583;597;-63;7;25839;591;27027;398198;212688
2021-07-09;SIC;44832;20690;24142;6403;38245;184;0;ITG;ITG1;19;Sicilia;38.11569725;13.3623567;128;20;148;3361;3509;52;201;223418;5988;232915;4998353;1893125
2021-07-09;LAZ;65144;31436;33708;27615;36756;773;0;ITI;ITI4;12;Lazio;41.89277044;12.48366722;135;27;162;1982;2144;-98;135;336245;8372;346761;7821673;4476894
2021-07-09;CAM;61511;29782;31729;4294;56846;371;0;ITF;ITF3;15;Campania;40.83956555;14.25084984;201;20;221;6521;6742;33;226;411257;7539;425538;5391111;3289470
2021-07-09;CAL;15691;7313;8378;3634;11985;72;0;ITF;ITF6;18;Calabria;38.90597598;16.59440194;45;3;48;2386;2434;-28;48;65591;1234;69259;949704;869591
2021-07-09;EMR;44938;22956;21982;5407;39103;428;0;ITH;ITH5;8;Emilia-Romagna;44.49436681;11.3417208;155;15;170;2024;2194;6;99;371950;13266;387410;6866355;1921059
2021-07-09;LIG;12855;6336;6519;4162;8601;92;0;ITC;ITC3;7;Liguria;44.41149315;8.9326992;11;7;18;127;145;7;17;99047;4352;103544;1801047;698253
2021-07-09;SAR;15884;7600;8284;3432;12369;83;0;ITG;ITG2;20;Sardegna;39.21531192;9.110616306;33;1;34;2333;2367;28;51;53575;1492;57434;1408854;822152
2021-07-09;VEN;45101;23790;21311;4124;40689;288;0;ITH;ITH3;5;Veneto;45.43490485;12.33845213;41;6;47;4770;4817;57;106;409694;11620;426131;8875719;1849161
2021-07-09;TOS;29151;14121;15030;7693;21260;198;0;ITI;ITI1;9;Toscana;43.76923077;11.25588885;68;15;83;1412;1495;9;79;236415;6888;244798;5238148;2397757
2021-07-09;LOM;115798;59021;56777;11739;103172;887;0;ITC;ITC4;3;Lombardia;45.46679409;9.190347404;127;35;162;8690;8852;167;230;800453;33795;843100;11863562;4708274
2021-07-09;FVG;11968;6361;5607;2125;9552;291;0;ITH;ITH4;6;Friuli-Venezia Giulia;45.6494354;13.76813649;6;1;7;199;206;3;17;103071;3789;107066;2199045;691098
2021-07-09;PIE;40513;20669;19844;5773;34199;541;0;ITC;ITC1;1;Piemonte;45.0732745;7.680687483;67;3;70;627;697;-4;40;350815;11698;363210;5144413;2019603
2021-07-09;PAT;5163;2739;2424;3050;1890;223;0;ITH;ITH2;4;Provincia Autonoma Trento;46.06893511;11.12123097;0;0;0;47;47;-1;4;44386;1363;45796;877388;236455
2021-07-09;PUG;37213;17930;19283;6395;30138;680;0;ITF;ITF4;16;Puglia;41.12559576;16.86736689;83;9;92;2044;2136;-215;44;244936;6650;253722;2726848;1250874
2021-07-09;VDA;946;446;500;279;657;10;0;ITC;ITC2;2;Valle d'Aosta / Vallée d'Aoste;45.73750286;7.320149366;0;0;0;22;22;0;1;11202;473;11697;142439;67435
2021-07-09;UMB;9570;4632;4938;129;9417;24;0;ITI;ITI2;10;Umbria;43.10675841;12.38824698;13;0;13;634;647;-27;1;54815;1423;56885;1481600;394079
2021-07-10;CAL;15949;7541;8408;3244;12661;44;0;ITF;ITF6;18;Calabria;38.90597598;16.59440194;46;3;49;2026;2075;-359;16;65966;1234;69275;951530;871160
2021-07-10;UMB;7690;3810;3880;66;7610;14;0;ITI;ITI2;10;Umbria;43.10675841;12.38824698;13;0;13;626;639;-8;7;54830;1423;56892;1484685;394613
2021-07-10;TOS;29317;14187;15130;7951;21176;190;0;ITI;ITI1;9;Toscana;43.76923077;11.25588885;69;16;85;1443;1528;33;63;236445;6888;244861;5248008;2401999
2021-07-10;PAT;1098;565;533;147;920;31;0;ITH;ITH2;4;Provincia Autonoma Trento;46.06893511;11.12123097;0;0;0;48;48;1;4;44389;1363;45800;878775;237010
2021-07-10;MOL;3745;1790;1955;326;3405;14;0;ITF;ITF2;14;Molise;41.55774754;14.65916051;1;0;1;57;58;-1;4;13178;492;13728;243089;209786
2021-07-10;FVG;8811;4550;4261;143;8642;26;0;ITH;ITH4;6;Friuli-Venezia Giulia;45.6494354;13.76813649;4;1;5;212;217;11;28;103084;3789;107090;2205280;692626
2021-07-10;LOM;107279;54309;52970;13914;92182;1183;0;ITC;ITC4;3;Lombardia;45.46679409;9.190347404;121;37;158;8302;8460;-392;205;801047;33798;843305;11898700;4718508
2021-07-10;PIE;41298;20946;20352;6735;34006;557;0;ITC;ITC1;1;Piemonte;45.0732745;7.680687483;64;3;67;644;711;14;33;350834;11698;363243;5166993;2024835
2021-07-10;LAZ;71212;35748;35464;25045;45478;689;0;ITI;ITI4;12;Lazio;41.89277044;12.48366722;131;26;157;2020;2177;33;176;336385;8375;346937;7846347;4479506
2021-07-10;SIC;46921;22358;24563;6053;40658;210;0;ITG;ITG1;19;Sicilia;38.11569725;13.3623567;131;18;149;3398;3547;38;192;223570;5990;233107;5008554;1897283
2021-07-10;PAB;5821;3005;2816;904;4755;162;0;ITH;ITH1;4;Provincia Autonoma Bolzano / Bozen;46.49933453;11.35662422;6;1;7;97;104;-9;15;72062;1180;73346;1654314;428610
2021-07-10;CAM;66913;32668;34245;2694;63964;255;0;ITF;ITF3;15;Campania;40.83956555;14.25084984;200;15;215;6607;6822;80;210;411385;7541;425748;5404594;3292219
2021-07-10;SAR;14242;6888;7354;2704;11503;35;0;ITG;ITG2;20;Sardegna;39.21531192;9.110616306;36;1;37;2361;2398;31;43;53587;1492;57477;1412226;824295
2021-07-10;LIG;6914;3489;3425;2722;4139;53;0;ITC;ITC3;7;Liguria;44.41149315;8.9326992;9;7;16;139;155;10;26;99063;4352;103570;1806576;700252
2021-07-10;PUG;22438;11051;11387;4444;17695;299;0;ITF;ITF4;16;Puglia;41.12559576;16.86736689;78;9;87;2023;2110;-26;41;245003;6650;253763;2733022;1252744
2021-07-10;VDA;1295;670;625;318;964;13;0;ITC;ITC2;2;Valle d'Aosta / Vallée d'Aoste;45.73750286;7.320149366;0;0;0;24;24;2;2;11202;473;11699;142710;67518
2021-07-10;MAR;14162;7234;6928;1656;12302;204;0;ITI;ITI3;11;Marche;43.61675973;13.5188753;8;2;10;1298;1308;24;35;99632;3038;103978;1320694;772334
2021-07-10;BAS;5530;2669;2861;1596;3925;9;0;ITF;ITF5;17;Basilicata;40.63947052;15.80514834;13;0;13;570;583;-14;9;25862;591;27036;398794;212913
2021-07-10;ABR;13124;6635;6489;3010;9948;166;0;ITF;ITF1;13;Abruzzo;42.35122196;13.39843823;26;1;27;879;906;-13;32;71685;2512;75103;1736410;701292
2021-07-10;EMR;42108;21442;20666;6796;34663;649;0;ITH;ITH5;8;Emilia-Romagna;44.49436681;11.3417208;153;13;166;2048;2214;20;96;372022;13268;387504;6886675;1922369
2021-07-10;VEN;43202;23219;19983;6302;36546;354;0;ITH;ITH3;5;Veneto;45.43490485;12.33845213;39;6;45;4868;4913;96;157;409755;11620;426288;8906359;1852675
2021-07-11;MAR;10399;5220;5179;1605;8657;137;0;ITI;ITI3;11;Marche;43.61675973;13.5188753;8;2;10;1324;1334;26;39;99645;3038;104017;1322655;773443
2021-07-11;PUG;12202;5768;6434;2573;9530;99;0;ITF;ITF4;16;Puglia;41.12559576;16.86736689;78;9;87;2040;2127;17;34;245020;6650;253797;2737033;1253345
2021-07-11;TOS;26197;12732;13465;9170;16852;175;0;ITI;ITI1;9;Toscana;43.76923077;11.25588885;66;15;81;1420;1501;-27;87;236558;6889;244948;5254973;2406661
2021-07-11;LIG;2154;1195;959;1229;903;22;0;ITC;ITC3;7;Liguria;44.41149315;8.9326992;9;7;16;160;176;21;26;99068;4352;103596;1809811;701525
2021-07-11;PAB;6080;3098;2982;1058;4882;140;0;ITH;ITH1;4;Provincia Autonoma Bolzano / Bozen;46.49933453;11.35662422;6;1;7;98;105;1;6;72067;1180;73352;1656532;428790
2021-07-11;ABR;9888;4977;4911;2362;7390;136;0;ITF;ITF1;13;Abruzzo;42.35122196;13.39843823;28;1;29;900;929;23;34;71696;2512;75137;1741990;703168
2021-07-11;MOL;2466;1200;1266;181;2281;4;0;ITF;ITF2;14;Molise;41.55774754;14.65916051;1;0;1;59;60;2;4;13180;492;13732;243415;210112
2021-07-11;BAS;5031;2405;2626;1508;3498;25;0;ITF;ITF5;17;Basilicata;40.63947052;15.80514834;13;0;13;551;564;-19;5;25886;591;27041;399214;213036
2021-07-11;CAL;6435;2986;3449;846;5578;11;0;ITF;ITF6;18;Calabria;38.90597598;16.59440194;45;3;48;2026;2074;-1;54;66021;1234;69329;953012;872425
2021-07-11;CAM;40870;19671;21199;1000;39776;94;0;ITF;ITF3;15;Campania;40.83956555;14.25084984;196;15;211;6670;6881;59;169;411495;7541;425917;5415803;3295183
2021-07-11;LAZ;44188;22286;21902;3743;40277;168;0;ITI;ITI4;12;Lazio;41.89277044;12.48366722;128;25;153;2078;2231;54;164;336494;8376;347101;7866864;4482118
2021-07-11;LOM;90351;45711;44640;11767;77526;1058;0;ITC;ITC4;3;Lombardia;45.46679409;9.190347404;124;37;161;7915;8076;-384;250;801680;33799;843555;11925412;4726894
2021-07-11;EMR;30400;15244;15156;2747;27384;269;0;ITH;ITH5;8;Emilia-Romagna;44.49436681;11.3417208;150;13;163;2064;2227;13;93;372102;13268;387597;6898669;1923573
2021-07-11;SAR;6380;3119;3261;1423;4921;36;0;ITG;ITG2;20;Sardegna;39.21531192;9.110616306;38;1;39;2403;2442;44;52;53595;1492;57529;1414001;825767
2021-07-11;VEN;34242;17926;16316;3700;30284;258;0;ITH;ITH3;5;Veneto;45.43490485;12.33845213;39;8;47;4961;5008;95;125;409784;11621;426413;8927599;1855527
2021-07-11;VDA;909;473;436;252;643;14;0;ITC;ITC2;2;Valle d'Aosta / Vallée d'Aoste;45.73750286;7.320149366;0;0;0;23;23;-1;1;11204;473;11700;143001;67649
2021-07-11;UMB;5875;2967;2908;89;5785;1;0;ITI;ITI2;10;Umbria;43.10675841;12.38824698;13;1;14;625;639;0;11;54841;1423;56903;1488134;395026
2021-07-11;SIC;36046;16872;19174;3663;32287;96;0;ITG;ITG1;19;Sicilia;38.11569725;13.3623567;129;17;146;3504;3650;103;183;223648;5992;233290;5015876;1900393
2021-07-11;FVG;6875;3592;3283;2384;4188;303;0;ITH;ITH4;6;Friuli-Venezia Giulia;45.6494354;13.76813649;4;1;5;208;213;-4;6;103094;3789;107096;2208106;693538
2021-07-11;PIE;33236;16939;16297;4535;28376;325;0;ITC;ITC1;1;Piemonte;45.0732745;7.680687483;63;4;67;676;743;32;47;350849;11698;363290;5176401;2028277
2021-07-11;PAT;1037;567;470;131;897;9;0;ITH;ITH2;4;Provincia Autonoma Trento;46.06893511;11.12123097;0;0;0;47;47;-1;3;44393;1363;45803;880208;237583
2021-07-12;VDA;979;483;496;238;733;8;0;ITC;ITC2;2;Valle d'Aosta / Vallée d'Aoste;45.73750286;7.320149366;0;0;0;20;20;-3;0;11207;473;11700;143440;67888
2021-07-12;ABR;15078;7458;7620;2357;12604;117;0;ITF;ITF1;13;Abruzzo;42.35122196;13.39843823;29;1;30;924;954;25;25;71696;2512;75162;1746571;704756
2021-07-12;BAS;5443;2594;2849;1608;3809;26;0;ITF;ITF5;17;Basilicata;40.63947052;15.80514834;13;0;13;545;558;-6;0;25892;591;27041;399336;213069
2021-07-12;PIE;39266;20249;19017;4562;34219;485;0;ITC;ITC1;1;Piemonte;45.0732745;7.680687483;62;3;65;686;751;8;17;350858;11698;363307;5186671;2029850
2021-07-12;UMB;4633;2242;2391;105;4516;12;0;ITI;ITI2;10;Umbria;43.10675841;12.38824698;12;1;13;615;628;-11;13;54864;1424;56916;1491459;395443
2021-07-12;SIC;49016;22620;26396;6439;42374;203;0;ITG;ITG1;19;Sicilia;38.11569725;13.3623567;140;18;158;3577;3735;85;150;223713;5992;233440;5022569;1902891
2021-07-12;CAM;56705;27377;29328;3683;52607;415;0;ITF;ITF3;15;Campania;40.83956555;14.25084984;198;15;213;6591;6804;-77;69;411638;7544;425986;5418976;3296026
2021-07-12;CAL;17982;8539;9443;2687;15246;49;0;ITF;ITF6;18;Calabria;38.90597598;16.59440194;46;2;48;2011;2059;-15;13;66047;1236;69342;954074;873206
2021-07-12;LIG;13466;6467;6999;4125;9253;88;0;ITC;ITC3;7;Liguria;44.41149315;8.9326992;6;6;12;163;175;-1;9;99078;4352;103605;1812188;702350
2021-07-12;TOS;28292;14009;14283;9661;18327;304;0;ITI;ITI1;9;Toscana;43.76923077;11.25588885;66;14;80;1391;1471;-30;66;236652;6891;245014;5258261;2408512
2021-07-12;EMR;44075;22332;21743;5424;38140;511;0;ITH;ITH5;8;Emilia-Romagna;44.49436681;11.3417208;151;14;165;2031;2196;-31;118;372251;13268;387715;6906471;1924399
2021-07-12;FVG;10041;5156;4885;1109;8776;156;0;ITH;ITH4;6;Friuli-Venezia Giulia;45.6494354;13.76813649;3;1;4;221;225;12;17;103098;3789;107112;2209278;693830
2021-07-12;PAT;4278;2155;2123;2031;2043;204;0;ITH;ITH2;4;Provincia Autonoma Trento;46.06893511;11.12123097;0;0;0;50;50;3;7;44397;1363;45810;882023;238309
2021-07-12;VEN;43250;22784;20466;4010;38914;326;0;ITH;ITH3;5;Veneto;45.43490485;12.33845213;38;7;45;5036;5081;73;76;409786;11622;426489;8938045;1856834
2021-07-12;MAR;13724;6805;6919;1228;12378;118;0;ITI;ITI3;11;Marche;43.61675973;13.5188753;8;2;10;1319;1329;-5;9;99659;3038;104026;1323500;773802
2021-07-12;PAB;3534;1755;1779;238;3243;53;0;ITH;ITH1;4;Provincia Autonoma Bolzano / Bozen;46.49933453;11.35662422;6;1;7;100;107;2;5;72070;1180;73357;1658730;428986
2021-07-12;PUG;45872;21665;24207;12713;32396;763;0;ITF;ITF4;16;Puglia;41.12559576;16.86736689;73;9;82;1797;1879;-248;19;245285;6652;253816;2741375;1254617
2021-07-12;MOL;2702;1336;1366;365;2315;22;0;ITF;ITF2;14;Molise;41.55774754;14.65916051;1;0;1;64;65;5;10;13185;492;13742;243832;210524
2021-07-12;SAR;15335;7414;7921;2400;12877;58;0;ITG;ITG2;20;Sardegna;39.21531192;9.110616306;39;2;41;2445;2486;44;51;53602;1492;57580;1415018;826426
2021-07-12;LAZ;41478;20742;20736;5848;35392;238;0;ITI;ITI4;12;Lazio;41.89277044;12.48366722;133;25;158;2061;2219;-12;172;336677;8377;347273;7876815;4484397
2021-07-12;LOM;111901;57521;54380;14807;95955;1139;0;ITC;ITC4;3;Lombardia;45.46679409;9.190347404;128;36;164;7464;7628;-448;95;802222;33800;843650;11934113;4733209
2021-07-13;PAT;3847;1956;1891;1776;1934;137;0;ITH;ITH2;4;Provincia Autonoma Trento;46.06893511;11.12123097;0;0;0;52;52;2;6;44401;1363;45816;883110;238744
2021-07-13;VEN;43581;22616;20965;5418;37852;311;0;ITH;ITH3;5;Veneto;45.43490485;12.33845213;42;8;50;5225;5275;194;254;409845;11623;426743;8964062;1861010
2021-07-13;TOS;29351;14739;14612;7712;21462;177;0;ITI;ITI1;9;Toscana;43.76923077;11.25588885;57;15;72;1396;1468;-3;65;236719;6892;245079;5265110;2412512
2021-07-13;FVG;11097;5722;5375;1175;9770;152;0;ITH;ITH4;6;Friuli-Venezia Giulia;45.6494354;13.76813649;4;1;5;224;229;4;15;103107;3789;107125;2214662;695039
2021-07-13;PIE;38919;20077;18842;3676;34902;341;0;ITC;ITC1;1;Piemonte;45.0732745;7.680687483;55;3;58;719;777;26;53;350885;11698;363360;5200541;2033747
2021-07-13;LOM;108727;56849;51878;15456;92036;1235;0;ITC;ITC4;3;Lombardia;45.46679409;9.190347404;131;35;166;7674;7840;212;241;802249;33802;843891;11963426;4740895
2021-07-13;SIC;46146;21180;24966;6921;39003;222;0;ITG;ITG1;19;Sicilia;38.11569725;13.3623567;139;20;159;3636;3795;60;174;223823;5996;233614;5038068;1907421
2021-07-13;CAM;53700;25798;27902;4660;48507;533;0;ITF;ITF3;15;Campania;40.83956555;14.25084984;197;14;211;6561;6772;-32;136;411799;7551;426122;5433896;3299268
2021-07-13;SAR;17810;8524;9286;3253;14479;78;0;ITG;ITG2;20;Sardegna;39.21531192;9.110616306;42;1;43;2520;2563;77;86;53611;1492;57666;1419811;828452
2021-07-13;PUG;48871;23043;25828;7760;40526;585;0;ITF;ITF4;16;Puglia;41.12559576;16.86736689;69;8;77;1635;1712;-167;97;245548;6653;253913;2748902;1256069
2021-07-13;MOL;2832;1437;1395;323;2491;18;0;ITF;ITF2;14;Molise;41.55774754;14.65916051;1;0;1;53;54;-11;0;13196;492;13742;243867;210560
2021-07-13;VDA;1064;567;497;310;748;6;0;ITC;ITC2;2;Valle d'Aosta / Vallée d'Aoste;45.73750286;7.320149366;0;0;0;22;22;2;2;11207;473;11702;143865;68073
2021-07-13;LIG;13113;6451;6662;3455;9591;67;0;ITC;ITC3;7;Liguria;44.41149315;8.9326992;11;6;17;168;185;10;25;99093;4352;103630;1817831;703931
2021-07-13;MAR;14853;7277;7576;1456;13267;130;0;ITI;ITI3;11;Marche;43.61675973;13.5188753;9;2;11;1328;1339;10;21;99670;3038;104047;1325881;775056
2021-07-13;UMB;4238;2006;2232;78;4152;8;0;ITI;ITI2;10;Umbria;43.10675841;12.38824698;9;1;10;623;633;5;17;54876;1424;56933;1496034;395897
2021-07-13;BAS;5853;2825;3028;1770;4034;49;0;ITF;ITF5;17;Basilicata;40.63947052;15.80514834;12;0;12;542;554;-4;3;25899;591;27044;399971;213303
2021-07-13;ABR;15527;7754;7773;2822;12528;177;0;ITF;ITF1;13;Abruzzo;42.35122196;13.39843823;29;1;30;912;942;-12;0;71708;2512;75162;1747372;705010
2021-07-13;LAZ;42798;20989;21809;5493;36944;361;0;ITI;ITI4;12;Lazio;41.89277044;12.48366722;129;25;154;2001;2155;-64;166;336904;8380;347439;7902542;4487414
2021-07-13;EMR;48508;24849;23659;6469;41348;691;0;ITH;ITH5;8;Emilia-Romagna;44.49436681;11.3417208;144;13;157;1956;2113;-83;76;372408;13268;387789;6924098;1925988
2021-07-13;CAL;17441;8160;9281;2304;15066;71;0;ITF;ITF6;18;Calabria;38.90597598;16.59440194;44;2;46;2009;2055;-4;45;66096;1236;69387;956364;875212
2021-07-13;PAB;3387;1734;1653;1282;1931;174;0;ITH;ITH1;4;Provincia Autonoma Bolzano / Bozen;46.49933453;11.35662422;7;2;9;99;108;1;12;72081;1180;73369;1661155;429110
2021-07-14;PAB;876;456;420;461;361;54;0;ITH;ITH1;4;Provincia Autonoma Bolzano / Bozen;46.49933453;11.35662422;7;2;9;102;111;3;12;72090;1180;73381;1664222;429110
2021-07-14;MOL;3444;1684;1760;211;3216;17;0;ITF;ITF2;14;Molise;41.55774754;14.65916051;1;0;1;60;61;7;7;13196;492;13749;244216;210906
2021-07-14;ABR;13723;6799;6924;2435;11136;152;0;ITF;ITF1;13;Abruzzo;42.35122196;13.39843823;28;1;29;903;932;-10;33;71751;2512;75195;1751751;706224
2021-07-14;BAS;5642;2721;2921;1627;3990;25;0;ITF;ITF5;17;Basilicata;40.63947052;15.80514834;12;0;12;533;545;-9;10;25918;591;27054;400445;213505
2021-07-14;VEN;43648;22443;21205;5280;37966;402;0;ITH;ITH3;5;Veneto;45.43490485;12.33845213;42;8;50;5442;5492;217;261;409888;11624;427004;8993527;1865810
2021-07-14;FVG;10915;5584;5331;1256;9466;193;0;ITH;ITH4;6;Friuli-Venezia Giulia;45.6494354;13.76813649;5;1;6;224;230;1;42;103148;3789;107167;2220387;696319
2021-07-14;PIE;39092;20105;18987;3601;35061;430;0;ITC;ITC1;1;Piemonte;45.0732745;7.680687483;50;4;54;747;801;24;84;350944;11699;363444;5215698;2038525
2021-07-14;EMR;47990;24550;23440;5588;41866;536;0;ITH;ITH5;8;Emilia-Romagna;44.49436681;11.3417208;144;14;158;2022;2180;67;117;372458;13268;387906;6941020;1927838
2021-07-14;SIC;47571;22029;25542;7932;39378;261;0;ITG;ITG1;19;Sicilia;38.11569725;13.3623567;137;20;157;3781;3938;143;288;223958;6006;233902;5050007;1912275
2021-07-14;VDA;1022;535;487;288;729;5;0;ITC;ITC2;2;Valle d'Aosta / Vallée d'Aoste;45.73750286;7.320149366;0;0;0;22;22;0;0;11207;473;11702;143981;68151
2021-07-14;CAM;51122;24587;26535;4240;46504;378;0;ITF;ITF3;15;Campania;40.83956555;14.25084984;192;12;204;6588;6792;20;188;411965;7553;426310;5449588;3301509
2021-07-14;TOS;28973;14303;14670;8607;20107;259;0;ITI;ITI1;9;Toscana;43.76923077;11.25588885;57;14;71;1410;1481;13;90;236792;6896;245169;5286816;2417409
2021-07-14;PAT;4202;2184;2018;1695;2357;150;0;ITH;ITH2;4;Provincia Autonoma Trento;46.06893511;11.12123097;0;0;0;52;52;0;2;44403;1363;45818;883410;238864
2021-07-14;MAR;13852;6818;7034;1785;11875;192;0;ITI;ITI3;11;Marche;43.61675973;13.5188753;10;2;12;1362;1374;35;60;99695;3038;104107;1328678;776516
2021-07-14;LOM;109458;56864;52594;14355;93694;1409;0;ITC;ITC4;3;Lombardia;45.46679409;9.190347404;123;32;155;8045;8200;360;420;802309;33802;844311;11998356;4749831
2021-07-14;CAL;22650;10682;11968;4156;18417;77;0;ITF;ITF6;18;Calabria;38.90597598;16.59440194;48;2;50;1989;2039;-16;56;66168;1236;69443;958624;877227
2021-07-14;SAR;16913;8191;8722;3773;13029;111;0;ITG;ITG2;20;Sardegna;39.21531192;9.110616306;48;1;49;2632;2681;118;135;53627;1493;57801;1422433;830630
2021-07-14;PUG;46335;22221;24114;13362;32136;837;0;ITF;ITF4;16;Puglia;41.12559576;16.86736689;72;8;80;1567;1647;-65;44;245654;6656;253957;2754985;1257612
2021-07-14;LIG;11530;5677;5853;3399;8046;85;0;ITC;ITC3;7;Liguria;44.41149315;8.9326992;8;5;13;195;208;23;40;99109;4353;103670;1823489;705509
2021-07-14;LAZ;42243;20598;21645;6188;35685;370;0;ITI;ITI4;12;Lazio;41.89277044;12.48366722;121;25;146;2082;2228;73;208;337038;8381;347647;7927676;4490886
2021-07-14;UMB;6208;3011;3197;1634;4264;310;0;ITI;ITI2;10;Umbria;43.10675841;12.38824698;7;1;8;621;629;-4;6;54886;1424;56939;1499671;396303
2021-07-15;PIE;42641;22029;20612;4113;38060;468;0;ITC;ITC1;1;Piemonte;45.0732745;7.680687483;49;4;53;785;838;37;68;350975;11699;363512;5229285;2041199
2021-07-15;SAR;18777;9237;9540;4644;14031;102;0;ITG;ITG2;20;Sardegna;39.21531192;9.110616306;42;3;45;1219;1264;-1417;112;55155;1494;57913;1428053;832896
2021-07-15;SIC;48441;22479;25962;8012;40165;264;0;ITG;ITG1;19;Sicilia;38.11569725;13.3623567;140;21;161;3979;4140;202;353;224129;6006;234275;5062086;1916265
2021-07-15;LAZ;45090;22081;23009;6692;37951;447;0;ITI;ITI4;12;Lazio;41.89277044;12.48366722;105;25;130;2260;2390;162;353;337228;8382;348000;7953073;4494779
2021-07-15;EMR;50404;26251;24153;7887;41807;710;0;ITH;ITH5;8;Emilia-Romagna;44.49436681;11.3417208;140;14;154;2103;2257;77;167;372548;13268;388073;6956769;1929200
2021-07-15;FVG;10099;5145;4954;945;8910;244;0;ITH;ITH4;6;Friuli-Venezia Giulia;45.6494354;13.76813649;5;1;6;225;231;1;21;103168;3789;107188;2226593;697551
2021-07-15;CAM;66739;32057;34682;8668;57089;982;0;ITF;ITF3;15;Campania;40.83956555;14.25084984;195;12;207;6701;6908;116;234;412082;7554;426544;5462609;3303607
2021-07-15;UMB;10579;5179;5400;567;9913;99;0;ITI;ITI2;10;Umbria;43.10675841;12.38824698;8;1;9;616;625;-4;4;54894;1424;56943;1500479;396459
2021-07-15;PAT;4304;2306;1998;1791;2367;146;0;ITH;ITH2;4;Provincia Autonoma Trento;46.06893511;11.12123097;0;0;0;49;49;-3;10;44416;1363;45828;884608;239343
2021-07-15;LOM;109400;56282;53118;13379;94827;1194;0;ITC;ITC4;3;Lombardia;45.46679409;9.190347404;128;29;157;7720;7877;-323;381;803013;33802;844692;12030688;4757739
2021-07-15;TOS;31270;15306;15964;8096;22926;248;0;ITI;ITI1;9;Toscana;43.76923077;11.25588885;62;15;77;1490;1567;86;173;236878;6897;245342;5298127;2422494
2021-07-15;ABR;15944;8087;7857;3129;12639;176;0;ITF;ITF1;13;Abruzzo;42.35122196;13.39843823;25;1;26;909;935;3;42;71790;2512;75237;1757225;707498
2021-07-15;BAS;6479;3211;3268;1668;4785;26;0;ITF;ITF5;17;Basilicata;40.63947052;15.80514834;10;0;10;534;544;-1;5;25924;591;27059;401217;213838
2021-07-15;VEN;51458;26928;24530;6020;45053;385;0;ITH;ITH3;5;Veneto;45.43490485;12.33845213;42;10;52;5693;5745;253;318;409952;11625;427322;9021475;1870696
2021-07-15;PAB;4398;2320;2078;1448;2704;246;0;ITH;ITH1;4;Provincia Autonoma Bolzano / Bozen;46.49933453;11.35662422;7;2;9;107;116;5;11;72095;1181;73392;1666398;429430
2021-07-15;PUG;44971;21767;23204;8879;35413;679;0;ITF;ITF4;16;Puglia;41.12559576;16.86736689;69;7;76;1575;1651;4;42;245690;6658;253999;2761070;1259104
2021-07-15;VDA;1103;597;506;285;804;14;0;ITC;ITC2;2;Valle d'Aosta / Vallée d'Aoste;45.73750286;7.320149366;0;0;0;19;19;-3;1;11210;474;11703;144342;68309
2021-07-15;MOL;3231;1625;1606;215;3001;15;0;ITF;ITF2;14;Molise;41.55774754;14.65916051;1;0;1;61;62;1;1;13196;492;13750;244333;211023
2021-07-15;CAL;18288;8811;9477;2519;15716;53;0;ITF;ITF6;18;Calabria;38.90597598;16.59440194;48;2;50;1936;1986;-53;32;66253;1236;69475;960600;878927
2021-07-15;LIG;14795;7486;7309;5116;9520;159;0;ITC;ITC3;7;Liguria;44.41149315;8.9326992;7;5;12;218;230;22;31;99117;4354;103701;1827676;706884
2021-07-15;MAR;16010;8287;7723;1749;14032;229;0;ITI;ITI3;11;Marche;43.61675973;13.5188753;9;2;11;1380;1391;17;40;99718;3038;104147;1330934;777728
2021-07-16;PAB;4516;2452;2064;1029;3322;165;0;ITH;ITH1;4;Provincia Autonoma Bolzano / Bozen;46.49933453;11.35662422;7;2;9;118;127;11;0;72083;1182;73392;1666566;429484
2021-07-16;PUG;46652;22643;24009;12936;32900;816;0;ITF;ITF4;16;Puglia;41.12559576;16.86736689;65;9;74;1567;1641;-10;46;245746;6658;254045;2767226;1260510
2021-07-16;MOL;3186;1614;1572;405;2751;30;0;ITF;ITF2;14;Molise;41.55774754;14.65916051;1;0;1;54;55;-7;0;13203;492;13750;244525;211215
2021-07-16;ABR;16152;8239;7913;2466;13569;117;0;ITF;ITF1;13;Abruzzo;42.35122196;13.39843823;24;1;25;903;928;-7;50;71844;2513;75285;1761623;708658
2021-07-16;VDA;1079;555;524;337;731;11;0;ITC;ITC2;2;Valle d'Aosta / Vallée d'Aoste;45.73750286;7.320149366;0;0;0;19;19;0;0;11211;473;11703;144648;68439
2021-07-16;MAR;15839;8240;7599;1844;13737;258;0;ITI;ITI3;11;Marche;43.61675973;13.5188753;11;2;13;1406;1419;28;52;99742;3038;104199;1333388;778959
2021-07-16;BAS;5934;2901;3033;1803;4097;34;0;ITF;ITF5;17;Basilicata;40.63947052;15.80514834;14;0;14;526;540;-4;10;25938;591;27069;401611;214002
2021-07-16;LAZ;44509;21459;23050;3325;40995;189;0;ITI;ITI4;12;Lazio;41.89277044;12.48366722;105;25;130;2515;2645;255;443;337414;8384;348443;7979053;4498502
2021-07-16;EMR;49800;26291;23509;7026;42099;675;0;ITH;ITH5;8;Emilia-Romagna;44.49436681;11.3417208;148;15;163;2195;2358;101;200;372646;13268;388272;6976623;1930574
2021-07-16;CAL;21063;10035;11028;3374;17612;77;0;ITF;ITF6;18;Calabria;38.90597598;16.59440194;47;3;50;1955;2005;19;77;66311;1236;69552;962537;880651
2021-07-16;PAT;4607;2376;2231;1729;2712;166;0;ITH;ITH2;4;Provincia Autonoma Trento;46.06893511;11.12123097;0;0;0;71;71;22;24;44418;1363;45852;885973;239889
2021-07-16;VEN;44756;24079;20677;6954;37336;466;0;ITH;ITH3;5;Veneto;45.43490485;12.33845213;41;11;52;6045;6097;352;425;410024;11626;427747;9051554;1874840
2021-07-16;TOS;27695;14054;13641;7707;19733;255;0;ITI;ITI1;9;Toscana;43.76923077;11.25588885;60;16;76;1598;1674;107;169;236939;6898;245511;5309547;2427278
2021-07-16;LIG;12637;6228;6409;3122;9440;75;0;ITC;ITC3;7;Liguria;44.41149315;8.9326992;8;5;13;243;256;26;54;99144;4355;103755;1833076;708673
2021-07-16;SAR;16937;8476;8461;4555;12247;135;0;ITG;ITG2;20;Sardegna;39.21531192;9.110616306;43;3;46;1353;1399;135;140;55160;1494;58053;1432213;835389
2021-07-16;LOM;108932;56716;52216;11140;96628;1164;0;ITC;ITC4;3;Lombardia;45.46679409;9.190347404;143;30;173;8080;8253;376;399;803034;33804;845091;12065399;4766855
2021-07-16;FVG;9818;5245;4573;1706;7964;148;0;ITH;ITH4;6;Friuli-Venezia Giulia;45.6494354;13.76813649;6;1;7;226;233;2;26;103192;3789;107214;2232644;698715
2021-07-16;CAM;61067;29875;31192;6502;53921;644;0;ITF;ITF3;15;Campania;40.83956555;14.25084984;171;12;183;6725;6908;0;204;412282;7558;426748;5475416;3305648
2021-07-16;PIE;42158;22019;20139;3609;38128;421;0;ITC;ITC1;1;Piemonte;45.0732745;7.680687483;48;3;51;869;920;82;115;351008;11699;363627;5249917;2045489
2021-07-16;UMB;9633;4900;4733;665;8889;79;0;ITI;ITI2;10;Umbria;43.10675841;12.38824698;8;1;9;614;623;-2;15;54911;1424;56958;1504873;396963
2021-07-16;SIC;49379;23385;25994;8720;40366;293;0;ITG;ITG1;19;Sicilia;38.11569725;13.3623567;144;23;167;4242;4409;269;386;224246;6006;234661;5071669;1920876
2021-07-17;BAS;5858;2918;2940;1709;4110;39;0;ITF;ITF5;17;Basilicata;40.63947052;15.80514834;14;0;14;533;547;7;11;25942;591;27080;402257;214255
2021-07-17;SIC;49327;24296;25031;9312;39714;301;0;ITG;ITG1;19;Sicilia;38.11569725;13.3623567;143;23;166;4621;4787;378;431;224299;6006;235092;5084845;1925293
2021-07-17;EMR;43670;23056;20614;7169;35759;742;0;ITH;ITH5;8;Emilia-Romagna;44.49436681;11.3417208;145;14;159;2329;2488;130;207;372723;13268;388479;6998929;1932454
2021-07-17;FVG;7394;3969;3425;620;6690;84;0;ITH;ITH4;6;Friuli-Venezia Giulia;45.6494354;13.76813649;8;0;8;237;245;12;30;103208;3789;107242;2239567;700442
2021-07-17;CAM;55272;27562;27710;3341;51549;382;0;ITF;ITF3;15;Campania;40.83956555;14.25084984;182;12;194;6854;7048;140;238;412378;7560;426986;5489756;3308617
2021-07-17;LOM;108512;57299;51213;10222;97362;928;0;ITC;ITC4;3;Lombardia;45.46679409;9.190347404;136;31;167;6911;7078;-1175;438;804643;33808;845529;12103488;4777828
2021-07-17;PIE;42062;22140;19922;4958;36605;499;0;ITC;ITC1;1;Piemonte;45.0732745;7.680687483;45;3;48;901;949;29;55;351034;11699;363682;5273856;2050428
2021-07-17;PAT;1100;537;563;270;809;21;0;ITH;ITH2;4;Provincia Autonoma Trento;46.06893511;11.12123097;1;1;2;85;87;16;23;44425;1363;45875;887586;240534
2021-07-17;CAL;18337;9047;9290;2705;15563;69;0;ITF;ITF6;18;Calabria;38.90597598;16.59440194;48;4;52;1951;2003;-2;51;66364;1236;69603;964248;882127
2021-07-17;UMB;7675;3858;3817;1287;6240;148;0;ITI;ITI2;10;Umbria;43.10675841;12.38824698;8;1;9;617;626;3;15;54923;1424;56973;1508543;397573
2021-07-17;SAR;12871;6302;6569;3178;9626;67;0;ITG;ITG2;20;Sardegna;39.21531192;9.110616306;56;4;60;1518;1578;179;190;55171;1494;58243;1436313;838017
2021-07-17;PUG;30880;15506;15374;9533;20717;630;0;ITF;ITF4;16;Puglia;41.12559576;16.86736689;65;9;74;1625;1699;58;81;245768;6659;254126;2773928;1262013
2021-07-17;LAZ;43979;22182;21797;2172;41699;108;0;ITI;ITI4;12;Lazio;41.89277044;12.48366722;105;25;130;2838;2968;323;500;337589;8386;348943;8013887;4502168
2021-07-17;PAB;3147;1801;1346;683;2352;112;0;ITH;ITH1;4;Provincia Autonoma Bolzano / Bozen;46.49933453;11.35662422;6;2;8;131;139;12;18;72089;1182;73410;1670110;429693
2021-07-17;VDA;988;521;467;246;734;8;0;ITC;ITC2;2;Valle d'Aosta / Vallée d'Aoste;45.73750286;7.320149366;0;0;0;19;19;0;0;11211;473;11703;144928;68574
2021-07-17;ABR;14097;7385;6712;2645;11272;180;0;ITF;ITF1;13;Abruzzo;42.35122196;13.39843823;25;1;26;898;924;-4;25;71871;2513;75308;1766547;710017
2021-07-17;MAR;15139;7792;7347;1383;13544;212;0;ITI;ITI3;11;Marche;43.61675973;13.5188753;11;2;13;1441;1454;35;53;99760;3038;104252;1335622;780268
2021-07-17;LIG;6515;3359;3156;1786;4698;31;0;ITC;ITC3;7;Liguria;44.41149315;8.9326992;11;5;16;277;293;37;55;99161;4356;103810;1838949;710894
2021-07-17;VEN;40620;21489;19131;4297;35978;345;0;ITH;ITH3;5;Veneto;45.43490485;12.33845213;44;10;54;6414;6468;371;424;410074;11629;428171;9090400;1880199
2021-07-17;TOS;27764;14347;13417;8962;18561;241;0;ITI;ITI1;9;Toscana;43.76923077;11.25588885;63;17;80;1766;1846;172;222;236989;6898;245733;5322515;2432192
2021-07-17;MOL;2884;1538;1346;306;2555;23;0;ITF;ITF2;14;Molise;41.55774754;14.65916051;1;0;1;66;67;12;16;13207;492;13766;245321;212007
2021-07-18;VEN;37723;19763;17960;3847;33626;250;0;ITH;ITH3;5;Veneto;45.43490485;12.33845213;45;9;54;6762;6816;348;379;410105;11629;428550;9119007;1885669
2021-07-18;LIG;2384;1223;1161;381;1986;17;0;ITC;ITC3;7;Liguria;44.41149315;8.9326992;12;5;17;321;338;45;72;99188;4356;103882;1843217;712716
2021-07-18;LOM;97110;50595;46515;8544;87873;693;0;ITC;ITC4;3;Lombardia;45.46679409;9.190347404;135;31;166;7241;7407;329;369;804682;33809;845898;12131864;4786790
2021-07-18;TOS;30397;15284;15113;8343;21844;210;0;ITI;ITI1;9;Toscana;43.76923077;11.25588885;66;16;82;1974;2056;210;243;237022;6898;245976;5332705;2436421
2021-07-18;PAT;465;244;221;116;339;10;0;ITH;ITH2;4;Provincia Autonoma Trento;46.06893511;11.12123097;0;1;1;112;113;26;33;44432;1363;45908;889082;241132
2021-07-18;MAR;12125;6310;5815;1333;10674;118;0;ITI;ITI3;11;Marche;43.61675973;13.5188753;13;2;15;1471;1486;32;60;99788;3038;104312;1338039;781721
2021-07-18;PUG;18856;9654;9202;6194;12323;339;0;ITF;ITF4;16;Puglia;41.12559576;16.86736689;66;9;75;1683;1758;59;70;245779;6659;254196;2777620;1262545
2021-07-18;MOL;1947;975;972;142;1794;11;0;ITF;ITF2;14;Molise;41.55774754;14.65916051;1;0;1;76;77;10;10;13207;492;13776;245692;212378
2021-07-18;ABR;12206;6312;5894;1995;10087;124;0;ITF;ITF1;13;Abruzzo;42.35122196;13.39843823;22;1;23;916;939;15;34;71889;2513;75341;1772682;712021
2021-07-18;PAB;1872;1034;838;637;1150;85;0;ITH;ITH1;4;Provincia Autonoma Bolzano / Bozen;46.49933453;11.35662422;5;1;6;140;146;7;13;72095;1182;73423;1672534;429836
2021-07-18;SIC;39292;19790;19502;8099;30958;235;0;ITG;ITG1;19;Sicilia;38.11569725;13.3623567;149;21;170;4953;5123;336;404;224367;6006;235496;5090677;1928449
2021-07-18;LAZ;58430;29749;28681;22757;34849;824;0;ITI;ITI4;12;Lazio;41.89277044;12.48366722;119;26;145;3254;3399;431;471;337629;8386;349414;8037320;4505620
2021-07-18;CAM;31388;15808;15580;3762;27169;457;0;ITF;ITF3;15;Campania;40.83956555;14.25084984;175;10;185;7016;7201;153;244;412468;7561;427230;5502699;3311291
2021-07-18;EMR;34593;17922;16671;8183;25840;570;0;ITH;ITH5;8;Emilia-Romagna;44.49436681;11.3417208;141;13;154;2552;2706;218;266;372771;13268;388745;7012132;1933745
2021-07-18;BAS;4389;2163;2226;1576;2786;27;0;ITF;ITF5;17;Basilicata;40.63947052;15.80514834;13;0;13;541;554;7;11;25946;591;27091;402837;214474
2021-07-18;CAL;8794;4207;4587;1280;7482;32;0;ITF;ITF6;18;Calabria;38.90597598;16.59440194;50;4;54;1952;2006;3;39;66399;1237;69642;965891;883561
2021-07-18;SAR;5693;2874;2819;982;4701;10;0;ITG;ITG2;20;Sardegna;39.21531192;9.110616306;60;4;64;1735;1799;221;233;55183;1494;58476;1438847;840145
2021-07-18;VDA;933;457;476;240;674;19;0;ITC;ITC2;2;Valle d'Aosta / Vallée d'Aoste;45.73750286;7.320149366;0;0;0;22;22;3;5;11213;473;11708;145284;68786
2021-07-18;UMB;7854;4063;3791;273;7554;27;0;ITI;ITI2;10;Umbria;43.10675841;12.38824698;7;1;8;609;617;-9;20;54952;1424;56993;1512006;398051
2021-07-18;PIE;32942;17275;15667;3251;29355;336;0;ITC;ITC1;1;Piemonte;45.0732745;7.680687483;46;3;49;959;1008;59;77;351052;11699;363759;5284449;2053835
2021-07-18;FVG;5479;2963;2516;441;5014;24;0;ITH;ITH4;6;Friuli-Venezia Giulia;45.6494354;13.76813649;9;0;9;239;248;3;16;103220;3789;107257;2242731;701351
2021-07-19;VDA;879;460;419;251;619;9;0;ITC;ITC2;2;Valle d'Aosta / Vallée d'Aoste;45.73750286;7.320149366;0;0;0;24;24;2;2;11213;473;11710;145667;69007
2021-07-19;ABR;11778;5982;5796;2661;8944;173;0;ITF;ITF1;13;Abruzzo;42.35122196;13.39843823;21;1;22;968;990;51;52;71890;2513;75393;1777895;713667
2021-07-19;BAS;5926;2890;3036;1997;3886;43;0;ITF;ITF5;17;Basilicata;40.63947052;15.80514834;16;0;16;534;550;-4;0;25950;591;27091;402952;214512
2021-07-19;LAZ;63232;31092;32140;28294;33782;1156;0;ITI;ITI4;12;Lazio;41.89277044;12.48366722;130;29;159;3475;3634;235;434;337827;8387;349848;8048857;4508232
2021-07-19;CAL;19022;9110;9912;3030;15941;51;0;ITF;ITF6;18;Calabria;38.90597598;16.59440194;50;5;55;1996;2051;45;59;66413;1237;69701;967073;884526
2021-07-19;UMB;7672;3842;3830;1527;6044;101;0;ITI;ITI2;10;Umbria;43.10675841;12.38824698;4;1;5;657;662;45;56;54963;1424;57049;1516171;398530
2021-07-19;EMR;42020;22132;19888;6630;34788;602;0;ITH;ITH5;8;Emilia-Romagna;44.49436681;11.3417208;142;14;156;2700;2856;150;219;372839;13268;388963;7019934;1934750
2021-07-19;MAR;14678;7531;7147;1925;12538;215;0;ITI;ITI3;11;Marche;43.61675973;13.5188753;13;2;15;1486;1501;15;25;99798;3038;104337;1338853;782059
2021-07-19;PAT;4819;2538;2281;1451;3227;141;0;ITH;ITH2;4;Provincia Autonoma Trento;46.06893511;11.12123097;1;1;2;126;128;15;26;44443;1363;45934;891042;241916
2021-07-19;FVG;9453;4942;4511;854;8445;154;0;ITH;ITH4;6;Friuli-Venezia Giulia;45.6494354;13.76813649;9;0;9;240;249;1;6;103225;3789;107263;2244254;701734
2021-07-19;LIG;12120;6043;6077;3309;8709;102;0;ITC;ITC3;7;Liguria;44.41149315;8.9326992;15;5;20;355;375;37;38;99189;4356;103920;1845518;713537
2021-07-19;PIE;39682;20647;19035;4511;34746;425;0;ITC;ITC1;1;Piemonte;45.0732745;7.680687483;54;3;57;956;1013;5;28;351075;11699;363787;5295768;2055658
2021-07-19;PAB;2784;1397;1387;609;2048;127;0;ITH;ITH1;4;Provincia Autonoma Bolzano / Bozen;46.49933453;11.35662422;5;0;5;148;153;7;22;72110;1182;73445;1674805;430032
2021-07-19;SIC;48986;23602;25384;11653;36973;360;0;ITG;ITG1;19;Sicilia;38.11569725;13.3623567;154;22;176;5205;5381;258;300;224408;6007;235796;5100200;1931050
2021-07-19;MOL;2900;1423;1477;528;2339;33;0;ITF;ITF2;14;Molise;41.55774754;14.65916051;0;0;0;96;96;19;23;13211;492;13799;246091;212776
2021-07-19;PUG;49599;24374;25225;10928;37903;768;0;ITF;ITF4;16;Puglia;41.12559576;16.86736689;66;10;76;1700;1776;18;47;245808;6659;254243;2781728;1264060
2021-07-19;TOS;38043;18962;19081;8805;28946;292;0;ITI;ITI1;9;Toscana;43.76923077;11.25588885;74;16;90;2123;2213;157;191;237055;6899;246167;5336922;2438434
2021-07-19;VEN;44757;23574;21183;7963;36398;396;0;ITH;ITH3;5;Veneto;45.43490485;12.33845213;47;10;57;6981;7038;222;238;410121;11629;428788;9129676;1888252
2021-07-19;SAR;15230;7629;7601;2796;12383;51;0;ITG;ITG2;20;Sardegna;39.21531192;9.110616306;57;4;61;1825;1886;87;95;55190;1495;58571;1443515;844100
2021-07-19;CAM;44002;21547;22455;5135;38379;488;0;ITF;ITF3;15;Campania;40.83956555;14.25084984;181;10;191;7071;7262;61;151;412556;7563;427381;5506622;3312131
2021-07-19;LOM;96929;50320;46609;10804;85045;1080;0;ITC;ITC4;3;Lombardia;45.46679409;9.190347404;138;30;168;7413;7581;174;208;804715;33810;846106;12143485;4790165
2021-07-20;CAM;40106;19783;20323;6091;33336;679;0;ITF;ITF3;15;Campania;40.83956555;14.25084984;184;13;197;7162;7359;97;233;412689;7566;427614;5521116;3314377
2021-07-20;SAR;16152;7932;8220;3654;12407;91;0;ITG;ITG2;20;Sardegna;39.21531192;9.110616306;58;3;61;1955;2016;130;145;55205;1495;58716;1446627;846209
2021-07-20;SIC;48522;23636;24886;12794;35366;362;0;ITG;ITG1;19;Sicilia;38.11569725;13.3623567;156;21;177;5623;5800;419;552;224538;6010;236348;5118238;1937581
2021-07-20;UMB;8270;4108;4162;1096;7090;84;0;ITI;ITI2;10;Umbria;43.10675841;12.38824698;6;1;7;679;686;24;30;54969;1424;57079;1521125;398997
2021-07-20;FVG;9419;4937;4482;2450;6673;296;0;ITH;ITH4;6;Friuli-Venezia Giulia;45.6494354;13.76813649;9;0;9;240;249;0;0;103225;3789;107263;2244254;701734
2021-07-20;LOM;95033;49097;45936;6921;87374;738;0;ITC;ITC4;3;Lombardia;45.46679409;9.190347404;136;31;167;7195;7362;-219;407;805341;33810;846513;12175439;4798855
2021-07-20;EMR;43154;22558;20596;6652;35795;707;0;ITH;ITH5;8;Emilia-Romagna;44.49436681;11.3417208;137;15;152;2807;2959;103;185;372918;13269;389146;7039804;1936821
2021-07-20;PIE;39123;20582;18541;5758;32792;573;0;ITC;ITC1;1;Piemonte;45.0732745;7.680687483;57;3;60;1034;1094;81;122;351116;11699;363909;5312022;2060046
2021-07-20;CAL;17499;8486;9013;3196;14227;76;0;ITF;ITF6;18;Calabria;38.90597598;16.59440194;47;4;51;2012;2063;12;33;66433;1238;69734;969346;886497
2021-07-20;LAZ;63480;31677;31803;28429;33788;1263;0;ITI;ITI4;12;Lazio;41.89277044;12.48366722;133;28;161;3941;4102;468;681;338039;8388;350529;8081723;4512733
2021-07-20;VEN;44387;23694;20693;6879;37000;508;0;ITH;ITH3;5;Veneto;45.43490485;12.33845213;51;13;64;7426;7490;452;600;410269;11629;429388;9163772;1892299
2021-07-20;PAT;4838;2613;2225;1742;2937;159;0;ITH;ITH2;4;Provincia Autonoma Trento;46.06893511;11.12123097;1;1;2;145;147;19;24;44448;1363;45958;892624;242549
2021-07-20;TOS;37346;19111;18235;7965;29188;193;0;ITI;ITI1;9;Toscana;43.76923077;11.25588885;70;15;85;2250;2335;122;169;237102;6899;246336;5348309;2443355
2021-07-20;LIG;13988;6889;7099;2696;11209;83;0;ITC;ITC3;7;Liguria;44.41149315;8.9326992;13;6;19;390;409;34;76;99230;4357;103996;1852453;715596
2021-07-20;MAR;14396;7435;6961;1767;12454;175;0;ITI;ITI3;11;Marche;43.61675973;13.5188753;12;2;14;1494;1508;7;54;99845;3038;104391;1341319;783353
2021-07-20;ABR;12590;6390;6200;3223;9178;189;0;ITF;ITF1;13;Abruzzo;42.35122196;13.39843823;22;1;23;967;990;0;15;71904;2513;75407;1779008;713971
2021-07-20;MOL;2200;1111;1089;1030;1120;50;0;ITF;ITF2;14;Molise;41.55774754;14.65916051;0;0;0;104;104;8;9;13212;492;13808;246495;213180
2021-07-20;BAS;5693;2792;2901;1688;3965;40;0;ITF;ITF5;17;Basilicata;40.63947052;15.80514834;16;0;16;507;523;-27;27;26004;591;27118;403726;214790
2021-07-20;PUG;47085;23098;23987;8191;38386;508;0;ITF;ITF4;16;Puglia;41.12559576;16.86736689;76;9;85;1690;1775;-1;80;245889;6659;254323;2789492;1266449
2021-07-20;PAB;3136;1731;1405;1349;1525;262;0;ITH;ITH1;4;Provincia Autonoma Bolzano / Bozen;46.49933453;11.35662422;5;0;5;135;140;-13;10;72133;1182;73455;1677449;430174
2021-07-20;VDA;1121;585;536;385;724;12;0;ITC;ITC2;2;Valle d'Aosta / Vallée d'Aoste;45.73750286;7.320149366;0;0;0;26;26;2;2;11213;473;11712;146057;69226
2021-07-21;PUG;45112;22238;22874;11847;32416;849;0;ITF;ITF4;16;Puglia;41.12559576;16.86736689;74;8;82;1742;1824;49;139;245974;6664;254462;2796793;1268487
2021-07-21;ABR;11079;5719;5360;2426;8518;135;0;ITF;ITF1;13;Abruzzo;42.35122196;13.39843823;20;1;21;992;1013;23;45;71925;2513;75451;1783623;715385
2021-07-21;PAB;3221;1883;1338;509;2645;67;0;ITH;ITH1;4;Provincia Autonoma Bolzano / Bozen;46.49933453;11.35662422;6;0;6;153;159;19;34;72148;1182;73489;1681723;430431
2021-07-21;MOL;4261;2144;2117;1621;2543;97;0;ITF;ITF2;14;Molise;41.55774754;14.65916051;1;0;1;107;108;4;13;13221;492;13821;246979;213660
2021-07-21;VDA;1169;639;530;302;850;17;0;ITC;ITC2;2;Valle d'Aosta / Vallée d'Aoste;45.73750286;7.320149366;0;0;0;26;26;0;0;11213;473;11712;146118;69268
2021-07-21;PAT;4719;2528;2191;1521;3092;106;0;ITH;ITH2;4;Provincia Autonoma Trento;46.06893511;11.12123097;2;0;2;144;146;-1;4;44453;1363;45962;893180;242772
2021-07-21;CAL;22127;10625;11502;4512;17496;119;0;ITF;ITF6;18;Calabria;38.90597598;16.59440194;46;5;51;2041;2092;29;71;66475;1238;69805;971420;888257
2021-07-21;CAM;50181;24429;25752;8334;40891;956;0;ITF;ITF3;15;Campania;40.83956555;14.25084984;175;13;188;7334;7522;163;292;412817;7567;427906;5536830;3317391
2021-07-21;FVG;8661;4390;4271;2046;6354;261;0;ITH;ITH4;6;Friuli-Venezia Giulia;45.6494354;13.76813649;8;0;8;285;293;44;92;103273;3789;107355;2256541;704049
2021-07-21;PIE;38083;20204;17879;6562;30989;532;0;ITC;ITC1;1;Piemonte;45.0732745;7.680687483;50;3;53;1127;1180;86;134;351164;11699;364043;5325088;2063316
2021-07-21;TOS;38520;19660;18860;7344;30937;239;0;ITI;ITI1;9;Toscana;43.76923077;11.25588885;78;13;91;2459;2550;215;306;237193;6899;246642;5359760;2448917
2021-07-21;BAS;5846;2943;2903;1612;4201;33;0;ITF;ITF5;17;Basilicata;40.63947052;15.80514834;19;0;19;512;531;8;29;26025;591;27147;404353;215044
2021-07-21;LIG;19221;9525;9696;3790;15335;96;0;ITC;ITC3;7;Liguria;44.41149315;8.9326992;15;6;21;496;517;108;110;99231;4358;104106;1858727;717439
2021-07-21;UMB;9857;4914;4943;1233;8537;87;0;ITI;ITI2;10;Umbria;43.10675841;12.38824698;7;1;8;745;753;67;67;54969;1424;57146;1525402;399530
2021-07-21;VEN;43285;22342;20943;8692;34093;500;0;ITH;ITH3;5;Veneto;45.43490485;12.33845213;47;12;59;7723;7782;292;457;410435;11628;429845;9201261;1893188
2021-07-21;SAR;19392;9500;9892;3907;15401;84;0;ITG;ITG2;20;Sardegna;39.21531192;9.110616306;47;4;51;2216;2267;251;274;55228;1495;58990;1457293;849163
2021-07-21;MAR;14920;7617;7303;2064;12643;213;0;ITI;ITI3;11;Marche;43.61675973;13.5188753;12;3;15;1520;1535;27;73;99890;3039;104464;1344325;784955
2021-07-21;SIC;42976;20973;22003;10638;32024;314;0;ITG;ITG1;19;Sicilia;38.11569725;13.3623567;165;20;185;6006;6191;391;550;224688;6019;236898;5132472;1943685
2021-07-21;LAZ;63848;32710;31138;29563;32881;1404;0;ITI;ITI4;12;Lazio;41.89277044;12.48366722;151;28;179;4385;4564;462;616;338193;8388;351145;8112047;4517005
2021-07-21;LOM;94019;48502;45517;8614;84538;867;0;ITC;ITC4;3;Lombardia;45.46679409;9.190347404;132;28;160;6726;6886;-476;564;806378;33813;847077;12212501;4808049
2021-07-21;EMR;43697;23308;20389;10752;32296;649;0;ITH;ITH5;8;Emilia-Romagna;44.49436681;11.3417208;141;13;154;3062;3216;257;324;372984;13270;389470;7058426;1938832
2021-07-22;CAL;18338;9028;9310;3491;14754;93;0;ITF;ITF6;18;Calabria;38.90597598;16.59440194;45;5;50;2004;2054;-38;58;66570;1239;69863;973418;889972
2021-07-22;LAZ;61214;30584;30630;28442;31210;1562;0;ITI;ITI4;12;Lazio;41.89277044;12.48366722;150;29;179;4902;5081;517;792;338467;8389;351937;8142346;4521277
2021-07-22;EMR;40395;21559;18836;15219;24220;956;0;ITH;ITH5;8;Emilia-Romagna;44.49436681;11.3417208;139;12;151;3360;3511;295;447;373133;13272;389916;7078772;1941177
2021-07-22;CAM;61859;30555;31304;6459;54800;600;0;ITF;ITF3;15;Campania;40.83956555;14.25084984;184;12;196;7517;7713;191;352;412974;7571;428258;5551620;3320122
2021-07-22;UMB;10077;4925;5152;1653;8318;106;0;ITI;ITI2;10;Umbria;43.10675841;12.38824698;8;1;9;711;720;-33;10;55012;1424;57156;1526371;399720
2021-07-22;FVG;7730;4111;3619;3277;4150;303;0;ITH;ITH4;6;Friuli-Venezia Giulia;45.6494354;13.76813649;8;0;8;316;324;31;56;103298;3789;107411;2261474;705046
2021-07-22;PIE;41683;21941;19742;7025;34054;604;0;ITC;ITC1;1;Piemonte;45.0732745;7.680687483;52;3;55;1248;1303;123;155;351196;11699;364198;5340736;2067192
2021-07-22;PAT;4786;2590;2196;1896;2741;149;0;ITH;ITH2;4;Provincia Autonoma Trento;46.06893511;11.12123097;2;0;2;158;160;14;31;44470;1363;45993;895006;243502
2021-07-22;MAR;15746;8048;7698;2017;13487;242;0;ITI;ITI3;11;Marche;43.61675973;13.5188753;16;3;19;1550;1569;34;99;99955;3039;104563;1346574;786131
2021-07-22;VEN;48418;25134;23284;13312;34449;657;0;ITH;ITH3;5;Veneto;45.43490485;12.33845213;62;10;72;8390;8462;680;819;410573;11629;430664;9239847;1902729
2021-07-22;TOS;39412;19808;19604;4479;34761;172;0;ITI;ITI1;9;Toscana;43.76923077;11.25588885;77;13;90;2827;2917;367;505;237329;6901;247147;5372202;2455254
2021-07-22;SAR;18340;9270;9070;4509;13722;109;0;ITG;ITG2;20;Sardegna;39.21531192;9.110616306;60;4;64;2441;2505;238;246;55235;1496;59236;1461067;852034
2021-07-22;SIC;40686;19974;20712;11231;29157;298;0;ITG;ITG1;19;Sicilia;38.11569725;13.3623567;158;22;180;6423;6603;412;520;224794;6021;237418;5145624;1949333
2021-07-22;LIG;21468;10907;10561;4533;16805;130;0;ITC;ITC3;7;Liguria;44.41149315;8.9326992;14;6;20;583;603;86;134;99279;4358;104240;1864521;719314
2021-07-22;LOM;99414;52043;47371;12510;85450;1454;0;ITC;ITC4;3;Lombardia;45.46679409;9.190347404;135;28;163;7070;7233;347;513;806543;33814;847590;12246048;4816469
2021-07-22;MOL;2287;1137;1150;850;1375;62;0;ITF;ITF2;14;Molise;41.55774754;14.65916051;1;0;1;102;103;-5;2;13228;492;13823;247088;213769
2021-07-22;PUG;47695;23650;24045;8457;38548;690;0;ITF;ITF4;16;Puglia;41.12559576;16.86736689;77;9;86;1845;1931;107;154;246021;6664;254616;2804129;1269906
2021-07-22;PAB;3738;1942;1796;1693;1790;255;0;ITH;ITH1;4;Provincia Autonoma Bolzano / Bozen;46.49933453;11.35662422;7;0;7;177;184;25;15;72138;1182;73504;1683571;430582
2021-07-22;ABR;14490;7412;7078;3515;10766;209;0;ITF;ITF1;13;Abruzzo;42.35122196;13.39843823;18;1;19;1004;1023;10;65;71975;2513;75511;1788671;716705
2021-07-22;VDA;983;519;464;261;705;17;0;ITC;ITC2;2;Valle d'Aosta / Vallée d'Aoste;45.73750286;7.320149366;0;0;0;28;28;2;3;11214;473;11715;146592;69502
2021-07-22;BAS;5798;2889;2909;1786;3950;62;0;ITF;ITF5;17;Basilicata;40.63947052;15.80514834;19;0;19;531;550;19;22;26028;591;27169;405069;215339
2021-07-23;MOL;2942;1531;1411;877;2004;61;0;ITF;ITF2;14;Molise;41.55774754;14.65916051;1;0;1;102;103;0;0;13228;492;13823;247386;214067
2021-07-23;LIG;20030;10318;9712;5102;14787;141;0;ITC;ITC3;7;Liguria;44.41149315;8.9326992;19;5;24;690;714;111;117;99285;4358;104357;1870141;721042
2021-07-23;PUG;43432;21976;21456;13649;28806;977;0;ITF;ITF4;16;Puglia;41.12559576;16.86736689;80;9;89;1887;1976;45;131;246107;6664;254747;2815016;1272564
2021-07-23;PAB;4360;2378;1982;1668;2391;301;0;ITH;ITH1;4;Provincia Autonoma Bolzano / Bozen;46.49933453;11.35662422;9;0;9;165;174;-10;2;72150;1182;73506;1684530;430658
2021-07-23;MAR;15542;8279;7263;2527;12790;225;0;ITI;ITI3;11;Marche;43.61675973;13.5188753;14;3;17;1598;1615;46;106;100015;3039;104669;1349381;787563
2021-07-23;BAS;5551;2781;2770;1889;3616;46;0;ITF;ITF5;17;Basilicata;40.63947052;15.80514834;22;0;22;539;561;11;18;26035;591;27187;405725;215650
2021-07-23;VDA;975;485;490;355;609;11;0;ITC;ITC2;2;Valle d'Aosta / Vallée d'Aoste;45.73750286;7.320149366;0;0;0;26;26;-2;1;11217;473;11716;146988;69652
2021-07-23;ABR;12572;6464;6108;2845;9566;161;0;ITF;ITF1;13;Abruzzo;42.35122196;13.39843823;18;1;19;1045;1064;41;61;71995;2513;75572;1793698;718076
2021-07-23;LOM;95541;50074;45467;11432;82852;1257;0;ITC;ITC4;3;Lombardia;45.46679409;9.190347404;142;27;169;7560;7729;496;691;806737;33815;848281;12282211;4825939
2021-07-23;SAR;15761;7788;7973;3405;12278;78;0;ITG;ITG2;20;Sardegna;39.21531192;9.110616306;51;6;57;2682;2739;234;261;55262;1496;59497;1467957;854748
2021-07-23;CAM;61841;30811;31030;8323;52874;644;0;ITF;ITF3;15;Campania;40.83956555;14.25084984;189;11;200;7644;7844;131;261;413097;7578;428519;5564876;3322060
2021-07-23;VEN;44510;23465;21045;15138;28794;578;0;ITH;ITH3;5;Veneto;45.43490485;12.33845213;60;12;72;8886;8958;496;669;410746;11629;431333;9278475;1907928
2021-07-23;CAL;22756;11353;11403;5557;17094;105;0;ITF;ITF6;18;Calabria;38.90597598;16.59440194;48;5;53;2038;2091;37;107;66635;1244;69970;975490;891731
2021-07-23;TOS;38469;19309;19160;4387;33925;157;0;ITI;ITI1;9;Toscana;43.76923077;11.25588885;86;12;98;3274;3372;455;470;237344;6901;247617;5384899;2461334
2021-07-23;FVG;9071;4652;4419;3042;5601;428;0;ITH;ITH4;6;Friuli-Venezia Giulia;45.6494354;13.76813649;9;0;9;355;364;40;56;103314;3789;107467;2267156;706200
2021-07-23;PIE;38191;20134;18057;8044;29508;639;0;ITC;ITC1;1;Piemonte;45.0732745;7.680687483;47;3;50;1364;1414;111;140;351225;11699;364338;5359615;2071439
2021-07-23;EMR;40437;21908;18529;19776;19495;1166;0;ITH;ITH5;8;Emilia-Romagna;44.49436681;11.3417208;144;9;153;3753;3906;395;474;373211;13272;390389;7100283;1943318
2021-07-23;PAT;4777;2448;2329;1658;2961;158;0;ITH;ITH2;4;Provincia Autonoma Trento;46.06893511;11.12123097;3;0;3;194;197;37;43;44476;1363;46036;896704;244181
2021-07-23;UMB;10674;5455;5219;1336;9232;106;0;ITI;ITI2;10;Umbria;43.10675841;12.38824698;9;1;10;754;764;44;76;55044;1424;57232;1531792;400490
2021-07-23;SIC;41522;20857;20665;14373;26824;325;0;ITG;ITG1;19;Sicilia;38.11569725;13.3623567;172;21;193;6710;6903;300;484;224976;6023;237902;5161037;1954023
2021-07-23;LAZ;58546;29368;29178;26778;29967;1801;0;ITI;ITI4;12;Lazio;41.89277044;12.48366722;183;30;213;5614;5827;746;854;338574;8390;352791;8172799;4525918
2021-07-24;VDA;1020;536;484;324;682;14;0;ITC;ITC2;2;Valle d'Aosta / Vallée d'Aoste;45.73750286;7.320149366;0;0;0;28;28;2;4;11219;473;11720;147327;69802
2021-07-24;BAS;5749;2945;2804;1776;3923;50;0;ITF;ITF5;17;Basilicata;40.63947052;15.80514834;16;0;16;553;569;8;27;26054;591;27214;406602;216001
2021-07-24;SAR;12384;6384;6000;1991;10363;30;0;ITG;ITG2;20;Sardegna;39.21531192;9.110616306;52;9;61;2947;3008;269;285;55278;1496;59782;1472220;858112
2021-07-24;CAM;47999;24873;23126;6603;40890;506;0;ITF;ITF3;15;Campania;40.83956555;14.25084984;176;12;188;7879;8067;223;341;413214;7579;428860;5580523;3325064
2021-07-24;LOM;95880;50656;45224;9738;85282;860;0;ITC;ITC4;3;Lombardia;45.46679409;9.190347404;153;26;179;7958;8137;408;574;806903;33815;848855;12322417;4837309
2021-07-24;CAL;18182;9345;8837;4680;13401;101;0;ITF;ITF6;18;Calabria;38.90597598;16.59440194;52;4;56;2127;2183;92;136;66679;1244;70106;977741;893667
2021-07-24;EMR;38886;20971;17915;17194;20650;1042;0;ITH;ITH5;8;Emilia-Romagna;44.49436681;11.3417208;150;9;159;4150;4309;403;468;373276;13272;390857;7124589;1945440
2021-07-24;UMB;8699;4368;4331;1346;7285;68;0;ITI;ITI2;10;Umbria;43.10675841;12.38824698;9;1;10;778;788;24;77;55097;1424;57309;1535907;401201
2021-07-24;SIC;40738;21216;19522;16788;23634;316;0;ITG;ITG1;19;Sicilia;38.11569725;13.3623567;182;27;209;7263;7472;569;626;225032;6024;238528;5174772;1959486
2021-07-24;LAZ;30792;15534;15258;3208;27423;161;0;ITI;ITI4;12;Lazio;41.89277044;12.48366722;196;32;228;6178;6406;579;845;338840;8390;353636;8205726;4530827
2021-07-24;PAT;996;548;448;516;445;35;0;ITH;ITH2;4;Provincia Autonoma Trento;46.06893511;11.12123097;4;0;4;233;237;40;44;44480;1363;46080;898361;244844
2021-07-24;FVG;6176;3338;2838;2918;3082;176;0;ITH;ITH4;6;Friuli-Venezia Giulia;45.6494354;13.76813649;7;2;9;396;405;41;68;103339;3789;107533;2273538;707916
2021-07-24;PIE;34936;18378;16558;7923;26402;611;0;ITC;ITC1;1;Piemonte;45.0732745;7.680687483;54;3;57;1464;1521;107;161;351279;11699;364499;5383813;2076887
2021-07-24;PUG;26793;13904;12889;7999;18322;472;0;ITF;ITF4;16;Puglia;41.12559576;16.86736689;81;9;90;1983;2073;97;138;246148;6664;254885;2828159;1275050
2021-07-24;ABR;12634;6842;5792;3805;8591;238;0;ITF;ITF1;13;Abruzzo;42.35122196;13.39843823;19;1;20;1072;1092;28;62;72028;2514;75634;1798996;719630
2021-07-24;PAB;4834;2849;1985;1353;3333;148;0;ITH;ITH1;4;Provincia Autonoma Bolzano / Bozen;46.49933453;11.35662422;7;0;7;191;198;24;39;72165;1182;73545;1688318;430906
2021-07-24;MAR;13278;7119;6159;2942;10077;259;0;ITI;ITI3;11;Marche;43.61675973;13.5188753;15;3;18;1628;1646;31;105;100089;3039;104774;1352059;789059
2021-07-24;LIG;11614;6042;5572;2298;9251;65;0;ITC;ITC3;7;Liguria;44.41149315;8.9326992;21;5;26;797;823;109;140;99315;4359;104497;1877811;723850
2021-07-24;VEN;41724;22371;19353;13305;27776;643;0;ITH;ITH3;5;Veneto;45.43490485;12.33845213;60;14;74;9291;9365;407;576;410913;11631;431909;9317881;1911752
2021-07-24;TOS;38468;19382;19086;6852;31382;234;0;ITI;ITI1;9;Toscana;43.76923077;11.25588885;85;14;99;3574;3673;301;441;237484;6901;248058;5398853;2467138
2021-07-24;MOL;3161;1699;1462;740;2391;30;0;ITF;ITF2;14;Molise;41.55774754;14.65916051;1;0;1;108;109;6;15;13237;492;13838;248053;214729
2021-07-25;SAR;4343;2142;2201;862;3466;15;0;ITG;ITG2;20;Sardegna;39.21531192;9.110616306;53;10;63;3255;3318;310;324;55291;1497;60106;1474839;860308
2021-07-25;LIG;6425;3280;3145;654;5760;11;0;ITC;ITC3;7;Liguria;44.41149315;8.9326992;31;6;37;840;877;54;91;99352;4359;104588;1882128;725666
2021-07-25;TOS;33932;16779;17153;7054;26697;181;0;ITI;ITI1;9;Toscana;43.76923077;11.25588885;96;16;112;4015;4127;454;513;237541;6903;248571;5410935;2472798
2021-07-25;LOM;86643;45740;40903;9424;76438;781;0;ITC;ITC4;3;Lombardia;45.46679409;9.190347404;150;27;177;8357;8534;397;461;806966;33816;849316;12350509;4846257
2021-07-25;PIE;28810;15277;13533;6610;21702;498;0;ITC;ITC1;1;Piemonte;45.0732745;7.680687483;58;3;61;1520;1581;60;97;351316;11699;364596;5394843;2080487
2021-07-25;VEN;33207;17548;15659;10853;21888;466;0;ITH;ITH3;5;Veneto;45.43490485;12.33845213;61;15;76;9651;9727;362;507;411058;11631;432416;9343728;1915777
2021-07-25;MAR;9351;4933;4418;1004;8249;98;0;ITI;ITI3;11;Marche;43.61675973;13.5188753;15;3;18;1671;1689;43;88;100134;3039;104862;1354528;790544
2021-07-25;MOL;2025;1068;957;357;1652;16;0;ITF;ITF2;14;Molise;41.55774754;14.65916051;1;0;1;103;104;-5;3;13245;492;13841;248330;215006
2021-07-25;EMR;28481;15186;13295;10541;17446;494;0;ITH;ITH5;8;Emilia-Romagna;44.49436681;11.3417208;150;9;159;4674;4833;524;565;373316;13273;391422;7139648;1946464
2021-07-25;PUG;14329;7410;6919;4273;9850;206;0;ITF;ITF4;16;Puglia;41.12559576;16.86736689;78;9;87;2126;2213;140;164;246172;6664;255049;2834769;1276805
2021-07-25;PAB;1893;1127;766;660;1146;87;0;ITH;ITH1;4;Provincia Autonoma Bolzano / Bozen;46.49933453;11.35662422;5;0;5;210;215;17;27;72174;1183;73572;1691294;431110
2021-07-25;ABR;9863;5217;4646;2169;7571;123;0;ITF;ITF1;13;Abruzzo;42.35122196;13.39843823;22;1;23;1095;1118;26;53;72055;2514;75687;1805596;721758
2021-07-25;BAS;4478;2254;2224;1606;2848;24;0;ITF;ITF5;17;Basilicata;40.63947052;15.80514834;13;0;13;550;563;-6;9;26069;591;27223;407070;216176
2021-07-25;CAL;6951;3571;3380;1467;5452;32;0;ITF;ITF6;18;Calabria;38.90597598;16.59440194;50;4;54;2216;2270;87;93;66685;1244;70199;979446;895403
2021-07-25;CAM;23227;11805;11422;4212;18740;275;0;ITF;ITF3;15;Campania;40.83956555;14.25084984;180;11;191;8050;8241;174;301;413341;7579;429161;5592962;3328028
2021-07-25;LAZ;24686;12155;12531;2090;22546;50;0;ITI;ITI4;12;Lazio;41.89277044;12.48366722;211;32;243;6616;6859;453;660;339045;8392;354296;8231172;4535085
2021-07-25;VDA;1021;494;527;262;749;10;0;ITC;ITC2;2;Valle d'Aosta / Vallée d'Aoste;45.73750286;7.320149366;0;0;0;40;40;12;12;11219;473;11732;147675;69987
2021-07-25;SIC;31813;16767;15046;11845;19708;260;0;ITG;ITG1;19;Sicilia;38.11569725;13.3623567;192;29;221;7700;7921;449;568;225151;6024;239096;5182797;1963393
2021-07-25;UMB;7310;3852;3458;1167;6099;44;0;ITI;ITI2;10;Umbria;43.10675841;12.38824698;11;1;12;820;832;44;61;55114;1424;57370;1540227;401836
2021-07-25;PAT;366;205;161;139;218;9;0;ITH;ITH2;4;Provincia Autonoma Trento;46.06893511;11.12123097;3;0;3;283;286;49;54;44485;1363;46134;900435;245674
2021-07-25;FVG;3906;2029;1877;1918;1881;107;0;ITH;ITH4;6;Friuli-Venezia Giulia;45.6494354;13.76813649;9;2;11;417;428;23;41;103356;3789;107573;2277450;709319
2021-07-26;BAS;5422;2723;2699;1996;3388;38;0;ITF;ITF5;17;Basilicata;40.63947052;15.80514834;15;0;15;536;551;-12;1;26082;591;27224;407114;216205
2021-07-26;VDA;1009;513;496;311;684;14;0;ITC;ITC2;2;Valle d'Aosta / Vallée d'Aoste;45.73750286;7.320149366;0;0;0;45;45;5;6;11220;473;11738;148033;70195
2021-07-26;ABR;14260;7459;6801;3864;10197;199;0;ITF;ITF1;13;Abruzzo;42.35122196;13.39843823;24;0;24;1178;1202;84;85;72056;2514;75772;1811755;723832
2021-07-26;UMB;9092;4804;4288;3874;5091;127;0;ITI;ITI2;10;Umbria;43.10675841;12.38824698;13;1;14;929;943;111;129;55132;1424;57499;1545100;402524
2021-07-26;SIC;44562;22211;22351;16706;27485;371;0;ITG;ITG1;19;Sicilia;38.11569725;13.3623567;216;28;244;8123;8367;446;457;225162;6024;239553;5189192;1966299
2021-07-26;SAR;14609;7291;7318;4120;10411;78;0;ITG;ITG2;20;Sardegna;39.21531192;9.110616306;64;10;74;3416;3490;172;209;55328;1497;60315;1477026;861809
2021-07-26;LAZ;50936;25096;25840;6620;43987;329;0;ITI;ITI4;12;Lazio;41.89277044;12.48366722;240;34;274;7005;7279;420;550;339173;8394;354846;8244165;4538477
2021-07-26;FVG;8568;4271;4297;1778;6576;214;0;ITH;ITH4;6;Friuli-Venezia Giulia;45.6494354;13.76813649;8;2;10;430;440;12;20;103363;3789;107592;2279027;709731
2021-07-26;PIE;32849;17090;15759;8313;23899;637;0;ITC;ITC1;1;Piemonte;45.0732745;7.680687483;68;3;71;1539;1610;29;59;351346;11699;364655;5405570;2082412
2021-07-26;PAT;3903;2058;1845;833;2996;74;0;ITH;ITH2;4;Provincia Autonoma Trento;46.06893511;11.12123097;6;0;6;304;310;24;39;44500;1363;46173;902626;246550
2021-07-26;TOS;38310;19870;18440;10085;27914;311;0;ITI;ITI1;9;Toscana;43.76923077;11.25588885;103;16;119;4288;4407;280;361;237621;6904;248932;5416160;2475445
2021-07-26;PUG;48056;23984;24072;17102;30032;922;0;ITF;ITF4;16;Puglia;41.12559576;16.86736689;75;8;83;1788;1871;-342;56;246567;6667;255105;2838958;1278376
2021-07-26;PAB;1629;940;689;1109;411;109;0;ITH;ITH1;4;Provincia Autonoma Bolzano / Bozen;46.49933453;11.35662422;4;0;4;238;242;27;12;72159;1183;73584;1693842;431285
2021-07-26;VEN;43656;22949;20707;17002;26019;635;0;ITH;ITH3;5;Veneto;45.43490485;12.33845213;64;16;80;10001;10081;354;407;411110;11632;432823;9357518;1918200
2021-07-26;EMR;39578;21106;18472;15864;22888;826;0;ITH;ITH5;8;Emilia-Romagna;44.49436681;11.3417208;161;8;169;5068;5237;404;469;373377;13277;391891;7151111;1948476
2021-07-26;MOL;2461;1268;1193;1267;1125;69;0;ITF;ITF2;14;Molise;41.55774754;14.65916051;1;0;1;116;117;13;17;13249;492;13858;248751;215427
2021-07-26;CAM;48869;24321;24548;10198;37946;725;0;ITF;ITF3;15;Campania;40.83956555;14.25084984;188;12;200;8038;8238;-3;115;413458;7580;429276;5596479;3328841
2021-07-26;LOM;109619;58922;50697;7711;101152;756;0;ITC;ITC4;3;Lombardia;45.46679409;9.190347404;151;28;179;8504;8683;149;177;806993;33817;849493;12359115;4848715
2021-07-26;CAL;18796;9338;9458;5209;13492;95;0;ITF;ITF6;18;Calabria;38.90597598;16.59440194;51;5;56;2271;2327;57;88;66707;1253;70287;980415;895797
2021-07-26;LIG;17692;9027;8665;4686;12868;138;0;ITC;ITC3;7;Liguria;44.41149315;8.9326992;38;6;44;869;913;36;63;99379;4359;104651;1884399;726434
2021-07-26;MAR;11031;5737;5294;2109;8715;207;0;ITI;ITI3;11;Marche;43.61675973;13.5188753;15;4;19;1672;1691;2;54;100186;3039;104916;1355391;790964
2021-07-27;CAL;17590;8993;8597;5019;12482;89;0;ITF;ITF6;18;Calabria;38.90597598;16.59440194;54;5;59;2365;2424;97;110;66719;1254;70397;983036;897737
2021-07-27;LAZ;56539;27470;29069;8117;48081;341;0;ITI;ITI4;12;Lazio;41.89277044;12.48366722;254;35;289;7230;7519;240;543;339476;8394;355389;8279559;4543330
2021-07-27;UMB;8148;4093;4055;2695;5337;116;0;ITI;ITI2;10;Umbria;43.10675841;12.38824698;9;2;11;1006;1017;74;95;55153;1424;57594;1549209;403091
2021-07-27;PAT;4834;2555;2279;1760;2951;123;0;ITH;ITH2;4;Provincia Autonoma Trento;46.06893511;11.12123097;5;0;5;316;321;11;27;44516;1363;46200;904378;247251
2021-07-27;VEN;42281;22194;20087;11798;30046;437;0;ITH;ITH3;5;Veneto;45.43490485;12.33845213;91;16;107;10358;10465;384;804;411528;11634;433627;9389260;1921972
2021-07-27;CAM;49168;24450;24718;12577;35733;858;0;ITF;ITF3;15;Campania;40.83956555;14.25084984;188;10;198;8068;8266;28;236;413661;7585;429512;5611765;3331965
2021-07-27;LOM;104947;56848;48099;7481;96762;704;0;ITC;ITC4;3;Lombardia;45.46679409;9.190347404;180;29;209;8832;9041;358;641;807275;33818;850134;12394889;4857600
2021-07-27;SIC;43344;21482;21862;19270;23610;464;0;ITG;ITG1;19;Sicilia;38.11569725;13.3623567;234;30;264;8244;8508;141;436;225451;6030;239989;5200567;1971953
2021-07-27;FVG;9542;4803;4739;2652;6664;226;0;ITH;ITH4;6;Friuli-Venezia Giulia;45.6494354;13.76813649;10;2;12;492;504;64;89;103387;3789;107680;2285569;710952
2021-07-27;EMR;41141;21855;19286;16980;23336;825;0;ITH;ITH5;8;Emilia-Romagna;44.49436681;11.3417208;162;9;171;5125;5296;59;299;373611;13279;392186;7175763;1950462
2021-07-27;TOS;38741;20143;18598;11266;27123;352;0;ITI;ITI1;9;Toscana;43.76923077;11.25588885;109;19;128;4467;4595;188;271;237700;6908;249203;5428729;2481372
2021-07-27;SAR;16535;8385;8150;4216;12208;111;0;ITG;ITG2;20;Sardegna;39.21531192;9.110616306;70;9;79;3638;3717;227;282;55382;1498;60597;1487183;864776
2021-07-27;PIE;33838;17669;16169;8265;25003;570;0;ITC;ITC1;1;Piemonte;45.0732745;7.680687483;67;3;70;1663;1733;123;224;351447;11699;364879;5421753;2086885
2021-07-27;MOL;1968;1088;880;1341;555;72;0;ITF;ITF2;14;Molise;41.55774754;14.65916051;1;0;1;112;113;-4;4;13257;492;13862;249087;215757
2021-07-27;MAR;14370;7537;6833;3031;11112;227;0;ITI;ITI3;11;Marche;43.61675973;13.5188753;12;4;16;1638;1654;-37;67;100290;3039;104983;1358417;792612
2021-07-27;ABR;15139;7906;7233;3332;11628;179;0;ITF;ITF1;13;Abruzzo;42.35122196;13.39843823;25;0;25;1155;1180;-22;6;72083;2514;75777;1813006;724215
2021-07-27;LIG;17452;8892;8560;4317;13013;122;0;ITC;ITC3;7;Liguria;44.41149315;8.9326992;35;6;41;917;958;45;139;99472;4360;104790;1891760;728683
2021-07-27;BAS;4713;2371;2342;1812;2855;46;0;ITF;ITF5;17;Basilicata;40.63947052;15.80514834;13;0;13;552;565;14;29;26097;591;27253;408008;216561
2021-07-27;PUG;48716;24243;24473;13325;34584;807;0;ITF;ITF4;16;Puglia;41.12559576;16.86736689;78;10;88;1736;1824;-47;132;246745;6668;255237;2850144;1280678
2021-07-27;PAB;3159;1886;1273;882;2182;95;0;ITH;ITH1;4;Provincia Autonoma Bolzano / Bozen;46.49933453;11.35662422;2;0;2;259;261;19;30;72170;1183;73614;1696849;431492
2021-07-27;VDA;1133;605;528;565;552;16;0;ITC;ITC2;2;Valle d'Aosta / Vallée d'Aoste;45.73750286;7.320149366;1;0;1;45;46;1;5;11224;473;11743;148454;70408
2021-07-28;MAR;14198;7369;6829;3249;10717;232;0;ITI;ITI3;11;Marche;43.61675973;13.5188753;17;4;21;1747;1768;114;162;100338;3039;105145;1361436;794228
2021-07-28;PUG;45425;22976;22449;14703;29831;891;0;ITF;ITF4;16;Puglia;41.12559576;16.86736689;75;9;84;1833;1917;93;163;246814;6669;255400;2862638;1283577
2021-07-28;MOL;2463;1308;1155;1153;1275;35;0;ITF;ITF2;14;Molise;41.55774754;14.65916051;1;0;1;122;123;10;17;13264;492;13879;249857;216513
2021-07-28;PAB;1441;787;654;841;498;102;0;ITH;ITH1;4;Provincia Autonoma Bolzano / Bozen;46.49933453;11.35662422;2;0;2;261;263;2;12;72180;1183;73626;1700541;431709
2021-07-28;ABR;13280;6956;6324;3435;9677;168;0;ITF;ITF1;13;Abruzzo;42.35122196;13.39843823;24;0;24;1176;1200;20;29;72091;2514;75805;1817383;725597
2021-07-28;VDA;1428;765;663;351;1050;27;0;ITC;ITC2;2;Valle d'Aosta / Vallée d'Aoste;45.73750286;7.320149366;1;0;1;45;46;0;0;11224;473;11743;148528;70459
2021-07-28;FVG;10513;5361;5152;4017;6045;451;0;ITH;ITH4;6;Friuli-Venezia Giulia;45.6494354;13.76813649;10;1;11;521;532;28;75;103433;3790;107755;2291751;712071
2021-07-28;BAS;5039;2577;2462;1929;3050;60;0;ITF;ITF5;17;Basilicata;40.63947052;15.80514834;12;0;12;560;572;7;15;26105;591;27268;408422;216717
2021-07-28;VEN;40317;20932;19385;12062;27803;452;0;ITH;ITH3;5;Veneto;45.43490485;12.33845213;99;16;115;10585;10700;235;544;411837;11634;434171;9428966;1925655
2021-07-28;CAL;21385;10737;10648;5893;15377;115;0;ITF;ITF6;18;Calabria;38.90597598;16.59440194;59;4;63;2428;2491;67;145;66797;1254;70542;985615;899945
2021-07-28;TOS;38585;20173;18412;12107;26137;341;0;ITI;ITI1;9;Toscana;43.76923077;11.25588885;105;16;121;4997;5118;523;661;237836;6910;249864;5442970;2488675
2021-07-28;PIE;34863;18116;16747;9184;25062;617;0;ITC;ITC1;1;Piemonte;45.0732745;7.680687483;68;3;71;1746;1817;84;150;351513;11699;365029;5434992;2090303
2021-07-28;PAT;4878;2673;2205;2159;2574;145;0;ITH;ITH2;4;Provincia Autonoma Trento;46.06893511;11.12123097;7;0;7;319;326;5;17;44528;1363;46217;904844;247437
2021-07-28;UMB;8246;4339;3907;2976;5157;113;0;ITI;ITI2;10;Umbria;43.10675841;12.38824698;11;2;13;1099;1112;95;101;55159;1424;57695;1554246;403814
2021-07-28;SIC;37672;18873;18799;14687;22661;324;0;ITG;ITG1;19;Sicilia;38.11569725;13.3623567;263;26;289;8654;8943;435;627;225637;6036;240616;5223333;1977824
2021-07-28;LIG;18500;9531;8969;5796;12561;143;0;ITC;ITC3;7;Liguria;44.41149315;8.9326992;37;6;43;1002;1045;87;144;99529;4360;104934;1897662;730390
2021-07-28;LAZ;58379;29829;28550;8629;49380;370;0;ITI;ITI4;12;Lazio;41.89277044;12.48366722;262;36;298;7913;8211;692;772;339554;8396;356161;8310682;4549482
2021-07-28;CAM;49459;24549;24910;13716;34781;962;0;ITF;ITF3;15;Campania;40.83956555;14.25084984;188;9;197;8195;8392;126;345;413880;7585;429857;5627567;3335269
2021-07-28;SAR;16793;8619;8174;6319;10326;148;0;ITG;ITG2;20;Sardegna;39.21531192;9.110616306;69;9;78;3968;4046;329;403;55456;1498;61000;1491953;868665
2021-07-28;LOM;77459;41729;35730;19115;56592;1752;0;ITC;ITC4;3;Lombardia;45.46679409;9.190347404;194;29;223;9294;9517;476;720;807518;33819;850854;12433178;4866877
2021-07-28;EMR;38709;20760;17949;13957;24058;694;0;ITH;ITH5;8;Emilia-Romagna;44.49436681;11.3417208;169;13;182;5440;5622;326;419;373699;13281;392602;7197252;1952472
2021-07-29;UMB;8205;4228;3977;2145;5941;119;0;ITI;ITI2;10;Umbria;43.10675841;12.38824698;11;2;13;1099;1112;0;7;55166;1424;57702;1555160;403934
2021-07-29;CAL;17592;8770;8822;4713;12777;102;0;ITF;ITF6;18;Calabria;38.90597598;16.59440194;57;4;61;2597;2658;167;183;66812;1255;70725;988267;902254
2021-07-29;EMR;40805;21536;19269;14489;25560;756;0;ITH;ITH5;8;Emilia-Romagna;44.49436681;11.3417208;183;13;196;5839;6035;413;493;373777;13281;393093;7218989;1955129
2021-07-29;PIE;36744;19096;17648;9389;26685;670;0;ITC;ITC1;1;Piemonte;45.0732745;7.680687483;76;4;80;1926;2006;189;282;351606;11699;365311;5450088;2094141
2021-07-29;LIG;18014;9221;8793;4387;13524;103;0;ITC;ITC3;7;Liguria;44.41149315;8.9326992;32;7;39;1061;1100;55;116;99589;4361;105050;1903717;732382
2021-07-29;CAM;48507;24348;24159;13400;34143;964;0;ITF;ITF3;15;Campania;40.83956555;14.25084984;183;11;194;8326;8520;128;380;414132;7585;430237;5642545;3339530
2021-07-29;SIC;36229;17900;18329;14338;21549;342;0;ITG;ITG1;19;Sicilia;38.11569725;13.3623567;267;29;296;9179;9475;532;719;225821;6039;241335;5237379;1983336
2021-07-29;LOM;74438;40435;34003;33778;38703;1957;0;ITC;ITC4;3;Lombardia;45.46679409;9.190347404;206;30;236;9661;9897;380;661;807796;33822;851515;12471780;4875487
2021-07-29;LAZ;56127;28599;27528;7658;48076;393;0;ITI;ITI4;12;Lazio;41.89277044;12.48366722;273;39;312;8582;8894;683;780;339650;8397;356941;8338857;4555201
2021-07-29;TOS;39424;20538;18886;12612;26462;350;0;ITI;ITI1;9;Toscana;43.76923077;11.25588885;112;13;125;5652;5777;659;748;237924;6911;250612;5456488;2495541
2021-07-29;SAR;17896;9042;8854;6524;11205;167;0;ITG;ITG2;20;Sardegna;39.21531192;9.110616306;61;11;72;4320;4392;346;413;55521;1500;61413;1495689;871789
2021-07-29;VEN;47559;25141;22418;20160;26545;854;0;ITH;ITH3;5;Veneto;45.43490485;12.33845213;104;16;120;11045;11165;465;737;412102;11641;434908;9459864;1930788
2021-07-29;FVG;9614;4904;4710;3230;6088;296;0;ITH;ITH4;6;Friuli-Venezia Giulia;45.6494354;13.76813649;10;2;12;578;590;58;96;103470;3790;107850;2297432;713203
2021-07-29;ABR;15181;7972;7209;3924;11045;212;0;ITF;ITF1;13;Abruzzo;42.35122196;13.39843823;26;0;26;1273;1299;99;141;72133;2514;75946;1823590;727135
2021-07-29;BAS;4856;2523;2333;1907;2902;47;0;ITF;ITF5;17;Basilicata;40.63947052;15.80514834;14;0;14;581;595;23;34;26116;591;27302;409064;216985
2021-07-29;MAR;14847;7881;6966;4580;9955;312;0;ITI;ITI3;11;Marche;43.61675973;13.5188753;21;4;25;1750;1775;7;101;100432;3039;105246;1364198;795752
2021-07-29;MOL;2477;1272;1205;1602;823;52;0;ITF;ITF2;14;Molise;41.55774754;14.65916051;1;0;1;122;123;0;0;13264;492;13879;249955;216611
2021-07-29;PUG;43117;21804;21313;12282;30041;794;0;ITF;ITF4;16;Puglia;41.12559576;16.86736689;75;9;84;1893;1977;60;151;246905;6669;255551;2874001;1286402
2021-07-29;VDA;999;509;490;318;667;14;0;ITC;ITC2;2;Valle d'Aosta / Vallée d'Aoste;45.73750286;7.320149366;1;0;1;50;51;5;5;11224;473;11748;148948;70635
2021-07-29;PAB;1343;720;623;697;570;76;0;ITH;ITH1;4;Provincia Autonoma Bolzano / Bozen;46.49933453;11.35662422;3;0;3;269;272;9;26;72197;1183;73652;1702935;431862
2021-07-29;PAT;5494;2922;2572;2641;2720;133;0;ITH;ITH2;4;Provincia Autonoma Trento;46.06893511;11.12123097;6;0;6;349;355;29;38;44537;1363;46255;906381;248052
2021-07-30;TOS;37921;20409;17512;10795;26767;359;0;ITI;ITI1;9;Toscana;43.76923077;11.25588885;127;14;141;6300;6441;664;720;237979;6912;251332;5469994;2502699
2021-07-30;PUG;36504;18753;17751;13169;22454;881;0;ITF;ITF4;16;Puglia;41.12559576;16.86736689;82;8;90;2069;2159;182;248;246971;6669;255799;2885860;1288882
2021-07-30;MAR;14714;7863;6851;4867;9559;288;0;ITI;ITI3;11;Marche;43.61675973;13.5188753;21;5;26;1835;1861;86;151;100497;3039;105397;1366796;797198
2021-07-30;LIG;16107;8344;7763;4638;11352;117;0;ITC;ITC3;7;Liguria;44.41149315;8.9326992;34;8;42;1117;1159;59;122;99651;4362;105172;1909999;734207
2021-07-30;PAB;5305;2845;2460;3325;1543;437;0;ITH;ITH1;4;Provincia Autonoma Bolzano / Bozen;46.49933453;11.35662422;10;0;10;254;264;-8;1;72206;1183;73653;1703563;431927
2021-07-30;VDA;966;501;465;417;525;24;0;ITC;ITC2;2;Valle d'Aosta / Vallée d'Aoste;45.73750286;7.320149366;1;0;1;50;51;0;3;11227;473;11751;149291;70779
2021-07-30;CAL;19736;10060;9676;5511;14097;128;0;ITF;ITF6;18;Calabria;38.90597598;16.59440194;62;6;68;2638;2706;48;108;66872;1255;70833;990585;904209
2021-07-30;MOL;2700;1399;1301;1443;1196;61;0;ITF;ITF2;14;Molise;41.55774754;14.65916051;1;0;1;120;121;-2;1;13267;492;13880;250198;216854
2021-07-30;CAM;44830;22824;22006;14302;29504;1024;0;ITF;ITF3;15;Campania;40.83956555;14.25084984;189;12;201;8243;8444;-76;355;414558;7590;430592;5656678;3342982
2021-07-30;UMB;6219;3243;2976;3185;2914;120;0;ITI;ITI2;10;Umbria;43.10675841;12.38824698;12;2;14;1207;1221;109;114;55171;1424;57816;1561742;404844
2021-07-30;PAT;5864;3103;2761;2289;3450;125;0;ITH;ITH2;4;Provincia Autonoma Trento;46.06893511;11.12123097;6;0;6;356;362;7;25;44555;1363;46280;907925;248670
2021-07-30;FVG;9087;4735;4352;2774;6051;262;0;ITH;ITH4;6;Friuli-Venezia Giulia;45.6494354;13.76813649;15;2;17;642;659;69;98;103498;3790;107947;2304447;714462
2021-07-30;EMR;39880;21421;18459;15670;23476;734;0;ITH;ITH5;8;Emilia-Romagna;44.49436681;11.3417208;197;14;211;6279;6490;455;544;373860;13282;393632;7243647;1957243
2021-07-30;PIE;35922;18758;17164;9557;25790;575;0;ITC;ITC1;1;Piemonte;45.0732745;7.680687483;72;5;77;2147;2224;218;287;351675;11699;365598;5471900;2098601
2021-07-30;VEN;45604;24257;21347;22627;22091;886;0;ITH;ITH3;5;Veneto;45.43490485;12.33845213;105;14;119;11808;11927;762;1046;412386;11641;435954;9502146;1933977
2021-07-30;ABR;12088;6436;5652;3791;8070;227;0;ITF;ITF1;13;Abruzzo;42.35122196;13.39843823;23;0;23;1296;1319;20;67;72179;2514;76012;1828453;728595
2021-07-30;BAS;4767;2437;2330;1915;2803;49;0;ITF;ITF5;17;Basilicata;40.63947052;15.80514834;15;0;15;611;626;31;37;26122;591;27339;410005;217380
2021-07-30;LAZ;56115;29096;27019;7445;48302;368;0;ITI;ITI4;12;Lazio;41.89277044;12.48366722;290;44;334;9190;9524;630;845;339861;8401;357786;8368920;4559506
2021-07-30;LOM;73319;39811;33508;35100;36099;2120;0;ITC;ITC4;3;Lombardia;45.46679409;9.190347404;211;26;237;9990;10227;330;678;808143;33823;852193;12508363;4884518
2021-07-30;SIC;32508;16115;16393;12076;20144;288;0;ITG;ITG1;19;Sicilia;38.11569725;13.3623567;268;30;298;9697;9995;520;724;226021;6043;242059;5250612;1988852
2021-07-30;SAR;15208;7859;7349;6624;8417;167;0;ITG;ITG2;20;Sardegna;39.21531192;9.110616306;70;11;81;4578;4659;267;308;55561;1501;61721;1499806;874989
2021-07-31;BAS;5470;2878;2592;1822;3591;57;0;ITF;ITF5;17;Basilicata;40.63947052;15.80514834;17;0;17;661;678;52;61;26131;591;27400;410921;217758
2021-07-31;VDA;893;466;427;318;556;19;0;ITC;ITC2;2;Valle d'Aosta / Vallée d'Aoste;45.73750286;7.320149366;1;0;1;54;55;4;4;11227;473;11755;149598;70910
2021-07-31;ABR;11742;6342;5400;3475;8063;204;0;ITF;ITF1;13;Abruzzo;42.35122196;13.39843823;22;0;22;1373;1395;76;112;72215;2514;76124;1833940;730189
2021-07-31;LAZ;56308;29606;26702;5516;50483;309;0;ITI;ITI4;12;Lazio;41.89277044;12.48366722;287;45;332;9743;10075;551;742;340049;8404;358528;8388310;4564368
2021-07-31;FVG;7377;3794;3583;1273;6014;90;0;ITH;ITH4;6;Friuli-Venezia Giulia;45.6494354;13.76813649;14;3;17;677;694;35;88;103551;3790;108035;2310819;716212
2021-07-31;EMR;36234;19244;16990;12127;23396;711;0;ITH;ITH5;8;Emilia-Romagna;44.49436681;11.3417208;208;15;223;6909;7132;642;700;373914;13282;394328;7271672;1959614
2021-07-31;PIE;35855;19056;16799;10748;24646;461;0;ITC;ITC1;1;Piemonte;45.0732745;7.680687483;69;6;75;2302;2377;153;229;351751;11699;365827;5496541;2104191
2021-07-31;CAM;30731;16216;14515;10432;19601;698;0;ITF;ITF3;15;Campania;40.83956555;14.25084984;196;12;208;8272;8480;36;471;414991;7592;431063;5673920;3345829
2021-07-31;VEN;35188;18906;16282;17035;17508;645;0;ITH;ITH3;5;Veneto;45.43490485;12.33845213;111;14;125;11988;12113;186;629;412828;11642;436583;9540978;1937677
2021-07-31;PUG;20054;10656;9398;7905;11667;482;0;ITF;ITF4;16;Puglia;41.12559576;16.86736689;81;8;89;2259;2348;189;232;247015;6668;256031;2897563;1291133
2021-07-31;SAR;10324;5458;4866;5277;4966;81;0;ITG;ITG2;20;Sardegna;39.21531192;9.110616306;75;13;88;4856;4944;285;330;55605;1502;62051;1510107;878261
2021-07-31;CAL;13810;7060;6750;3630;10100;80;0;ITF;ITF6;18;Calabria;38.90597598;16.59440194;64;6;70;2679;2749;43;122;66951;1255;70955;992479;905746
2021-07-31;UMB;4334;2262;2072;1478;2809;47;0;ITI;ITI2;10;Umbria;43.10675841;12.38824698;13;2;15;1327;1342;121;143;55193;1424;57959;1566536;405615
2021-07-31;SIC;28765;14941;13824;10447;18050;268;0;ITG;ITG1;19;Sicilia;38.11569725;13.3623567;275;31;306;10364;10670;675;901;226243;6047;242960;5271222;1994863
2021-07-31;PAT;1500;859;641;1076;383;41;0;ITH;ITH2;4;Provincia Autonoma Trento;46.06893511;11.12123097;6;0;6;352;358;-4;45;44604;1363;46325;909676;249370
2021-07-31;MAR;13203;7250;5953;5142;7731;330;0;ITI;ITI3;11;Marche;43.61675973;13.5188753;22;5;27;1952;1979;118;165;100544;3039;105562;1369777;798990
2021-07-31;PAB;3171;1721;1450;2068;926;177;0;ITH;ITH1;4;Provincia Autonoma Bolzano / Bozen;46.49933453;11.35662422;10;0;10;283;293;29;33;72210;1183;73686;1707532;432162
2021-07-31;LOM;71116;38778;32338;36366;32724;2026;0;ITC;ITC4;3;Lombardia;45.46679409;9.190347404;206;25;231;10631;10862;635;777;808281;33827;852970;12547763;4895422
2021-07-31;LIG;8273;4417;3856;1303;6935;35;0;ITC;ITC3;7;Liguria;44.41149315;8.9326992;33;9;42;1162;1204;45;156;99761;4363;105328;1917418;736484
2021-07-31;TOS;35864;19232;16632;12378;23025;461;0;ITI;ITI1;9;Toscana;43.76923077;11.25588885;137;17;154;6818;6972;531;641;238088;6913;251973;5485696;2509567
2021-07-31;MOL;2013;1123;890;765;1202;46;0;ITF;ITF2;14;Molise;41.55774754;14.65916051;1;0;1;108;109;-12;14;13293;492;13894;250805;217453
2021-08-01;LIG;1490;856;634;152;1338;0;0;ITC;ITC3;7;Liguria;44.41149315;8.9326992;34;9;43;1330;1373;169;172;99764;4363;105500;1923111;738969
2021-08-01;PIE;27341;14476;12865;8465;18295;581;0;ITC;ITC1;1;Piemonte;45.0732745;7.680687483;81;6;87;2388;2475;98;146;351799;11699;365973;5508685;2108164
2021-08-01;SIC;19967;10433;9534;7852;11968;147;0;ITG;ITG1;19;Sicilia;38.11569725;13.3623567;295;33;328;10891;11219;549;581;226275;6047;243541;5280504;1999003
2021-08-01;TOS;29941;15330;14611;13792;15657;492;0;ITI;ITI1;9;Toscana;43.76923077;11.25588885;149;18;167;7401;7568;596;702;238194;6913;252675;5498724;2515777
2021-08-01;VEN;27919;14947;12972;11045;16358;516;0;ITH;ITH3;5;Veneto;45.43490485;12.33845213;108;15;123;12229;12352;239;483;413072;11639;437066;9568593;1940826
2021-08-01;SAR;3055;1502;1553;1031;1988;36;0;ITG;ITG2;20;Sardegna;39.21531192;9.110616306;74;17;91;5120;5211;267;314;55652;1502;62365;1513829;881378
2021-08-01;CAM;16085;8414;7671;6817;8834;434;0;ITF;ITF3;15;Campania;40.83956555;14.25084984;218;12;230;8466;8696;216;377;415150;7594;431440;5687085;3348592
2021-08-01;LOM;53146;28434;24712;27339;24268;1539;0;ITC;ITC4;3;Lombardia;45.46679409;9.190347404;208;27;235;10939;11174;312;522;808491;33827;853492;12577489;4904689
2021-08-01;FVG;3611;1932;1679;1487;1876;248;0;ITH;ITH4;6;Friuli-Venezia Giulia;45.6494354;13.76813649;16;3;19;684;703;9;50;103591;3790;108084;2314333;717365
2021-08-01;PAB;1320;760;560;696;552;72;0;ITH;ITH1;4;Provincia Autonoma Bolzano / Bozen;46.49933453;11.35662422;11;0;11;296;307;14;25;72221;1183;73711;1710494;432392
2021-08-01;MAR;7497;4049;3448;1835;5577;85;0;ITI;ITI3;11;Marche;43.61675973;13.5188753;25;6;31;2031;2062;83;126;100587;3039;105688;1372888;800877
2021-08-01;MOL;967;530;437;760;175;32;0;ITF;ITF2;14;Molise;41.55774754;14.65916051;1;0;1;112;113;4;4;13293;492;13898;251102;217750
2021-08-01;PUG;12438;6517;5921;4324;7993;121;0;ITF;ITF4;16;Puglia;41.12559576;16.86736689;75;9;84;2337;2421;73;158;247099;6669;256189;2907054;1293396
2021-08-01;EMR;30063;16172;13891;10266;19387;410;0;ITH;ITH5;8;Emilia-Romagna;44.49436681;11.3417208;223;17;240;7402;7642;510;606;374009;13283;394934;7289557;1961404
2021-08-01;ABR;7570;4057;3513;2003;5465;102;0;ITF;ITF1;13;Abruzzo;42.35122196;13.39843823;23;0;23;1425;1448;53;85;72247;2514;76209;1840113;732358
2021-08-01;VDA;842;445;397;284;547;11;0;ITC;ITC2;2;Valle d'Aosta / Vallée d'Aoste;45.73750286;7.320149366;1;0;1;59;60;5;6;11228;473;11761;149921;71075
2021-08-01;BAS;4210;2114;2096;1633;2537;40;0;ITF;ITF5;17;Basilicata;40.63947052;15.80514834;17;0;17;682;699;21;24;26134;591;27424;411307;217929
2021-08-01;LAZ;40077;21369;18708;5813;33944;320;0;ITI;ITI4;12;Lazio;41.89277044;12.48366722;297;46;343;10448;10791;716;716;340049;8404;359244;8388310;4564368
2021-08-01;CAL;4895;2562;2333;1172;3699;24;0;ITF;ITF6;18;Calabria;38.90597598;16.59440194;66;6;72;2765;2837;88;126;66989;1255;71081;994459;907420
2021-08-01;UMB;3027;1533;1494;1331;1650;46;0;ITI;ITI2;10;Umbria;43.10675841;12.38824698;15;2;17;1430;1447;105;117;55205;1424;58076;1571556;406486
2021-08-02;PAB;2134;1278;856;1162;875;97;0;ITH;ITH1;4;Provincia Autonoma Bolzano / Bozen;46.49933453;11.35662422;10;0;10;326;336;29;40;72232;1183;73751;1713105;432614
2021-08-02;MOL;2734;1426;1308;1207;1479;48;0;ITF;ITF2;14;Molise;41.55774754;14.65916051;1;0;1;118;119;6;13;13300;492;13911;251555;218201
2021-08-02;ABR;13857;7154;6703;3542;10056;259;0;ITF;ITF1;13;Abruzzo;42.35122196;13.39843823;34;0;34;1473;1507;59;58;72246;2514;76267;1846668;734451
2021-08-02;BAS;4609;2333;2276;1778;2791;40;0;ITF;ITF5;17;Basilicata;40.63947052;15.80514834;19;1;20;686;706;7;7;26134;591;27431;411550;218020
2021-08-02;LOM;83647;45310;38337;18335;64399;913;0;ITC;ITC4;3;Lombardia;45.46679409;9.190347404;210;32;242;11204;11446;272;326;808545;33827;853818;12588000;4907564
2021-08-02;LAZ;37814;19764;18050;6596;30974;244;0;ITI;ITI4;12;Lazio;41.89277044;12.48366722;321;48;369;10712;11081;290;292;340049;8406;359536;8388310;4564368
2021-08-02;SAR;13118;6602;6516;6209;6730;179;0;ITG;ITG2;20;Sardegna;39.21531192;9.110616306;77;19;96;5195;5291;80;178;55748;1504;62543;1520776;882872
2021-08-02;VDA;764;410;354;304;447;13;0;ITC;ITC2;2;Valle d'Aosta / Vallée d'Aoste;45.73750286;7.320149366;2;0;2;55;57;-3;4;11235;473;11765;150327;71308
2021-08-02;SIC;33002;16404;16598;12854;19796;352;0;ITG;ITG1;19;Sicilia;38.11569725;13.3623567;320;34;354;10995;11349;130;262;226404;6050;243803;5288222;2002592
2021-08-02;PAT;5383;2852;2531;1607;3704;72;0;ITH;ITH2;4;Provincia Autonoma Trento;46.06893511;11.12123097;6;0;6;355;361;3;36;44637;1363;46361;911547;250118
2021-08-02;VEN;40112;21044;19068;16312;23170;630;0;ITH;ITH3;5;Veneto;45.43490485;12.33845213;108;16;124;12536;12660;308;460;413227;11639;437526;9579540;1943006
2021-08-02;PIE;30081;15889;14192;9402;20077;602;0;ITC;ITC1;1;Piemonte;45.0732745;7.680687483;81;6;87;2467;2554;79;138;351858;11699;366111;5519759;2110406
2021-08-02;UMB;5538;2897;2641;259;5257;22;0;ITI;ITI2;10;Umbria;43.10675841;12.38824698;14;2;16;1570;1586;139;157;55223;1424;58233;1576869;407192
2021-08-02;FVG;9043;4649;4394;2870;5916;257;0;ITH;ITH4;6;Friuli-Venezia Giulia;45.6494354;13.76813649;19;3;22;690;712;9;22;103604;3790;108106;2315898;717729
2021-08-02;EMR;38544;20363;18181;14766;23102;676;0;ITH;ITH5;8;Emilia-Romagna;44.49436681;11.3417208;241;20;261;7795;8056;414;560;374148;13285;395489;7300142;1962829
2021-08-02;PUG;39840;20194;19646;14215;24398;1227;0;ITF;ITF4;16;Puglia;41.12559576;16.86736689;83;9;92;2360;2452;31;66;247134;6669;256255;2912103;1295126
2021-08-02;TOS;35320;18092;17228;13361;21564;395;0;ITI;ITI1;9;Toscana;43.76923077;11.25588885;159;20;179;7675;7854;286;452;238354;6919;253127;5504738;2518777
2021-08-02;CAL;15083;7537;7546;3724;11301;58;0;ITF;ITF6;18;Calabria;38.90597598;16.59440194;71;5;76;2817;2893;56;67;66999;1256;71148;995860;908516
2021-08-02;CAM;41769;21213;20556;12996;28014;759;0;ITF;ITF3;15;Campania;40.83956555;14.25084984;225;10;235;8157;8392;-304;194;415644;7598;431634;5691411;3349204
2021-08-02;LIG;13122;6524;6598;2953;10073;96;0;ITC;ITC3;7;Liguria;44.41149315;8.9326992;32;12;44;1367;1411;38;40;99764;4365;105540;1925272;739585
2021-08-02;MAR;11725;6209;5516;4598;6868;259;0;ITI;ITI3;11;Marche;43.61675973;13.5188753;29;6;35;2060;2095;33;65;100619;3039;105753;1373737;801213
2021-08-03;SIC;32103;15755;16348;13904;17779;420;0;ITG;ITG1;19;Sicilia;38.11569725;13.3623567;338;32;370;11387;11757;408;809;226799;6056;244612;5302518;2008416
2021-08-03;CAM;31999;16223;15776;14438;16658;903;0;ITF;ITF3;15;Campania;40.83956555;14.25084984;223;11;234;7606;7840;-552;361;416553;7602;431995;5706661;3351834
2021-08-03;EMR;38528;20279;18249;15567;22302;659;0;ITH;ITH5;8;Emilia-Romagna;44.49436681;11.3417208;247;22;269;7975;8244;188;365;374321;13285;395850;7322570;1964815
2021-08-03;FVG;10209;5384;4825;5283;4566;360;0;ITH;ITH4;6;Friuli-Venezia Giulia;45.6494354;13.76813649;22;4;26;734;760;48;94;103650;3790;108200;2321400;718800
2021-08-03;PIE;30275;15837;14438;9327;20393;555;0;ITC;ITC1;1;Piemonte;45.0732745;7.680687483;80;7;87;2517;2604;50;194;352001;11700;366305;5534209;2114429
2021-08-03;CAL;14100;7125;6975;3905;10120;75;0;ITF;ITF6;18;Calabria;38.90597598;16.59440194;71;5;76;2764;2840;-53;123;67174;1257;71271;999311;911581
2021-08-03;SAR;14576;7511;7065;7514;6864;198;0;ITG;ITG2;20;Sardegna;39.21531192;9.110616306;80;19;99;5301;5400;109;210;55848;1505;62753;1524995;885652
2021-08-03;LAZ;32662;16663;15999;5171;27277;214;0;ITI;ITI4;12;Lazio;41.89277044;12.48366722;357;50;407;11092;11499;418;421;340049;8409;359957;8388310;4564368
2021-08-03;LOM;85837;46541;39296;13487;71628;722;0;ITC;ITC4;3;Lombardia;45.46679409;9.190347404;237;32;269;11331;11600;154;586;808974;33830;854404;12624010;4916621
2021-08-03;LIG;14149;7227;6922;3959;10079;111;0;ITC;ITC3;7;Liguria;44.41149315;8.9326992;33;12;45;1320;1365;-46;81;99890;4366;105621;1932099;741630
2021-08-03;BAS;5059;2573;2486;1824;3186;49;0;ITF;ITF5;17;Basilicata;40.63947052;15.80514834;19;1;20;742;762;56;66;26143;592;27497;412401;218370
2021-08-03;ABR;12722;6574;6148;3643;8910;169;0;ITF;ITF1;13;Abruzzo;42.35122196;13.39843823;38;1;39;1447;1486;-21;25;72291;2515;76292;1847741;734812
2021-08-03;TOS;36366;18936;17430;12169;23817;380;0;ITI;ITI1;9;Toscana;43.76923077;11.25588885;170;23;193;7820;8013;159;326;238521;6919;253453;5517393;2524615
2021-08-03;VEN;40748;21565;19183;17595;22433;720;0;ITH;ITH3;5;Veneto;45.43490485;12.33845213;125;16;141;12606;12747;87;663;413799;11643;438189;9619790;1946539
2021-08-03;MOL;2219;1155;1064;1227;956;36;0;ITF;ITF2;14;Molise;41.55774754;14.65916051;1;0;1;114;115;-4;5;13309;492;13916;251885;218526
2021-08-03;MAR;10877;5736;5141;4029;6581;267;0;ITI;ITI3;11;Marche;43.61675973;13.5188753;33;5;38;2119;2157;62;125;100682;3039;105878;1376935;802933
2021-08-03;PAB;2953;1587;1366;1928;840;185;0;ITH;ITH1;4;Provincia Autonoma Bolzano / Bozen;46.49933453;11.35662422;10;0;10;330;340;4;24;72252;1183;73775;1715744;433046
2021-08-03;PAT;6229;3364;2865;2488;3601;140;0;ITH;ITH2;4;Provincia Autonoma Trento;46.06893511;11.12123097;8;0;8;353;361;0;34;44671;1363;46395;913670;250968
2021-08-03;UMB;9208;4762;4446;3503;5520;185;0;ITI;ITI2;10;Umbria;43.10675841;12.38824698;17;2;19;1672;1691;105;119;55237;1424;58352;1583282;407971
2021-08-03;PUG;36522;18532;17990;9201;26556;765;0;ITF;ITF4;16;Puglia;41.12559576;16.86736689;82;12;94;2491;2585;133;213;247212;6671;256468;2923726;1297453
2021-08-03;VDA;946;489;457;571;358;17;0;ITC;ITC2;2;Valle d'Aosta / Vallée d'Aoste;45.73750286;7.320149366;2;0;2;56;58;1;4;11238;473;11769;150702;71534
2021-08-04;MAR;12002;6380;5622;4057;7702;243;0;ITI;ITI3;11;Marche;43.61675973;13.5188753;37;5;42;2265;2307;150;211;100743;3039;106089;1380251;804831
2021-08-04;MOL;2529;1311;1218;967;1543;19;0;ITF;ITF2;14;Molise;41.55774754;14.65916051;0;1;1;128;129;14;23;13318;492;13939;252335;218957
2021-08-04;PAB;3815;2020;1795;2639;982;194;0;ITH;ITH1;4;Provincia Autonoma Bolzano / Bozen;46.49933453;11.35662422;5;3;8;328;336;-4;22;72278;1183;73797;1719731;433832
2021-08-04;PUG;35369;18027;17342;12455;21854;1060;0;ITF;ITF4;16;Puglia;41.12559576;16.86736689;84;12;96;2633;2729;144;236;247304;6671;256704;2936394;1300918
2021-08-04;VDA;1047;572;475;366;657;24;0;ITC;ITC2;2;Valle d'Aosta / Vallée d'Aoste;45.73750286;7.320149366;2;0;2;58;60;2;2;11238;473;11771;150781;71585
2021-08-04;ABR;10883;5629;5254;4301;6339;243;0;ITF;ITF1;13;Abruzzo;42.35122196;13.39843823;42;1;43;1428;1471;-15;54;72360;2515;76346;1852559;736336
2021-08-04;UMB;10673;5542;5131;3312;7195;166;0;ITI;ITI2;10;Umbria;43.10675841;12.38824698;18;2;20;1684;1704;13;77;55301;1424;58429;1588510;408592
2021-08-04;TOS;34870;18039;16831;11361;23089;420;0;ITI;ITI1;9;Toscana;43.76923077;11.25588885;177;21;198;8343;8541;528;765;238756;6921;254218;5531679;2531392
2021-08-04;BAS;4504;2232;2272;1427;3035;42;0;ITF;ITF5;17;Basilicata;40.63947052;15.80514834;19;1;20;769;789;27;50;26166;592;27547;412946;218605
2021-08-04;LAZ;48317;24377;23940;20777;26817;723;0;ITI;ITI4;12;Lazio;41.89277044;12.48366722;379;51;430;11581;12011;512;513;340049;8410;360470;8388310;4564368
2021-08-04;PIE;29383;15539;13844;8964;19860;559;0;ITC;ITC1;1;Piemonte;45.0732745;7.680687483;86;5;91;2634;2725;121;257;352137;11700;366562;5550096;2118484
2021-08-04;PAT;6216;3316;2900;2577;3500;139;0;ITH;ITH2;4;Provincia Autonoma Trento;46.06893511;11.12123097;9;0;9;372;381;20;35;44686;1363;46430;915618;251747
2021-08-04;SIC;24364;12012;12352;10979;13058;327;0;ITG;ITG1;19;Sicilia;38.11569725;13.3623567;351;36;387;11708;12095;338;808;227263;6062;245420;5318107;2015101
2021-08-04;FVG;9365;4839;4526;4680;4383;302;0;ITH;ITH4;6;Friuli-Venezia Giulia;45.6494354;13.76813649;21;4;25;777;802;42;133;103740;3790;108332;2326988;719958
2021-08-04;CAL;16017;8122;7895;4245;11669;103;0;ITF;ITF6;18;Calabria;38.90597598;16.59440194;74;5;79;2668;2747;-93;151;67415;1260;71422;1001875;913788
2021-08-04;SAR;16213;8527;7686;9596;6352;265;0;ITG;ITG2;20;Sardegna;39.21531192;9.110616306;87;19;106;5574;5680;280;350;55917;1506;63103;1531744;889500
2021-08-04;LIG;13872;6985;6887;3248;10508;116;0;ITC;ITC3;7;Liguria;44.41149315;8.9326992;35;12;47;1294;1341;-24;152;100066;4366;105773;1939760;743654
2021-08-04;LOM;90176;48834;41342;14483;75034;659;0;ITC;ITC4;3;Lombardia;45.46679409;9.190347404;247;32;279;11776;12055;455;806;809321;33834;855210;12663242;4925478
2021-08-04;CAM;29840;15309;14531;15746;13101;993;0;ITF;ITF3;15;Campania;40.83956555;14.25084984;239;12;251;7284;7535;-305;496;417352;7604;432491;5720930;3354187
2021-08-04;EMR;35359;18848;16511;13024;21693;642;0;ITH;ITH5;8;Emilia-Romagna;44.49436681;11.3417208;256;22;278;8326;8604;360;495;374451;13286;396341;7344643;1967185
2021-08-04;VEN;42496;22695;19801;22610;18779;1107;0;ITH;ITH3;5;Veneto;45.43490485;12.33845213;137;16;153;12827;12980;233;779;414344;11644;438968;9658660;1950344
2021-08-05;BAS;4559;2321;2238;1285;3232;42;0;ITF;ITF5;17;Basilicata;40.63947052;15.80514834;19;1;20;796;816;27;63;26202;592;27610;414093;219094
2021-08-05;CAL;12473;6289;6184;3878;8497;98;0;ITF;ITF6;18;Calabria;38.90597598;16.59440194;75;5;80;2449;2529;-218;164;67792;1265;71586;1004610;916123
2021-08-05;EMR;36779;19462;17317;18387;17415;977;0;ITH;ITH5;8;Emilia-Romagna;44.49436681;11.3417208;267;24;291;8711;9002;398;669;374717;13286;397005;7365147;1969558
2021-08-05;VEN;39284;21462;17822;15725;22943;616;0;ITH;ITH3;5;Veneto;45.43490485;12.33845213;135;15;150;13153;13303;323;888;414908;11645;439856;9695454;1954277
2021-08-05;UMB;9707;5078;4629;3838;5701;168;0;ITI;ITI2;10;Umbria;43.10675841;12.38824698;19;2;21;1639;1660;-44;22;55367;1424;58451;1589689;408742
2021-08-05;SIC;23867;11850;12017;11521;12037;309;0;ITG;ITG1;19;Sicilia;38.11569725;13.3623567;362;40;402;12145;12547;452;831;227637;6067;246251;5340028;2021313
2021-08-05;MAR;11905;6393;5512;4077;7560;268;0;ITI;ITI3;11;Marche;43.61675973;13.5188753;46;4;50;2398;2448;141;197;100798;3040;106286;1383114;806460
2021-08-05;LAZ;33745;17531;16214;22018;10657;1070;0;ITI;ITI4;12;Lazio;41.89277044;12.48366722;392;53;445;12104;12549;538;544;340049;8416;361014;8388310;4564368
2021-08-05;SAR;15650;8229;7421;8684;6800;166;0;ITG;ITG2;20;Sardegna;39.21531192;9.110616306;87;19;106;6000;6106;426;522;56009;1510;63625;1538450;893023
2021-08-05;TOS;34769;18030;16739;12126;22268;375;0;ITI;ITI1;9;Toscana;43.76923077;11.25588885;201;22;223;8869;9092;551;765;238967;6924;254983;5545466;2538176
2021-08-05;CAM;35177;18033;17144;17272;16834;1071;0;ITF;ITF3;15;Campania;40.83956555;14.25084984;246;13;259;7569;7828;293;670;417728;7605;433161;5734969;3356640
2021-08-05;LOM;90313;49280;41033;15765;73759;789;0;ITC;ITC4;3;Lombardia;45.46679409;9.190347404;254;31;285;12048;12333;278;793;809835;33835;856003;12698582;4933885
2021-08-05;LIG;14268;7368;6900;4107;10064;97;0;ITC;ITC3;7;Liguria;44.41149315;8.9326992;40;13;53;1417;1470;129;169;100106;4366;105942;1946642;745813
2021-08-05;MOL;2300;1161;1139;1620;627;53;0;ITF;ITF2;14;Molise;41.55774754;14.65916051;0;1;1;128;129;0;0;13318;492;13939;252466;219088
2021-08-05;ABR;13903;7162;6741;4713;8916;274;0;ITF;ITF1;13;Abruzzo;42.35122196;13.39843823;39;1;40;1494;1534;63;126;72422;2515;76471;1857733;737908
2021-08-05;PUG;34547;17415;17132;9535;24140;872;0;ITF;ITF4;16;Puglia;41.12559576;16.86736689;95;13;108;2779;2887;158;243;247389;6671;256947;2946886;1303366
2021-08-05;PAB;3473;1888;1585;1769;1581;123;0;ITH;ITH1;4;Provincia Autonoma Bolzano / Bozen;46.49933453;11.35662422;5;3;8;340;348;12;21;72286;1184;73818;1722194;434275
2021-08-05;VDA;790;407;383;278;480;32;0;ITC;ITC2;2;Valle d'Aosta / Vallée d'Aoste;45.73750286;7.320149366;3;0;3;80;83;23;28;11243;473;11799;151254;71808
2021-08-05;PAT;6396;3498;2898;2952;3321;123;0;ITH;ITH2;4;Provincia Autonoma Trento;46.06893511;11.12123097;9;1;10;375;385;4;12;44694;1363;46442;916042;251916
2021-08-05;FVG;7150;3675;3475;3250;3697;203;0;ITH;ITH4;6;Friuli-Venezia Giulia;45.6494354;13.76813649;19;4;23;808;831;29;111;103821;3790;108442;2332684;721111
2021-08-05;PIE;30407;16123;14284;11230;18565;612;0;ITC;ITC1;1;Piemonte;45.0732745;7.680687483;90;5;95;2774;2869;144;259;352252;11700;366821;5566025;2122442
2021-08-06;MAR;11705;6354;5351;4143;7280;282;0;ITI;ITI3;11;Marche;43.61675973;13.5188753;46;5;51;2539;2590;142;217;100873;3040;106503;1385923;808015
2021-08-06;LOM;85628;46662;38966;17811;66969;848;0;ITC;ITC4;3;Lombardia;45.46679409;9.190347404;248;35;283;12172;12455;122;664;810376;33836;856667;12738233;4943962
2021-08-06;LIG;12229;6217;6012;3967;8129;133;0;ITC;ITC3;7;Liguria;44.41149315;8.9326992;42;13;55;1438;1493;23;166;100249;4366;106108;1953700;748163
2021-08-06;VEN;38372;20947;17425;19898;17605;869;0;ITH;ITH3;5;Veneto;45.43490485;12.33845213;142;18;160;13226;13386;83;564;415389;11645;440420;9742451;1958141
2021-08-06;PAT;6482;3571;2911;2677;3684;121;0;ITH;ITH2;4;Provincia Autonoma Trento;46.06893511;11.12123097;8;1;9;340;349;-36;24;44754;1363;46466;917923;252669
2021-08-06;MOL;2348;1240;1108;1097;1208;43;0;ITF;ITF2;14;Molise;41.55774754;14.65916051;1;1;2;124;126;-3;3;13324;492;13942;252817;219435
2021-08-06;PUG;30470;15885;14585;9194;20522;754;0;ITF;ITF4;16;Puglia;41.12559576;16.86736689;94;15;109;2924;3033;146;241;247483;6672;257188;2960868;1306156
2021-08-06;TOS;32985;17688;15297;15355;17150;480;0;ITI;ITI1;9;Toscana;43.76923077;11.25588885;207;22;229;9453;9682;590;734;239109;6926;255717;5561229;2545725
2021-08-06;PAB;3643;1918;1725;1113;2431;99;0;ITH;ITH1;4;Provincia Autonoma Bolzano / Bozen;46.49933453;11.35662422;7;3;10;335;345;-3;0;72289;1184;73818;1723141;434494
2021-08-06;FVG;6463;3399;3064;2360;3936;167;0;ITH;ITH4;6;Friuli-Venezia Giulia;45.6494354;13.76813649;21;2;23;843;866;35;104;103889;3791;108546;2338629;722376
2021-08-06;VDA;821;400;421;401;398;22;0;ITC;ITC2;2;Valle d'Aosta / Vallée d'Aoste;45.73750286;7.320149366;4;0;4;87;91;8;9;11244;473;11808;151596;71998
2021-08-06;CAM;31229;16259;14970;17515;12646;1068;0;ITF;ITF3;15;Campania;40.83956555;14.25084984;257;14;271;7757;8028;200;526;418049;7610;433687;5751191;3359493
2021-08-06;SIC;24789;12579;12210;13507;10871;411;0;ITG;ITG1;19;Sicilia;38.11569725;13.3623567;375;42;417;12562;12979;432;789;227985;6076;247040;5354575;2028073
2021-08-06;UMB;8242;4311;3931;3327;4825;90;0;ITI;ITI2;10;Umbria;43.10675841;12.38824698;17;2;19;1642;1661;1;75;55441;1424;58526;1596304;409467
2021-08-06;CAL;15625;7935;7690;5083;10407;135;0;ITF;ITF6;18;Calabria;38.90597598;16.59440194;76;5;81;2590;2671;142;235;67885;1265;71821;1007736;918730
2021-08-06;PIE;30564;16168;14396;13288;16513;763;0;ITC;ITC1;1;Piemonte;45.0732745;7.680687483;81;4;85;2881;2966;97;236;352390;11701;367057;5589530;2127201
2021-08-06;EMR;34683;18604;16079;18791;14994;898;0;ITH;ITH5;8;Emilia-Romagna;44.49436681;11.3417208;263;22;285;9282;9567;565;717;374868;13287;397722;7393231;1971822
2021-08-06;BAS;4214;2158;2056;1315;2846;53;0;ITF;ITF5;17;Basilicata;40.63947052;15.80514834;21;1;22;812;834;18;37;26221;592;27647;415027;219419
2021-08-06;ABR;10674;5707;4967;3683;6748;243;0;ITF;ITF1;13;Abruzzo;42.35122196;13.39843823;38;1;39;1576;1615;81;123;72464;2515;76594;1864095;739721
2021-08-06;SAR;13827;7175;6652;7989;5662;176;0;ITG;ITG2;20;Sardegna;39.21531192;9.110616306;94;21;115;6183;6298;192;312;56128;1511;63937;1544162;895940
2021-08-06;LAZ;33760;17776;15984;22462;10223;1075;0;ITI;ITI4;12;Lazio;41.89277044;12.48366722;397;54;451;12858;13309;760;762;340049;8418;361776;8388310;4564368
2021-08-07;VDA;741;435;306;308;418;15;0;ITC;ITC2;2;Valle d'Aosta / Vallée d'Aoste;45.73750286;7.320149366;4;0;4;96;100;9;13;11248;473;11821;151955;72159
2021-08-07;ABR;6493;3617;2876;1834;4561;98;0;ITF;ITF1;13;Abruzzo;42.35122196;13.39843823;41;1;42;1618;1660;45;85;72504;2515;76679;1870038;741674
2021-08-07;BAS;4518;2377;2141;1359;3098;61;0;ITF;ITF5;17;Basilicata;40.63947052;15.80514834;21;2;23;864;887;53;67;26235;592;27714;416303;219905
2021-08-07;UMB;7235;3803;3432;2543;4620;72;0;ITI;ITI2;10;Umbria;43.10675841;12.38824698;20;2;22;1750;1772;111;187;55517;1424;58713;1601129;410180
2021-08-07;TOS;30496;16309;14187;14233;15774;489;0;ITI;ITI1;9;Toscana;43.76923077;11.25588885;224;25;249;9863;10112;430;714;239392;6927;256431;5580239;2553200
2021-08-07;EMR;31005;17056;13949;17742;12217;1046;0;ITH;ITH5;8;Emilia-Romagna;44.49436681;11.3417208;280;22;302;9813;10115;548;685;374999;13289;398403;7426476;1973860
2021-08-07;CAL;9527;4874;4653;3019;6444;64;0;ITF;ITF6;18;Calabria;38.90597598;16.59440194;74;4;78;2700;2778;107;238;68015;1266;72059;1011109;921486
2021-08-07;LIG;5211;2662;2549;1124;4060;27;0;ITC;ITC3;7;Liguria;44.41149315;8.9326992;44;15;59;1472;1531;38;143;100353;4367;106251;1962503;751580
2021-08-07;CAM;17200;9180;8020;11199;5290;711;0;ITF;ITF3;15;Campania;40.83956555;14.25084984;253;15;268;8088;8356;328;610;418329;7612;434297;5771433;3365435
2021-08-07;LAZ;35082;19008;16074;22009;11936;1137;0;ITI;ITI4;12;Lazio;41.89277044;12.48366722;381;54;435;13511;13946;637;638;340049;8419;362414;8388310;4564368
2021-08-07;SAR;8213;4308;3905;5438;2707;68;0;ITG;ITG2;20;Sardegna;39.21531192;9.110616306;108;20;128;6451;6579;281;414;56259;1513;64351;1550336;899318
2021-08-07;LOM;79738;43282;36456;16081;62849;808;0;ITC;ITC4;3;Lombardia;45.46679409;9.190347404;259;35;294;12522;12816;361;756;810770;33837;857423;12785883;4957864
2021-08-07;VEN;28958;16299;12659;16345;12070;543;0;ITH;ITH3;5;Veneto;45.43490485;12.33845213;150;18;168;13201;13369;-17;682;416086;11647;441102;9794321;1961606
2021-08-07;SIC;20051;10399;9652;10812;8901;338;0;ITG;ITG1;19;Sicilia;38.11569725;13.3623567;394;47;441;12970;13411;432;776;228322;6083;247816;5372237;2034361
2021-08-07;PIE;29841;15970;13871;12627;16650;564;0;ITC;ITC1;1;Piemonte;45.0732745;7.680687483;85;5;90;2964;3054;88;170;352472;11701;367227;5614497;2134426
2021-08-07;PUG;10132;5348;4784;3564;6270;298;0;ITF;ITF4;16;Puglia;41.12559576;16.86736689;101;13;114;3146;3260;227;360;247615;6673;257548;2978308;1308804
2021-08-07;MOL;1940;1073;867;1060;852;28;0;ITF;ITF2;14;Molise;41.55774754;14.65916051;1;1;2;131;133;7;15;13332;492;13957;253191;219802
2021-08-07;PAT;1631;935;696;817;771;43;0;ITH;ITH2;4;Provincia Autonoma Trento;46.06893511;11.12123097;8;1;9;367;376;27;29;44756;1363;46495;919688;253375
2021-08-07;FVG;4843;2615;2228;2780;1933;130;0;ITH;ITH4;6;Friuli-Venezia Giulia;45.6494354;13.76813649;20;2;22;878;900;34;111;103966;3791;108657;2346220;724385
2021-08-07;MAR;9455;5195;4260;3474;5742;239;0;ITI;ITI3;11;Marche;43.61675973;13.5188753;44;5;49;2697;2746;156;221;100937;3041;106724;1389930;810646
2021-08-07;PAB;2379;1354;1025;1622;665;92;0;ITH;ITH1;4;Provincia Autonoma Bolzano / Bozen;46.49933453;11.35662422;8;2;10;343;353;8;24;72305;1184;73842;1727712;435168
2021-08-08;CAL;4220;2146;2074;1493;2698;29;0;ITF;ITF6;18;Calabria;38.90597598;16.59440194;84;4;88;2732;2820;42;104;68077;1266;72163;1013263;923230
2021-08-08;PAT;642;342;300;247;387;8;0;ITH;ITH2;4;Provincia Autonoma Trento;46.06893511;11.12123097;10;1;11;362;373;-3;33;44792;1363;46528;921823;254229
2021-08-08;EMR;21634;11722;9912;10576;10498;560;0;ITH;ITH5;8;Emilia-Romagna;44.49436681;11.3417208;290;26;316;10321;10637;522;661;375136;13289;399062;7448081;1976102
2021-08-08;FVG;4344;2358;1986;1923;2330;91;0;ITH;ITH4;6;Friuli-Venezia Giulia;45.6494354;13.76813649;23;2;25;853;878;-22;48;104036;3791;108705;2351079;726079
2021-08-08;LAZ;50381;26085;24296;18018;31517;846;0;ITI;ITI4;12;Lazio;41.89277044;12.48366722;398;54;452;14045;14497;551;554;340049;8422;362968;8388310;4564368
2021-08-08;TOS;25050;12929;12121;14610;9937;503;0;ITI;ITI1;9;Toscana;43.76923077;11.25588885;235;23;258;10323;10581;469;665;239586;6929;257096;5594792;2559286
2021-08-08;PIE;20338;10862;9476;9009;10941;388;0;ITC;ITC1;1;Piemonte;45.0732745;7.680687483;90;4;94;3018;3112;58;151;352565;11701;367378;5627443;2140078
2021-08-08;UMB;5066;2712;2354;3556;1414;96;0;ITI;ITI2;10;Umbria;43.10675841;12.38824698;18;2;20;1838;1858;86;147;55578;1424;58860;1605815;410881
2021-08-08;SAR;1884;979;905;1020;841;23;0;ITG;ITG2;20;Sardegna;39.21531192;9.110616306;109;22;131;6548;6679;100;303;56461;1514;64654;1553388;901872
2021-08-08;SIC;15319;8132;7187;7411;7716;192;0;ITG;ITG1;19;Sicilia;38.11569725;13.3623567;418;54;472;13605;14077;666;822;228475;6086;248638;5381320;2038784
2021-08-08;CAM;7575;4042;3533;4646;2667;262;0;ITF;ITF3;15;Campania;40.83956555;14.25084984;249;14;263;8230;8493;137;369;418561;7612;434666;5787249;3370156
2021-08-08;LOM;58845;31957;26888;16679;41370;796;0;ITC;ITC4;3;Lombardia;45.46679409;9.190347404;276;35;311;13003;13314;498;637;810908;33838;858060;12821994;4969503
2021-08-08;VEN;20541;11409;9132;10686;9543;312;0;ITH;ITH3;5;Veneto;45.43490485;12.33845213;150;19;169;13409;13578;209;587;416464;11647;441689;9829379;1964135
2021-08-08;PUG;5124;2602;2522;1656;3419;49;0;ITF;ITF4;16;Puglia;41.12559576;16.86736689;97;14;111;3285;3396;136;208;247687;6673;257756;2990851;1311062
2021-08-08;LIG;1207;650;557;539;660;8;0;ITC;ITC3;7;Liguria;44.41149315;8.9326992;48;15;63;1497;1560;29;135;100458;4368;106386;1968607;754392
2021-08-08;MAR;5638;3020;2618;1682;3845;111;0;ITI;ITI3;11;Marche;43.61675973;13.5188753;45;6;51;2790;2841;95;151;100993;3041;106875;1393285;812774
2021-08-08;PAB;1882;1029;853;953;859;70;0;ITH;ITH1;4;Provincia Autonoma Bolzano / Bozen;46.49933453;11.35662422;8;2;10;363;373;20;28;72313;1184;73870;1731683;435824
2021-08-08;ABR;4450;2428;2022;1886;2474;90;0;ITF;ITF1;13;Abruzzo;42.35122196;13.39843823;42;1;43;1668;1711;51;83;72535;2515;76761;1878541;745011
2021-08-08;MOL;893;467;426;648;229;16;0;ITF;ITF2;14;Molise;41.55774754;14.65916051;2;1;3;126;129;-4;5;13341;492;13962;253535;220143
2021-08-08;VDA;580;298;282;176;394;10;0;ITC;ITC2;2;Valle d'Aosta / Vallée d'Aoste;45.73750286;7.320149366;3;0;3;105;108;8;8;11248;473;11829;152472;72397
2021-08-08;BAS;3664;1873;1791;1112;2521;31;0;ITF;ITF5;17;Basilicata;40.63947052;15.80514834;23;1;24;875;899;12;24;26247;592;27738;417024;220187
2021-08-09;ABR;10706;5550;5156;3097;7415;194;0;ITF;ITF1;13;Abruzzo;42.35122196;13.39843823;43;1;44;1777;1821;110;120;72545;2515;76881;1887114;748253
2021-08-09;PUG;28063;14473;13590;11343;15855;865;0;ITF;ITF4;16;Puglia;41.12559576;16.86736689;107;16;123;3319;3442;46;144;247784;6674;257900;2996355;1312554
2021-08-09;MOL;3447;1782;1665;1633;1763;51;0;ITF;ITF2;14;Molise;41.55774754;14.65916051;2;1;3;134;137;8;16;13349;492;13978;253796;220403
2021-08-09;PAB;1543;863;680;1066;413;64;0;ITH;ITH1;4;Provincia Autonoma Bolzano / Bozen;46.49933453;11.35662422;9;1;10;351;361;-12;21;72346;1184;73891;1735189;436357
2021-08-09;BAS;4014;2067;1947;1568;2399;47;0;ITF;ITF5;17;Basilicata;40.63947052;15.80514834;24;1;25;889;914;15;21;26253;592;27759;417311;220295
2021-08-09;FVG;7849;4199;3650;2377;5286;186;0;ITH;ITH4;6;Friuli-Venezia Giulia;45.6494354;13.76813649;26;1;27;813;840;-38;10;104084;3791;108715;2352508;726451
2021-08-09;PIE;24820;12949;11871;12060;12004;756;0;ITC;ITC1;1;Piemonte;45.0732745;7.680687483;102;4;106;3057;3163;51;90;352604;11701;367468;5634742;2141232
2021-08-09;PAT;5360;2859;2501;2297;2921;142;0;ITH;ITH2;4;Provincia Autonoma Trento;46.06893511;11.12123097;12;0;12;330;342;-31;22;44845;1363;46550;924495;255298
2021-08-09;VDA;675;336;339;250;404;21;0;ITC;ITC2;2;Valle d'Aosta / Vallée d'Aoste;45.73750286;7.320149366;3;0;3;114;117;9;11;11250;473;11840;153228;72854
2021-08-09;CAM;25088;13085;12003;13666;10466;956;0;ITF;ITF3;15;Campania;40.83956555;14.25084984;261;17;278;8274;8552;59;315;418812;7617;434981;5793340;3373504
2021-08-09;SAR;13418;6974;6444;6478;6794;146;0;ITG;ITG2;20;Sardegna;39.21531192;9.110616306;109;22;131;6539;6670;-9;172;56640;1516;64826;1562936;903502
2021-08-09;SIC;25181;12864;12317;12482;12320;379;0;ITG;ITG1;19;Sicilia;38.11569725;13.3623567;442;52;494;14445;14939;862;923;228534;6088;249561;5398676;2043444
2021-08-09;UMB;6697;3548;3149;3503;3034;160;0;ITI;ITI2;10;Umbria;43.10675841;12.38824698;18;1;19;1899;1918;60;137;55655;1424;58997;1611720;411676
2021-08-09;LAZ;52789;26818;25971;21947;29744;1098;0;ITI;ITI4;12;Lazio;41.89277044;12.48366722;438;62;500;14468;14968;471;474;340049;8425;363442;8388310;4564368
2021-08-09;VEN;34783;18649;16134;17157;16862;764;0;ITH;ITH3;5;Veneto;45.43490485;12.33845213;146;20;166;13613;13779;201;425;416686;11649;442114;9842645;1965890
2021-08-09;LOM;68990;37028;31962;18637;49305;1048;0;ITC;ITC4;3;Lombardia;45.46679409;9.190347404;275;37;312;13137;13449;135;200;810972;33839;858260;12832969;4972465
2021-08-09;EMR;30268;16147;14121;16636;12559;1073;0;ITH;ITH5;8;Emilia-Romagna;44.49436681;11.3417208;306;31;337;10794;11131;494;642;375283;13290;399704;7461354;1977311
2021-08-09;TOS;28990;14727;14263;18499;9773;718;0;ITI;ITI1;9;Toscana;43.76923077;11.25588885;253;30;283;10527;10810;229;492;239846;6932;257588;5601265;2562432
2021-08-09;CAL;13165;6713;6452;4641;8361;163;0;ITF;ITF6;18;Calabria;38.90597598;16.59440194;87;4;91;2782;2873;53;92;68114;1268;72255;1014912;924516
2021-08-09;LIG;12026;6116;5910;4338;7544;144;0;ITC;ITC3;7;Liguria;44.41149315;8.9326992;51;15;66;1539;1605;45;76;100489;4368;106462;1971161;755266
2021-08-09;MAR;9097;4828;4269;4051;4771;275;0;ITI;ITI3;11;Marche;43.61675973;13.5188753;49;6;55;2808;2863;22;46;101017;3041;106921;1394022;813105
2021-08-10;CAL;9788;4915;4873;3599;6087;102;0;ITF;ITF6;18;Calabria;38.90597598;16.59440194;89;4;93;2894;2987;114;212;68211;1269;72467;1019361;928327
2021-08-10;UMB;7403;3935;3468;4001;3258;144;0;ITI;ITI2;10;Umbria;43.10675841;12.38824698;24;1;25;1961;1986;68;142;55729;1424;59139;1619829;412379
2021-08-10;LAZ;51103;26435;24668;21594;28509;1000;0;ITI;ITI4;12;Lazio;41.89277044;12.48366722;441;63;504;15166;15670;702;703;340049;8426;364145;8388310;4564368
2021-08-10;CAM;21641;11192;10449;13569;6951;1121;0;ITF;ITF3;15;Campania;40.83956555;14.25084984;270;16;286;8111;8397;-155;364;419327;7621;435345;5809218;3376923
2021-08-10;SIC;21833;10877;10956;10652;10917;264;0;ITG;ITG1;19;Sicilia;38.11569725;13.3623567;448;50;498;14699;15197;258;848;229112;6100;250409;5417435;2049840
2021-08-10;SAR;14247;7512;6735;6256;7829;162;0;ITG;ITG2;20;Sardegna;39.21531192;9.110616306;119;22;141;6515;6656;-14;251;56904;1517;65077;1566941;906743
2021-08-10;LIG;13152;6567;6585;4280;8720;152;0;ITC;ITC3;7;Liguria;44.41149315;8.9326992;54;14;68;1520;1588;-17;106;100612;4368;106568;1978456;757942
2021-08-10;TOS;25944;13497;12447;16355;8938;651;0;ITI;ITI1;9;Toscana;43.76923077;11.25588885;262;30;292;10748;11040;230;511;240122;6937;258099;5614168;2567705
2021-08-10;LOM;61484;33270;28214;18717;41700;1067;0;ITC;ITC4;3;Lombardia;45.46679409;9.190347404;283;35;318;13083;13401;-48;525;811541;33843;858785;12872580;4982816
2021-08-10;EMR;31352;16776;14576;15375;14922;1055;0;ITH;ITH5;8;Emilia-Romagna;44.49436681;11.3417208;313;31;344;10989;11333;202;463;375532;13290;400155;7488469;1979486
2021-08-10;VEN;28516;15645;12871;16436;11476;604;0;ITH;ITH3;5;Veneto;45.43490485;12.33845213;170;18;188;13457;13645;-134;604;417423;11650;442718;9890710;1968757
2021-08-10;PAB;1854;1019;835;1424;281;149;0;ITH;ITH1;4;Provincia Autonoma Bolzano / Bozen;46.49933453;11.35662422;9;1;10;353;363;2;27;72371;1184;73918;1740213;437052
2021-08-10;PAT;6011;3211;2800;2923;2897;191;0;ITH;ITH2;4;Provincia Autonoma Trento;46.06893511;11.12123097;17;1;18;334;352;10;44;44879;1363;46594;928234;256793
2021-08-10;PIE;22109;11708;10401;12524;8894;691;0;ITC;ITC1;1;Piemonte;45.0732745;7.680687483;105;4;109;3024;3133;-30;147;352781;11701;367615;5649735;2146168
2021-08-10;MOL;1928;1047;881;689;1207;32;0;ITF;ITF2;14;Molise;41.55774754;14.65916051;2;1;3;143;146;9;9;13349;492;13987;254108;220714
2021-08-10;FVG;7327;4089;3238;5310;1658;359;0;ITH;ITH4;6;Friuli-Venezia Giulia;45.6494354;13.76813649;27;3;30;834;864;24;75;104135;3791;108790;2358069;727324
2021-08-10;MAR;9200;4814;4386;3333;5592;275;0;ITI;ITI3;11;Marche;43.61675973;13.5188753;47;6;53;2798;2851;-12;146;101175;3041;107067;1397209;814907
2021-08-10;PUG;27471;14323;13148;14201;12114;1156;0;ITF;ITF4;16;Puglia;41.12559576;16.86736689;113;20;133;3519;3652;210;316;247889;6675;258216;3010595;1314980
2021-08-10;VDA;856;437;419;580;264;12;0;ITC;ITC2;2;Valle d'Aosta / Vallée d'Aoste;45.73750286;7.320149366;3;0;3;125;128;11;11;11250;473;11851;153977;73313
2021-08-10;BAS;4417;2326;2091;1513;2833;71;0;ITF;ITF5;17;Basilicata;40.63947052;15.80514834;24;1;25;915;940;26;49;26276;592;27808;418202;220644
2021-08-10;ABR;9270;4964;4306;3396;5661;213;0;ITF;ITF1;13;Abruzzo;42.35122196;13.39843823;49;1;50;1750;1800;-21;25;72591;2515;76906;1889252;748915
2021-08-11;PAB;1207;608;599;669;487;51;0;ITH;ITH1;4;Provincia Autonoma Bolzano / Bozen;46.49933453;11.35662422;7;2;9;354;363;0;28;72399;1184;73946;1749347;438320
2021-08-11;MAR;7571;4099;3472;3169;4165;237;0;ITI;ITI3;11;Marche;43.61675973;13.5188753;42;6;48;2798;2846;-5;208;101388;3041;107275;1400188;816529
2021-08-11;MOL;2025;1059;966;1145;816;64;0;ITF;ITF2;14;Molise;41.55774754;14.65916051;2;1;3;145;148;2;10;13357;492;13997;254552;221144
2021-08-11;PUG;24049;12386;11663;12200;10834;1015;0;ITF;ITF4;16;Puglia;41.12559576;16.86736689;123;22;145;3614;3759;107;306;248086;6677;258522;3024180;1317944
2021-08-11;LIG;13144;6743;6401;4791;8235;118;0;ITC;ITC3;7;Liguria;44.41149315;8.9326992;51;14;65;1533;1598;10;191;100792;4369;106759;1985479;760340
2021-08-11;EMR;27782;14897;12885;12100;14881;801;0;ITH;ITH5;8;Emilia-Romagna;44.49436681;11.3417208;323;31;354;11233;11587;254;454;375687;13291;400565;7513169;1981676
2021-08-11;VDA;778;380;398;304;453;21;0;ITC;ITC2;2;Valle d'Aosta / Vallée d'Aoste;45.73750286;7.320149366;3;0;3;125;128;0;1;11251;473;11852;154147;73437
2021-08-11;ABR;8275;4414;3861;2614;5503;158;0;ITF;ITF1;13;Abruzzo;42.35122196;13.39843823;53;1;54;1750;1804;4;78;72665;2515;76984;1895406;751201
2021-08-11;BAS;3708;1921;1787;1427;2223;58;0;ITF;ITF5;17;Basilicata;40.63947052;15.80514834;23;1;24;953;977;37;64;26302;593;27872;419188;221041
2021-08-11;UMB;7624;4088;3536;3720;3718;186;0;ITI;ITI2;10;Umbria;43.10675841;12.38824698;25;1;26;2029;2055;69;115;55775;1424;59254;1626542;413027
2021-08-11;LOM;61390;33591;27799;22460;37583;1347;0;ITC;ITC4;3;Lombardia;45.46679409;9.190347404;294;35;329;13063;13392;-9;768;812316;33845;859553;12909396;4991626
2021-08-11;FVG;7948;4200;3748;5236;2377;335;0;ITH;ITH4;6;Friuli-Venezia Giulia;45.6494354;13.76813649;27;4;31;850;881;17;155;104272;3791;108944;2364449;728743
2021-08-11;PIE;23504;12639;10865;13448;9366;690;0;ITC;ITC1;1;Piemonte;45.0732745;7.680687483;111;4;115;3086;3201;68;367;353078;11703;367982;5668140;2151180
2021-08-11;PAT;5852;3153;2699;3122;2566;164;0;ITH;ITH2;4;Provincia Autonoma Trento;46.06893511;11.12123097;15;1;16;357;373;21;29;44887;1363;46623;931738;258195
2021-08-11;SAR;11928;6362;5566;6147;5601;180;0;ITG;ITG2;20;Sardegna;39.21531192;9.110616306;119;22;141;6651;6792;136;380;57146;1519;65457;1574778;910253
2021-08-11;LAZ;49074;25756;23318;20489;27688;897;0;ITI;ITI4;12;Lazio;41.89277044;12.48366722;463;65;528;15784;16312;642;645;340049;8429;364790;8388310;4564368
2021-08-11;SIC;16202;8336;7866;8727;7186;289;0;ITG;ITG1;19;Sicilia;38.11569725;13.3623567;459;59;518;15066;15584;387;868;229584;6109;251277;5431841;2056140
2021-08-11;CAL;11065;5677;5388;3524;7426;115;0;ITF;ITF6;18;Calabria;38.90597598;16.59440194;100;4;104;3018;3122;135;212;68287;1270;72679;1022490;930891
2021-08-11;CAM;21055;11097;9958;12034;8144;877;0;ITF;ITF3;15;Campania;40.83956555;14.25084984;284;15;299;8233;8532;135;552;419740;7625;435897;5825877;3379785
2021-08-11;TOS;27084;14209;12875;16924;9421;739;0;ITI;ITI1;9;Toscana;43.76923077;11.25588885;260;29;289;11175;11464;424;774;240471;6938;258873;5629886;2574503
2021-08-11;VEN;26817;14809;12008;15672;10579;566;0;ITH;ITH3;5;Veneto;45.43490485;12.33845213;157;21;178;13429;13607;-38;620;418081;11650;443338;9931578;1972029
2021-08-12;BAS;3919;2000;1919;1678;2159;82;0;ITF;ITF5;17;Basilicata;40.63947052;15.80514834;25;1;26;978;1004;27;63;26338;593;27935;420037;221415
2021-08-12;VDA;378;204;174;118;248;12;0;ITC;ITC2;2;Valle d'Aosta / Vallée d'Aoste;45.73750286;7.320149366;3;0;3;122;125;-3;8;11262;473;11860;154911;73829
2021-08-12;SAR;12481;6615;5866;6627;5686;168;0;ITG;ITG2;20;Sardegna;39.21531192;9.110616306;129;22;151;6856;7007;215;435;57364;1521;65892;1581001;913358
2021-08-12;EMR;27744;15073;12671;19319;6883;1542;0;ITH;ITH5;8;Emilia-Romagna;44.49436681;11.3417208;319;32;351;11580;11931;344;632;375972;13292;401195;7536732;1983964
2021-08-12;LOM;56907;31258;25649;22005;33527;1375;0;ITC;ITC4;3;Lombardia;45.46679409;9.190347404;292;37;329;13033;13362;-30;679;813023;33847;860232;12942309;4999639
2021-08-12;CAM;18928;9999;8929;12393;5718;817;0;ITF;ITF3;15;Campania;40.83956555;14.25084984;290;16;306;8106;8412;-120;543;420399;7629;436440;5839604;3382628
2021-08-12;UMB;7360;3905;3455;4592;2546;222;0;ITI;ITI2;10;Umbria;43.10675841;12.38824698;29;1;30;2038;2068;13;31;55793;1424;59285;1628044;413140
2021-08-12;VEN;24187;13096;11091;17324;6165;698;0;ITH;ITH3;5;Veneto;45.43490485;12.33845213;146;24;170;13251;13421;-186;583;418849;11651;443921;9974355;1975170
2021-08-12;CAL;7648;3884;3764;2802;4670;176;0;ITF;ITF6;18;Calabria;38.90597598;16.59440194;96;7;103;3246;3349;227;299;68358;1271;72978;1025371;933392
2021-08-12;SIC;15126;7585;7541;7975;6906;245;0;ITG;ITG1;19;Sicilia;38.11569725;13.3623567;473;59;532;15702;16234;650;1134;230056;6121;252411;5448443;2063140
2021-08-12;MAR;8020;4332;3688;3890;3768;362;0;ITI;ITI3;11;Marche;43.61675973;13.5188753;37;6;43;2805;2848;2;199;101585;3041;107474;1402875;818042
2021-08-12;LIG;12552;6455;6097;4596;7858;98;0;ITC;ITC3;7;Liguria;44.41149315;8.9326992;57;13;70;1575;1645;47;164;100908;4370;106923;1992033;762610
2021-08-12;LAZ;48078;24897;23181;20826;26257;995;0;ITI;ITI4;12;Lazio;41.89277044;12.48366722;466;66;532;16344;16876;564;567;340049;8432;365357;8388310;4564368
2021-08-12;MOL;1465;761;704;1024;400;41;0;ITF;ITF2;14;Molise;41.55774754;14.65916051;4;1;5;147;152;4;4;13357;492;14001;254608;221198
2021-08-12;TOS;25859;13458;12401;14315;10899;645;0;ITI;ITI1;9;Toscana;43.76923077;11.25588885;259;32;291;11604;11895;431;876;240914;6940;259749;5643577;2580967
2021-08-12;ABR;8770;4627;4143;3179;5411;180;0;ITF;ITF1;13;Abruzzo;42.35122196;13.39843823;48;1;49;1833;1882;78;141;72725;2516;77123;1901599;753278
2021-08-12;PUG;19661;10512;9149;11186;7576;899;0;ITF;ITF4;16;Puglia;41.12559576;16.86736689;126;22;148;3714;3862;103;281;248264;6677;258803;3036409;1320427
2021-08-12;PAB;3367;1724;1643;582;2713;72;0;ITH;ITH1;4;Provincia Autonoma Bolzano / Bozen;46.49933453;11.35662422;8;2;10;369;379;16;31;72414;1184;73977;1754915;439086
2021-08-12;FVG;7996;4287;3709;5202;2503;291;0;ITH;ITH4;6;Friuli-Venezia Giulia;45.6494354;13.76813649;27;5;32;862;894;13;101;104360;3791;109045;2370865;730170
2021-08-12;PIE;22110;11863;10247;13487;7829;794;0;ITC;ITC1;1;Piemonte;45.0732745;7.680687483;114;5;119;3166;3285;84;301;353294;11704;368283;5683697;2155855
2021-08-12;PAT;5715;3055;2660;2212;3326;177;0;ITH;ITH2;4;Provincia Autonoma Trento;46.06893511;11.12123097;16;0;16;340;356;-17;16;44920;1363;46639;932996;258698
2021-08-13;TOS;23124;12531;10593;11341;11233;550;0;ITI;ITI1;9;Toscana;43.76923077;11.25588885;263;32;295;11822;12117;222;819;241507;6944;260568;5658103;2588108
2021-08-13;VEN;24481;13846;10635;18339;5369;773;0;ITH;ITH3;5;Veneto;45.43490485;12.33845213;140;28;168;13366;13534;113;771;419506;11652;444692;10013460;1980475
2021-08-13;PAT;5970;3383;2587;2615;3204;151;0;ITH;ITH2;4;Provincia Autonoma Trento;46.06893511;11.12123097;14;0;14;363;377;21;41;44940;1363;46680;936201;259980
2021-08-13;SAR;9949;5418;4531;6314;3516;119;0;ITG;ITG2;20;Sardegna;39.21531192;9.110616306;128;23;151;6910;7061;54;400;57707;1524;66292;1589401;915629
2021-08-13;LOM;53466;29612;23854;20531;31669;1266;0;ITC;ITC4;3;Lombardia;45.46679409;9.190347404;299;33;332;12990;13322;-40;661;813719;33852;860893;12977623;5008172
2021-08-13;LIG;10906;5635;5271;3928;6882;96;0;ITC;ITC3;7;Liguria;44.41149315;8.9326992;66;12;78;1686;1764;119;158;100947;4370;107081;1998568;764910
2021-08-13;PIE;20066;10695;9371;12093;7243;730;0;ITC;ITC1;1;Piemonte;45.0732745;7.680687483;117;7;124;3159;3283;-2;280;353576;11704;368563;5703895;2160463
2021-08-13;PUG;13813;7340;6473;7306;5916;591;0;ITF;ITF4;16;Puglia;41.12559576;16.86736689;125;21;146;3814;3960;98;361;248526;6678;259164;3050742;1322980
2021-08-13;CAL;7593;3918;3675;2442;5082;69;0;ITF;ITF6;18;Calabria;38.90597598;16.59440194;102;7;109;3375;3484;135;239;68462;1271;73217;1028561;936066
2021-08-13;UMB;6977;3871;3106;4249;2526;202;0;ITI;ITI2;10;Umbria;43.10675841;12.38824698;30;1;31;2098;2129;61;142;55873;1425;59427;1635499;413876
2021-08-13;LAZ;43705;22724;20981;20107;22502;1096;0;ITI;ITI4;12;Lazio;41.89277044;12.48366722;466;68;534;16952;17486;610;613;340049;8435;365970;8388310;4564368
2021-08-13;MOL;1539;802;737;1122;385;32;0;ITF;ITF2;14;Molise;41.55774754;14.65916051;4;1;5;149;154;2;2;13357;492;14003;254903;221492
2021-08-13;PAB;2917;1561;1356;1514;1304;99;0;ITH;ITH1;4;Provincia Autonoma Bolzano / Bozen;46.49933453;11.35662422;9;2;11;342;353;-26;1;72441;1184;73978;1756214;439375
2021-08-13;VDA;496;273;223;204;283;9;0;ITC;ITC2;2;Valle d'Aosta / Vallée d'Aoste;45.73750286;7.320149366;5;0;5;124;129;4;11;11267;473;11871;155559;74173
2021-08-13;MAR;6752;3759;2993;3389;3151;212;0;ITI;ITI3;11;Marche;43.61675973;13.5188753;31;7;38;2826;2864;16;171;101740;3041;107645;1405402;819372
2021-08-13;SIC;11520;5970;5550;5978;5301;241;0;ITG;ITG1;19;Sicilia;38.11569725;13.3623567;499;65;564;16366;16930;696;1101;230448;6134;253512;5462397;2069633
2021-08-13;FVG;3895;2184;1711;2732;969;194;0;ITH;ITH4;6;Friuli-Venezia Giulia;45.6494354;13.76813649;24;5;29;878;907;13;109;104454;3792;109153;2376817;731323
2021-08-13;EMR;21279;11812;9467;14288;6090;901;0;ITH;ITH5;8;Emilia-Romagna;44.49436681;11.3417208;321;36;357;12072;12429;498;656;376118;13295;401842;7561721;1985944
2021-08-13;BAS;3661;1904;1757;1423;2147;91;0;ITF;ITF5;17;Basilicata;40.63947052;15.80514834;27;1;28;995;1023;19;39;26357;594;27974;420831;221791
2021-08-13;ABR;7120;3832;3288;2012;5001;107;0;ITF;ITF1;13;Abruzzo;42.35122196;13.39843823;51;1;52;1893;1945;63;140;72801;2516;77262;1907560;755249
2021-08-13;CAM;16870;9153;7717;9711;6606;553;0;ITF;ITF3;15;Campania;40.83956555;14.25084984;303;16;319;8333;8652;240;622;420773;7637;437062;5854229;3385240
2021-08-14;ABR;127;69;58;99;26;2;0;ITF;ITF1;13;Abruzzo;42.35122196;13.39843823;48;3;51;1883;1934;-11;95;72904;2518;77356;1913281;757315
2021-08-14;VDA;465;256;209;135;314;16;0;ITC;ITC2;2;Valle d'Aosta / Vallée d'Aoste;45.73750286;7.320149366;5;0;5;125;130;1;1;11269;473;11872;156128;74516
2021-08-14;BAS;3479;1907;1572;1421;1997;61;0;ITF;ITF5;17;Basilicata;40.63947052;15.80514834;31;1;32;1042;1074;51;66;26372;594;28040;421963;222217
2021-08-14;UMB;5856;3233;2623;2919;2786;151;0;ITI;ITI2;10;Umbria;43.10675841;12.38824698;30;1;31;2091;2122;-7;139;56018;1426;59566;1641080;414522
2021-08-14;PIE;15158;8167;6991;9813;4765;580;0;ITC;ITC1;1;Piemonte;45.0732745;7.680687483;109;8;117;3226;3343;60;280;353795;11705;368843;5726928;2166506
2021-08-14;SIC;6146;3343;2803;3309;2716;121;0;ITG;ITG1;19;Sicilia;38.11569725;13.3623567;531;65;596;16891;17487;557;1013;230901;6137;254525;5481011;2075770
2021-08-14;VEN;9922;5810;4112;7273;2401;248;0;ITH;ITH3;5;Veneto;45.43490485;12.33845213;144;27;171;13115;13286;-248;600;420354;11652;445292;10054451;1983200
2021-08-14;MOL;1622;875;747;705;896;21;0;ITF;ITF2;14;Molise;41.55774754;14.65916051;4;1;5;152;157;3;17;13371;492;14020;255328;221910
2021-08-14;EMR;15815;8922;6893;8338;7028;449;0;ITH;ITH5;8;Emilia-Romagna;44.49436681;11.3417208;316;38;354;12628;12982;553;765;376320;13299;402601;7588532;1987793
2021-08-14;LAZ;2546;1439;1107;994;1518;34;0;ITI;ITI4;12;Lazio;41.89277044;12.48366722;454;67;521;17543;18064;578;583;340049;8440;366553;8388310;4564368
2021-08-14;LOM;26550;14889;11661;11129;14867;554;0;ITC;ITC4;3;Lombardia;45.46679409;9.190347404;317;36;353;12867;13220;-102;676;814493;33856;861569;13017061;5018038
2021-08-14;SAR;1793;1025;768;990;793;10;0;ITG;ITG2;20;Sardegna;39.21531192;9.110616306;131;21;152;7101;7253;192;471;57983;1527;66763;1593515;919251
2021-08-14;TOS;22397;12226;10171;10459;11519;419;0;ITI;ITI1;9;Toscana;43.76923077;11.25588885;268;33;301;11888;12189;72;683;242113;6949;261251;5672481;2594178
2021-08-14;MAR;2402;1379;1023;1035;1318;49;0;ITI;ITI3;11;Marche;43.61675973;13.5188753;34;6;40;2884;2924;60;199;101877;3043;107844;1408332;821052
2021-08-14;CAL;2233;1195;1038;728;1489;16;0;ITF;ITF6;18;Calabria;38.90597598;16.59440194;104;7;111;3346;3457;-27;237;68724;1273;73454;1031398;938444
2021-08-14;LIG;3215;1719;1496;898;2299;18;0;ITC;ITC3;7;Liguria;44.41149315;8.9326992;66;12;78;1699;1777;13;187;101121;4370;107268;2006495;768149
2021-08-14;CAM;4919;2804;2115;2051;2706;162;0;ITF;ITF3;15;Campania;40.83956555;14.25084984;317;16;333;8625;8958;306;711;421176;7639;437773;5871884;3389191
2021-08-14;FVG;207;152;55;189;4;14;0;ITH;ITH4;6;Friuli-Venezia Giulia;45.6494354;13.76813649;29;4;33;881;914;7;99;104545;3792;109251;2385302;733406
2021-08-14;PAT;290;156;134;51;236;3;0;ITH;ITH2;4;Provincia Autonoma Trento;46.06893511;11.12123097;13;1;14;363;377;0;36;44976;1363;46716;939078;261131
2021-08-14;PUG;1102;568;534;510;573;19;0;ITF;ITF4;16;Puglia;41.12559576;16.86736689;128;21;149;3958;4107;147;334;248710;6681;259498;3067609;1325551
2021-08-14;PAB;2063;1120;943;727;1274;62;0;ITH;ITH1;4;Provincia Autonoma Bolzano / Bozen;46.49933453;11.35662422;11;2;13;367;380;27;45;72459;1184;74023;1763155;440370
2021-08-15;FVG;1;1;0;0;1;0;0;ITH;ITH4;6;Friuli-Venezia Giulia;45.6494354;13.76813649;30;5;35;866;901;-13;61;104619;3792;109312;2389704;734895
2021-08-15;PIE;6583;3635;2948;5033;1271;279;0;ITC;ITC1;1;Piemonte;45.0732745;7.680687483;115;9;124;3320;3444;101;202;353896;11705;369045;5738585;2170840
2021-08-15;SIC;2513;1428;1085;1509;954;50;0;ITG;ITG1;19;Sicilia;38.11569725;13.3623567;538;68;606;17430;18036;549;946;231294;6141;255471;5489876;2080136
2021-08-15;SAR;19;10;9;9;10;0;0;ITG;ITG2;20;Sardegna;39.21531192;9.110616306;134;21;155;7135;7290;37;275;58216;1532;67038;1596184;921482
2021-08-15;LOM;7000;3988;3012;2933;3884;183;0;ITC;ITC4;3;Lombardia;45.46679409;9.190347404;308;42;350;12881;13231;11;333;814814;33857;861902;13026827;5020500
2021-08-15;UMB;4395;2387;2008;2870;1382;143;0;ITI;ITI2;10;Umbria;43.10675841;12.38824698;30;1;31;2136;2167;45;158;56131;1426;59724;1646370;415161
2021-08-15;VEN;3107;1763;1344;2619;425;63;0;ITH;ITH3;5;Veneto;45.43490485;12.33845213;144;30;174;13156;13330;44;509;420817;11654;445801;10085559;1985142
2021-08-15;CAM;1122;639;483;215;899;8;0;ITF;ITF3;15;Campania;40.83956555;14.25084984;313;15;328;8847;9175;217;473;421431;7640;438246;5885705;3392358
2021-08-15;EMR;6658;3694;2964;3288;3200;170;0;ITH;ITH5;8;Emilia-Romagna;44.49436681;11.3417208;326;35;361;12787;13148;166;551;376702;13300;403150;7608348;1989478
2021-08-15;MAR;225;112;113;205;13;7;0;ITI;ITI3;11;Marche;43.61675973;13.5188753;39;6;45;2927;2972;48;160;101989;3043;108004;1410581;822311
2021-08-15;LAZ;1520;941;579;801;697;22;0;ITI;ITI4;12;Lazio;41.89277044;12.48366722;456;67;523;18007;18530;466;467;340049;8441;367020;8388310;4564368
2021-08-15;CAL;52;24;28;18;33;1;0;ITF;ITF6;18;Calabria;38.90597598;16.59440194;103;7;110;3365;3475;18;250;68954;1275;73704;1033841;940441
2021-08-15;TOS;14692;7762;6930;5271;9237;184;0;ITI;ITI1;9;Toscana;43.76923077;11.25588885;287;33;320;12061;12381;192;725;242645;6950;261976;5684712;2599444
2021-08-15;LIG;1414;786;628;848;531;35;0;ITC;ITC3;7;Liguria;44.41149315;8.9326992;71;12;83;1698;1781;4;169;101286;4370;107437;2012385;770898
2021-08-15;PUG;58;35;23;57;1;0;0;ITF;ITF4;16;Puglia;41.12559576;16.86736689;128;22;150;4058;4208;101;184;248792;6682;259682;3079519;1327713
2021-08-15;PAB;616;333;283;263;334;19;0;ITH;ITH1;4;Provincia Autonoma Bolzano / Bozen;46.49933453;11.35662422;12;1;13;427;440;60;60;72459;1184;74083;1767979;441118
2021-08-15;BAS;2704;1430;1274;1136;1527;41;0;ITF;ITF5;17;Basilicata;40.63947052;15.80514834;32;2;34;1092;1126;52;63;26383;594;28103;422636;222537
2021-08-16;MAR;5167;2782;2385;2983;2024;160;0;ITI;ITI3;11;Marche;43.61675973;13.5188753;38;7;45;2935;2980;8;69;102050;3043;108073;1411328;822667
2021-08-16;MOL;1786;926;860;829;941;16;0;ITF;ITF2;14;Molise;41.55774754;14.65916051;5;1;6;150;156;-1;4;13376;492;14024;255645;222227
2021-08-16;PUG;12095;6419;5676;7085;4377;633;0;ITF;ITF4;16;Puglia;41.12559576;16.86736689;136;23;159;4076;4235;27;103;248868;6682;259785;3085424;1329360
2021-08-16;PAB;1966;1116;850;822;1086;58;0;ITH;ITH1;4;Provincia Autonoma Bolzano / Bozen;46.49933453;11.35662422;13;1;14;462;476;36;77;72500;1184;74160;1773417;442068
2021-08-16;ABR;6094;3205;2889;2255;3692;147;0;ITF;ITF1;13;Abruzzo;42.35122196;13.39843823;50;5;55;1915;1970;36;104;72972;2518;77460;1921543;760245
2021-08-16;CAL;6977;3566;3411;2375;4540;62;0;ITF;ITF6;18;Calabria;38.90597598;16.59440194;109;7;116;3297;3413;-62;95;69110;1276;73799;1035003;941524
2021-08-16;CAM;12470;6697;5773;6207;5728;535;0;ITF;ITF3;15;Campania;40.83956555;14.25084984;317;15;332;8793;9125;-50;183;421658;7646;438429;5889612;3393079
2021-08-16;VDA;422;211;211;129;276;17;0;ITC;ITC2;2;Valle d'Aosta / Vallée d'Aoste;45.73750286;7.320149366;5;0;5;113;118;-12;13;11294;473;11885;156769;74884
2021-08-16;BAS;3568;1867;1701;1485;1998;85;0;ITF;ITF5;17;Basilicata;40.63947052;15.80514834;34;2;36;1084;1120;-6;2;26391;594;28105;422692;222565
2021-08-16;FVG;4826;2599;2227;2702;1876;248;0;ITH;ITH4;6;Friuli-Venezia Giulia;45.6494354;13.76813649;30;7;37;855;892;-9;16;104644;3792;109328;2390850;735191
2021-08-16;EMR;20237;10878;9359;12637;6580;1020;0;ITH;ITH5;8;Emilia-Romagna;44.49436681;11.3417208;344;40;384;12894;13278;130;458;377023;13302;403603;7619395;1990735
2021-08-16;LAZ;3723;2052;1671;2067;1593;63;0;ITI;ITI4;12;Lazio;41.89277044;12.48366722;493;70;563;17529;18092;-438;419;340906;8441;367439;8388310;4564368
2021-08-16;SIC;20318;10431;9887;10909;9091;318;0;ITG;ITG1;19;Sicilia;38.11569725;13.3623567;583;71;654;18079;18733;697;881;231471;6148;256352;5497904;2084591
2021-08-16;LOM;39044;21109;17935;16894;21102;1048;0;ITC;ITC4;3;Lombardia;45.46679409;9.190347404;311;40;351;12675;13026;-205;138;815154;33860;862040;13032787;5021882
2021-08-16;PAT;4867;2571;2296;1839;2912;116;0;ITH;ITH2;4;Provincia Autonoma Trento;46.06893511;11.12123097;15;1;16;370;386;9;33;45000;1363;46749;941803;262221
2021-08-16;PIE;19278;10234;9044;11596;6817;865;0;ITC;ITC1;1;Piemonte;45.0732745;7.680687483;127;11;138;3254;3392;-52;97;354045;11705;369142;5747299;2172616
2021-08-16;UMB;3524;1744;1780;1980;1475;69;0;ITI;ITI2;10;Umbria;43.10675841;12.38824698;32;2;34;2235;2269;102;179;56208;1426;59903;1652370;415851
2021-08-16;LIG;9933;5141;4792;3773;6053;107;0;ITC;ITC3;7;Liguria;44.41149315;8.9326992;75;10;85;1728;1813;32;78;101331;4371;107515;2014762;771714
2021-08-16;SAR;8461;4411;4050;4550;3794;117;0;ITG;ITG2;20;Sardegna;39.21531192;9.110616306;140;22;162;7223;7385;95;266;58386;1533;67304;1599444;923178
2021-08-16;VEN;19741;10689;9052;13001;6165;575;0;ITH;ITH3;5;Veneto;45.43490485;12.33845213;155;32;187;13229;13416;86;291;421022;11654;446092;10096273;1986443
2021-08-16;TOS;30016;15753;14263;16608;12703;705;0;ITI;ITI1;9;Toscana;43.76923077;11.25588885;297;37;334;12054;12388;7;527;243162;6953;262503;5690599;2602117
2021-08-17;EMR;22408;12319;10089;14518;6863;1027;0;ITH;ITH5;8;Emilia-Romagna;44.49436681;11.3417208;361;44;405;13023;13428;150;478;377341;13309;404078;7647105;1992764
2021-08-17;CAL;7691;3917;3774;2766;4830;95;0;ITF;ITF6;18;Calabria;38.90597598;16.59440194;110;11;121;3281;3402;-11;201;69319;1279;74000;1038257;944332
2021-08-17;SAR;10611;5536;5075;6094;4389;128;0;ITG;ITG2;20;Sardegna;39.21531192;9.110616306;158;18;176;7187;7363;-22;207;58607;1541;67511;1609309;925968
2021-08-17;FVG;3652;1966;1686;2822;602;228;0;ITH;ITH4;6;Friuli-Venezia Giulia;45.6494354;13.76813649;26;7;33;899;932;40;79;104678;3795;109405;2397652;736569
2021-08-17;PIE;18118;9714;8404;11718;5609;791;0;ITC;ITC1;1;Piemonte;45.0732745;7.680687483;132;12;144;3222;3366;-26;205;354276;11705;369347;5761952;2177528
2021-08-17;LOM;33281;18420;14861;17416;14681;1184;0;ITC;ITC4;3;Lombardia;45.46679409;9.190347404;320;39;359;12547;12906;-120;374;815646;33862;862414;13065784;5030548
2021-08-17;CAM;22282;12045;10237;7290;14442;550;0;ITF;ITF3;15;Campania;40.83956555;14.25084984;327;18;345;8714;9059;-66;335;422049;7656;438764;5903741;3396083
2021-08-17;PUG;20015;10384;9631;9332;9984;699;0;ITF;ITF4;16;Puglia;41.12559576;16.86736689;137;23;160;4041;4201;-34;165;249065;6684;259950;3098711;1331284
2021-08-17;TOS;26028;14047;11981;11486;14045;497;0;ITI;ITI1;9;Toscana;43.76923077;11.25588885;309;38;347;11927;12274;-114;396;243667;6958;262899;5701825;2606498
2021-08-17;PAB;1252;690;562;790;392;70;0;ITH;ITH1;4;Provincia Autonoma Bolzano / Bozen;46.49933453;11.35662422;16;1;17;507;524;48;43;72495;1184;74203;1778845;442872
2021-08-17;BAS;3508;1763;1745;1398;2044;66;0;ITF;ITF5;17;Basilicata;40.63947052;15.80514834;36;1;37;1108;1145;25;49;26414;595;28154;423440;222909
2021-08-17;ABR;6582;3468;3114;2822;3542;218;0;ITF;ITF1;13;Abruzzo;42.35122196;13.39843823;56;5;61;1971;2032;62;76;72985;2518;77535;1928957;763162
2021-08-17;LIG;9875;5183;4692;3644;6122;109;0;ITC;ITC3;7;Liguria;44.41149315;8.9326992;75;12;87;1662;1749;-64;133;101527;4372;107648;2021956;773948
2021-08-17;MAR;7595;4040;3555;3085;4286;224;0;ITI;ITI3;11;Marche;43.61675973;13.5188753;39;8;47;2958;3005;25;101;102126;3043;108174;1413527;823727
2021-08-17;PAT;5479;2894;2585;1977;3363;139;0;ITH;ITH2;4;Provincia Autonoma Trento;46.06893511;11.12123097;15;1;16;410;426;40;62;45022;1363;46811;944713;263385
2021-08-17;MOL;1669;879;790;342;1310;17;0;ITF;ITF2;14;Molise;41.55774754;14.65916051;6;1;7;156;163;7;17;13386;492;14041;255989;222561
2021-08-17;VEN;19293;10481;8812;11234;7599;460;0;ITH;ITH3;5;Veneto;45.43490485;12.33845213;175;35;210;12755;12965;-451;422;421892;11657;446514;10138899;1989122
2021-08-17;VDA;561;307;254;211;342;8;0;ITC;ITC2;2;Valle d'Aosta / Vallée d'Aoste;45.73750286;7.320149366;4;0;4;115;119;1;8;11301;473;11893;157431;75268
2021-08-17;UMB;3670;1913;1757;2493;1088;89;0;ITI;ITI2;10;Umbria;43.10675841;12.38824698;32;2;34;2206;2240;-29;92;56329;1426;59995;1659057;416434
2021-08-17;LAZ;8350;4839;3511;4034;4194;122;0;ITI;ITI4;12;Lazio;41.89277044;12.48366722;505;66;571;17241;17812;-280;551;341729;8449;367990;8388310;4564368
2021-08-17;SIC;18574;9499;9075;10106;8142;326;0;ITG;ITG1;19;Sicilia;38.11569725;13.3623567;607;77;684;19265;19949;1216;1229;231484;6148;257581;5524769;2091953
2021-08-18;LIG;12246;6605;5641;4250;7865;131;0;ITC;ITC3;7;Liguria;44.41149315;8.9326992;73;11;84;1705;1789;40;161;101645;4375;107809;2029046;776249
2021-08-18;MAR;6423;3424;2999;3216;2872;335;0;ITI;ITI3;11;Marche;43.61675973;13.5188753;44;9;53;3042;3095;90;205;102241;3043;108379;1416410;825144
2021-08-18;PUG;20243;10722;9521;10741;8577;925;0;ITF;ITF4;16;Puglia;41.12559576;16.86736689;140;23;163;4158;4321;120;358;249301;6686;260308;3113265;1334403
2021-08-18;PAB;882;462;420;356;499;27;0;ITH;ITH1;4;Provincia Autonoma Bolzano / Bozen;46.49933453;11.35662422;12;1;13;518;531;7;35;72523;1184;74238;1787823;444200
2021-08-18;VDA;687;356;331;235;433;19;0;ITC;ITC2;2;Valle d'Aosta / Vallée d'Aoste;45.73750286;7.320149366;4;0;4;122;126;7;13;11307;473;11906;158175;75703
2021-08-18;ABR;7382;3920;3462;3084;4107;191;0;ITF;ITF1;13;Abruzzo;42.35122196;13.39843823;61;5;66;1940;2006;-26;15;73026;2518;77550;1930471;763681
2021-08-18;UMB;4707;2464;2243;3442;1146;119;0;ITI;ITI2;10;Umbria;43.10675841;12.38824698;33;2;35;2170;2205;-35;117;56481;1426;60112;1664886;416846
2021-08-18;SIC;21951;11325;10626;11668;9909;374;0;ITG;ITG1;19;Sicilia;38.11569725;13.3623567;621;80;701;19016;19717;-232;997;232688;6173;258578;5539807;2098864
2021-08-18;PIE;18171;9817;8354;11646;5771;754;0;ITC;ITC1;1;Piemonte;45.0732745;7.680687483;136;14;150;3242;3392;26;305;354554;11706;369652;5775709;2181523
2021-08-18;EMR;22301;12215;10086;14594;6655;1052;0;ITH;ITH5;8;Emilia-Romagna;44.49436681;11.3417208;369;47;416;12974;13390;-38;445;377819;13312;404521;7671607;1995230
2021-08-18;PAT;4643;2556;2087;1450;3104;89;0;ITH;ITH2;4;Provincia Autonoma Trento;46.06893511;11.12123097;16;1;17;401;418;-8;39;45069;1363;46850;948583;264933
2021-08-18;FVG;4736;2521;2215;3023;1480;233;0;ITH;ITH4;6;Friuli-Venezia Giulia;45.6494354;13.76813649;30;9;39;888;927;-5;128;104811;3795;109533;2404890;738059
2021-08-18;BAS;3572;1975;1597;1500;1976;96;0;ITF;ITF5;17;Basilicata;40.63947052;15.80514834;33;1;34;1159;1193;48;68;26433;596;28222;424459;223333
2021-08-18;LAZ;9543;5517;4026;3278;6145;120;0;ITI;ITI4;12;Lazio;41.89277044;12.48366722;524;64;588;17129;17717;-95;703;342521;8455;368693;8388310;4564368
2021-08-18;SAR;10694;5534;5160;5708;4856;130;0;ITG;ITG2;20;Sardegna;39.21531192;9.110616306;165;18;183;7199;7382;19;429;59012;1546;67940;1616342;929510
2021-08-18;CAM;19593;10346;9247;7725;11293;575;0;ITF;ITF3;15;Campania;40.83956555;14.25084984;336;20;356;8824;9180;121;558;422477;7665;439322;5918005;3398822
2021-08-18;LOM;30914;17062;13852;17895;11649;1370;0;ITC;ITC4;3;Lombardia;45.46679409;9.190347404;319;39;358;12235;12593;-313;671;816623;33869;863085;13107260;5040501
2021-08-18;CAL;9463;4852;4611;3393;5970;100;0;ITF;ITF6;18;Calabria;38.90597598;16.59440194;119;10;129;3356;3485;83;279;69512;1282;74279;1042828;947728
2021-08-18;TOS;25956;13827;12129;12847;12505;604;0;ITI;ITI1;9;Toscana;43.76923077;11.25588885;315;39;354;11814;12168;-106;675;244446;6960;263574;5716599;2613025
2021-08-18;MOL;1347;706;641;344;981;22;0;ITF;ITF2;14;Molise;41.55774754;14.65916051;8;1;9;144;153;-10;6;13402;492;14047;256324;222890
2021-08-18;VEN;23350;12586;10764;14234;8443;673;0;ITH;ITH3;5;Veneto;45.43490485;12.33845213;186;39;225;12619;12844;-121;692;422703;11659;447206;10176078;1991780
2021-08-19;VDA;265;158;107;70;180;15;0;ITC;ITC2;2;Valle d'Aosta / Vallée d'Aoste;45.73750286;7.320149366;4;0;4;121;125;-1;1;11309;473;11907;158319;75804
2021-08-19;BAS;3596;1871;1725;1671;1836;89;0;ITF;ITF5;17;Basilicata;40.63947052;15.80514834;35;2;37;1193;1230;37;68;26464;596;28290;425635;223834
2021-08-19;LAZ;9313;5341;3972;3014;6190;109;0;ITI;ITI4;12;Lazio;41.89277044;12.48366722;526;65;591;17055;17646;-71;548;343134;8461;369241;8388310;4564368
2021-08-19;SIC;19570;9768;9802;10489;8767;314;0;ITG;ITG1;19;Sicilia;38.11569725;13.3623567;641;83;724;19978;20702;985;1377;233064;6189;259955;5556072;2106912
2021-08-19;ABR;6722;3609;3113;3256;3274;192;0;ITF;ITF1;13;Abruzzo;42.35122196;13.39843823;61;6;67;1960;2027;21;99;73103;2519;77649;1936505;765868
2021-08-19;CAL;5874;2946;2928;2347;3468;59;0;ITF;ITF6;18;Calabria;38.90597598;16.59440194;125;11;136;3427;3563;78;231;69653;1291;74507;1045875;950242
2021-08-19;CAM;22020;11638;10382;9569;11774;677;0;ITF;ITF3;15;Campania;40.83956555;14.25084984;340;23;363;8956;9319;139;647;422981;7669;439969;5932417;3402136
2021-08-19;VEN;19603;10690;8913;12256;6813;534;0;ITH;ITH3;5;Veneto;45.43490485;12.33845213;189;41;230;12540;12770;-74;588;423364;11660;447794;10209653;1994271
2021-08-19;TOS;24211;12846;11365;11921;11658;632;0;ITI;ITI1;9;Toscana;43.76923077;11.25588885;322;38;360;11996;12356;188;844;245096;6966;264418;5730826;2619753
2021-08-19;EMR;21574;11586;9988;11958;8737;879;0;ITH;ITH5;8;Emilia-Romagna;44.49436681;11.3417208;376;47;423;13235;13658;268;576;378111;13315;405084;7693428;1996961
2021-08-19;UMB;5730;3042;2688;3940;1611;179;0;ITI;ITI2;10;Umbria;43.10675841;12.38824698;36;2;38;2133;2171;-34;11;56526;1426;60123;1665963;416977
2021-08-19;LIG;9840;5180;4660;2710;7020;110;0;ITC;ITC3;7;Liguria;44.41149315;8.9326992;74;13;87;1774;1861;72;212;101785;4375;108021;2035548;778379
2021-08-19;SAR;10762;5691;5071;5731;4898;133;0;ITG;ITG2;20;Sardegna;39.21531192;9.110616306;175;20;195;7281;7476;94;451;59365;1550;68391;1621413;932298
2021-08-19;PAB;1752;968;784;1047;615;90;0;ITH;ITH1;4;Provincia Autonoma Bolzano / Bozen;46.49933453;11.35662422;18;1;19;511;530;-1;22;72546;1184;74260;1793431;445040
2021-08-19;MOL;2284;1147;1137;609;1648;27;0;ITF;ITF2;14;Molise;41.55774754;14.65916051;8;1;9;151;160;7;21;13416;492;14068;256826;223379
2021-08-19;LOM;28983;15943;13040;14777;13084;1122;0;ITC;ITC4;3;Lombardia;45.46679409;9.190347404;309;42;351;12238;12589;-4;627;817251;33872;863712;13140875;5048450
2021-08-19;MAR;6273;3347;2926;3490;2454;329;0;ITI;ITI3;11;Marche;43.61675973;13.5188753;45;9;54;2992;3046;-49;208;102498;3043;108587;1418788;826427
2021-08-19;PUG;17913;9335;8578;8799;8394;720;0;ITF;ITF4;16;Puglia;41.12559576;16.86736689;145;23;168;4166;4334;13;217;249503;6688;260525;3126026;1336852
2021-08-19;FVG;4915;2628;2287;1759;3006;150;0;ITH;ITH4;6;Friuli-Venezia Giulia;45.6494354;13.76813649;26;10;36;861;897;-30;68;104906;3795;109598;2410074;739249
2021-08-19;PIE;15927;8570;7357;10586;4605;736;0;ITC;ITC1;1;Piemonte;45.0732745;7.680687483;139;14;153;3283;3436;44;254;354764;11706;369906;5790993;2185501
2021-08-19;PAT;4638;2487;2151;1116;3437;85;0;ITH;ITH2;4;Provincia Autonoma Trento;46.06893511;11.12123097;19;1;20;427;447;29;47;45087;1363;46897;951856;266242
2021-08-20;FVG;6323;3566;2757;2750;3313;260;0;ITH;ITH4;6;Friuli-Venezia Giulia;45.6494354;13.76813649;28;9;37;904;941;44;113;104974;3795;109710;2416687;740533
2021-08-20;LOM;27134;15014;12120;14131;11908;1095;0;ITC;ITC4;3;Lombardia;45.46679409;9.190347404;314;41;355;11823;12178;-411;504;818163;33875;864216;13175422;5056498
2021-08-20;CAM;17414;9327;8087;7425;9424;565;0;ITF;ITF3;15;Campania;40.83956555;14.25084984;348;22;370;9068;9438;119;539;423394;7676;440508;5945497;3404401
2021-08-20;PIE;16681;8965;7716;10395;5562;724;0;ITC;ITC1;1;Piemonte;45.0732745;7.680687483;128;13;141;3380;3521;85;250;354928;11707;370156;5811884;2190038
2021-08-20;SAR;10176;5353;4823;4794;5232;150;0;ITG;ITG2;20;Sardegna;39.21531192;9.110616306;179;19;198;7425;7623;147;403;59617;1554;68794;1627334;935367
2021-08-20;TOS;20234;11097;9137;9968;9768;498;0;ITI;ITI1;9;Toscana;43.76923077;11.25588885;330;41;371;12003;12374;18;700;245774;6970;265118;5743507;2624995
2021-08-20;VEN;19482;10550;8932;11324;7584;574;0;ITH;ITH3;5;Veneto;45.43490485;12.33845213;190;43;233;12431;12664;-106;505;423972;11663;448299;10246556;1996387
2021-08-20;LIG;9452;5040;4412;3140;6207;105;0;ITC;ITC3;7;Liguria;44.41149315;8.9326992;81;11;92;1829;1921;60;206;101931;4375;108227;2042216;780532
2021-08-20;SIC;18798;9362;9436;9858;8674;266;0;ITG;ITG1;19;Sicilia;38.11569725;13.3623567;663;83;746;20519;21265;563;1508;233997;6201;261463;5573615;2114311
2021-08-20;PAB;3935;2075;1860;876;2975;84;0;ITH;ITH1;4;Provincia Autonoma Bolzano / Bozen;46.49933453;11.35662422;17;1;18;488;506;-24;3;72573;1184;74263;1794598;445318
2021-08-20;PAT;5233;2889;2344;1504;3625;104;0;ITH;ITH2;4;Provincia Autonoma Trento;46.06893511;11.12123097;21;1;22;434;456;9;18;45096;1363;46915;952965;266686
2021-08-20;PUG;18038;9399;8639;8313;8982;743;0;ITF;ITF4;16;Puglia;41.12559576;16.86736689;156;22;178;4301;4479;145;347;249703;6690;260872;3140186;1339336
2021-08-20;BAS;3123;1679;1444;1451;1593;79;0;ITF;ITF5;17;Basilicata;40.63947052;15.80514834;37;2;39;1206;1245;15;45;26494;596;28335;426588;224161
2021-08-20;MOL;2463;1296;1167;507;1936;20;0;ITF;ITF2;14;Molise;41.55774754;14.65916051;6;1;7;137;144;-16;3;13435;492;14071;256926;223478
2021-08-20;VDA;473;240;233;142;316;15;0;ITC;ITC2;2;Valle d'Aosta / Vallée d'Aoste;45.73750286;7.320149366;4;0;4;141;145;20;22;11311;473;11929;159035;76176
2021-08-20;LAZ;8447;4757;3690;2117;6229;101;0;ITI;ITI4;12;Lazio;41.89277044;12.48366722;528;67;595;16941;17536;-110;661;343898;8468;369902;8388310;4564368
2021-08-20;UMB;4348;2316;2032;2921;1281;146;0;ITI;ITI2;10;Umbria;43.10675841;12.38824698;45;4;49;2165;2214;43;135;56618;1426;60258;1673340;417601
2021-08-20;EMR;19754;10761;8993;10256;8524;974;0;ITH;ITH5;8;Emilia-Romagna;44.49436681;11.3417208;373;44;417;13523;13940;282;637;378462;13316;405718;7717406;1999197
2021-08-20;MAR;4964;2693;2271;2952;1687;325;0;ITI;ITI3;11;Marche;43.61675973;13.5188753;49;9;58;2941;2999;-47;156;102700;3044;108743;1421364;827709
2021-08-20;ABR;6048;3166;2882;2033;3883;132;0;ITF;ITF1;13;Abruzzo;42.35122196;13.39843823;57;11;68;2016;2084;57;143;73188;2519;77791;1942770;768115
2021-08-20;CAL;7577;3828;3749;3018;4466;93;0;ITF;ITF6;18;Calabria;38.90597598;16.59440194;124;9;133;3507;3640;77;282;69855;1294;74789;1048111;952329
2021-08-21;ABR;3840;2097;1743;1729;1989;122;0;ITF;ITF1;13;Abruzzo;42.35122196;13.39843823;60;11;71;2078;2149;65;154;73276;2519;77944;1949188;770289
2021-08-21;PAB;1707;919;788;589;1076;42;0;ITH;ITH1;4;Provincia Autonoma Bolzano / Bozen;46.49933453;11.35662422;17;1;18;517;535;29;39;72583;1184;74302;1801636;446318
2021-08-21;MOL;2171;1221;950;1102;1017;52;0;ITF;ITF2;14;Molise;41.55774754;14.65916051;7;1;8;146;154;10;11;13436;492;14082;257219;223766
2021-08-21;TOS;17990;9962;8028;8147;9462;381;0;ITI;ITI1;9;Toscana;43.76923077;11.25588885;333;41;374;11891;12265;-109;639;246518;6974;265757;5757051;2630471
2021-08-21;BAS;3268;1778;1490;1711;1461;96;0;ITF;ITF5;17;Basilicata;40.63947052;15.80514834;38;2;40;1225;1265;20;49;26523;596;28384;427377;224528
2021-08-21;UMB;2793;1465;1328;1613;1115;65;0;ITI;ITI2;10;Umbria;43.10675841;12.38824698;42;4;46;2059;2105;-109;163;56890;1426;60421;1679000;418232
2021-08-21;SIC;13739;7168;6571;6197;7353;189;0;ITG;ITG1;19;Sicilia;38.11569725;13.3623567;677;84;761;21868;22629;1364;1739;234360;6213;263202;5594427;2122236
2021-08-21;LAZ;10223;5880;4343;3213;6903;107;0;ITI;ITI4;12;Lazio;41.89277044;12.48366722;528;68;596;16884;17480;-56;553;344499;8476;370455;8388310;4564368
2021-08-21;SAR;5622;3056;2566;3639;1893;90;0;ITG;ITG2;20;Sardegna;39.21531192;9.110616306;190;20;210;7498;7708;85;313;59843;1556;69107;1634168;938601
2021-08-21;PIE;13349;7138;6211;7724;5090;535;0;ITC;ITC1;1;Piemonte;45.0732745;7.680687483;133;12;145;3436;3581;60;225;355091;11709;370381;5833892;2195708
2021-08-21;CAM;9803;5396;4407;4078;5344;381;0;ITF;ITF3;15;Campania;40.83956555;14.25084984;344;22;366;9115;9481;43;585;423934;7678;441093;5961792;3407615
2021-08-21;LOM;21337;11881;9456;9483;11079;775;0;ITC;ITC4;3;Lombardia;45.46679409;9.190347404;319;41;360;11772;12132;-46;540;818746;33878;864756;13213994;5065960
2021-08-21;EMR;19119;10700;8419;10445;7776;898;0;ITH;ITH5;8;Emilia-Romagna;44.49436681;11.3417208;376;46;422;13774;14196;256;622;378824;13318;406338;7745433;2000952
2021-08-21;CAL;3651;1862;1789;1441;2163;47;0;ITF;ITF6;18;Calabria;38.90597598;16.59440194;122;12;134;3704;3838;198;290;69945;1296;75079;1053101;956355
2021-08-21;VEN;12204;6884;5320;8297;3389;518;0;ITH;ITH3;5;Veneto;45.43490485;12.33845213;192;45;237;12457;12694;30;744;424683;11666;449043;10286052;1998933
2021-08-21;LIG;3080;1676;1404;903;2128;49;0;ITC;ITC3;7;Liguria;44.41149315;8.9326992;77;12;89;1898;1987;66;153;102016;4377;108380;2050441;783364
2021-08-21;MAR;2977;1664;1313;1492;1311;174;0;ITI;ITI3;11;Marche;43.61675973;13.5188753;49;9;58;2920;2978;-21;198;102918;3045;108941;1424115;829148
2021-08-21;PAT;1324;786;538;609;672;43;0;ITH;ITH2;4;Provincia Autonoma Trento;46.06893511;11.12123097;21;2;23;462;485;29;42;45109;1363;46957;956025;267910
2021-08-21;FVG;2898;1560;1338;283;2575;40;0;ITH;ITH4;6;Friuli-Venezia Giulia;45.6494354;13.76813649;30;9;39;899;938;-3;103;105077;3796;109811;2423961;742535
2021-08-21;VDA;443;221;222;94;331;18;0;ITC;ITC2;2;Valle d'Aosta / Vallée d'Aoste;45.73750286;7.320149366;4;0;4;148;152;7;23;11327;473;11952;159744;76634
2021-08-21;PUG;4320;2311;2009;1983;2101;236;0;ITF;ITF4;16;Puglia;41.12559576;16.86736689;163;24;187;4318;4505;26;364;250040;6691;261236;3157039;1341949
2021-08-22;CAL;1525;769;756;485;1021;19;0;ITF;ITF6;18;Calabria;38.90597598;16.59440194;118;12;130;3761;3891;53;213;70105;1296;75292;1054960;957834
2021-08-22;UMB;1470;773;697;479;977;14;0;ITI;ITI2;10;Umbria;43.10675841;12.38824698;49;4;53;2033;2086;-19;104;57013;1426;60525;1684395;418757
2021-08-22;SIC;10328;5502;4826;3912;6298;118;0;ITG;ITG1;19;Sicilia;38.11569725;13.3623567;704;84;788;22672;23460;831;1350;234873;6219;264552;5605642;2128723
2021-08-22;FVG;2072;1187;885;793;1240;39;0;ITH;ITH4;6;Friuli-Venezia Giulia;45.6494354;13.76813649;32;9;41;899;940;2;78;105152;3796;109888;2428502;744038
2021-08-22;PIE;9631;5261;4370;5144;4101;386;0;ITC;ITC1;1;Piemonte;45.0732745;7.680687483;140;12;152;3491;3643;62;177;355205;11710;370558;5845437;2199694
2021-08-22;LAZ;8785;5311;3474;2533;6165;87;0;ITI;ITI4;12;Lazio;41.89277044;12.48366722;506;69;575;16783;17358;-122;454;345075;8476;370909;8388310;4564368
2021-08-22;CAM;6812;3877;2935;2535;4129;148;0;ITF;ITF3;15;Campania;40.83956555;14.25084984;337;22;359;9175;9534;53;470;424350;7679;441563;5967210;3410479
2021-08-22;SAR;1162;650;512;403;756;3;0;ITG;ITG2;20;Sardegna;39.21531192;9.110616306;193;21;214;7631;7845;137;256;59959;1559;69363;1637122;941071
2021-08-22;VEN;9261;5053;4208;5885;3107;269;0;ITH;ITH3;5;Veneto;45.43490485;12.33845213;187;48;235;12428;12663;-31;420;425134;11666;449463;10316060;2001042
2021-08-22;PAT;411;246;165;225;170;16;0;ITH;ITH2;4;Provincia Autonoma Trento;46.06893511;11.12123097;23;2;25;460;485;0;56;45165;1363;47013;958983;269093
2021-08-22;TOS;18533;9970;8563;7311;10904;318;0;ITI;ITI1;9;Toscana;43.76923077;11.25588885;349;43;392;11873;12265;0;594;247111;6975;266351;5768964;2635378
2021-08-22;LIG;760;441;319;173;579;8;0;ITC;ITC3;7;Liguria;44.41149315;8.9326992;78;11;89;1902;1991;4;162;102173;4378;108542;2055977;785684
2021-08-22;LOM;18208;10165;8043;7599;10067;542;0;ITC;ITC4;3;Lombardia;45.46679409;9.190347404;311;41;352;11894;12246;114;406;819036;33880;865162;13243184;5073896
2021-08-22;PUG;1480;771;709;531;924;25;0;ITF;ITF4;16;Puglia;41.12559576;16.86736689;175;22;197;4428;4625;120;261;250178;6694;261497;3169665;1344127
2021-08-22;MOL;389;202;187;3;386;0;0;ITF;ITF2;14;Molise;41.55774754;14.65916051;5;1;6;146;152;-2;3;13441;492;14085;257506;224048
2021-08-22;PAB;995;548;447;293;685;17;0;ITH;ITH1;4;Provincia Autonoma Bolzano / Bozen;46.49933453;11.35662422;18;1;19;592;611;76;100;72607;1184;74402;1806802;447131
2021-08-22;MAR;109;60;49;75;26;8;0;ITI;ITI3;11;Marche;43.61675973;13.5188753;45;10;55;2881;2936;-42;140;103100;3045;109081;1426798;830647
2021-08-22;VDA;177;88;89;8;169;0;0;ITC;ITC2;2;Valle d'Aosta / Vallée d'Aoste;45.73750286;7.320149366;4;0;4;155;159;7;11;11331;473;11963;160345;76975
2021-08-22;ABR;1832;948;884;536;1243;53;0;ITF;ITF1;13;Abruzzo;42.35122196;13.39843823;62;12;74;2095;2169;20;101;73357;2519;78045;1955859;772670
2021-08-22;BAS;2443;1282;1161;1025;1370;48;0;ITF;ITF5;17;Basilicata;40.63947052;15.80514834;38;0;38;1242;1280;15;52;26559;597;28436;428627;225092
2021-08-22;EMR;16476;9048;7428;6741;9106;629;0;ITH;ITH5;8;Emilia-Romagna;44.49436681;11.3417208;387;47;434;14035;14469;273;555;379103;13321;406893;7765652;2002774
2021-08-23;MOL;1725;934;791;270;1442;13;0;ITF;ITF2;14;Molise;41.55774754;14.65916051;7;1;8;156;164;12;12;13441;492;14097;257898;224440
2021-08-23;MAR;6196;3341;2855;2278;3650;268;0;ITI;ITI3;11;Marche;43.61675973;13.5188753;44;13;57;2889;2946;10;34;103124;3045;109115;1427407;830921
2021-08-23;PUG;30476;15807;14669;10770;18828;878;0;ITF;ITF4;16;Puglia;41.12559576;16.86736689;186;22;208;4423;4631;6;144;250316;6694;261641;3176951;1345902
2021-08-23;PAB;2132;1204;928;772;1327;33;0;ITH;ITH1;4;Provincia Autonoma Bolzano / Bozen;46.49933453;11.35662422;19;1;20;570;590;-21;30;72658;1184;74432;1812346;448037
2021-08-23;BAS;3316;1736;1580;1369;1864;83;0;ITF;ITF5;17;Basilicata;40.63947052;15.80514834;39;0;39;1239;1278;-2;8;26569;597;28444;428972;225253
2021-08-23;ABR;5921;3109;2812;1656;4120;145;0;ITF;ITF1;13;Abruzzo;42.35122196;13.39843823;59;12;71;2160;2231;62;150;73445;2519;78195;1964210;775712
2021-08-23;PIE;18401;9895;8506;8865;8942;594;0;ITC;ITC1;1;Piemonte;45.0732745;7.680687483;143;12;155;3427;3582;-61;102;355367;11711;370660;5856179;2201913
2021-08-23;UMB;5294;2824;2470;1546;3664;84;0;ITI;ITI2;10;Umbria;43.10675841;12.38824698;52;4;56;2011;2067;-19;128;57159;1427;60653;1689633;419351
2021-08-23;VDA;404;205;199;91;299;14;0;ITC;ITC2;2;Valle d'Aosta / Vallée d'Aoste;45.73750286;7.320149366;3;0;3;159;162;3;5;11333;473;11968;161011;77351
2021-08-23;CAL;7682;3815;3867;2792;4783;107;0;ITF;ITF6;18;Calabria;38.90597598;16.59440194;123;8;131;3925;4056;165;257;70194;1299;75549;1057233;959542
2021-08-23;EMR;22626;11779;10847;11846;9481;1299;0;ITH;ITH5;8;Emilia-Romagna;44.49436681;11.3417208;402;52;454;14278;14732;263;558;379393;13324;407449;7778869;2004424
2021-08-23;LAZ;22846;12446;10400;16345;5487;1014;0;ITI;ITI4;12;Lazio;41.89277044;12.48366722;538;67;605;16472;17077;-281;348;345696;8484;371257;8388310;4564368
2021-08-23;LOM;57498;31501;25997;23770;30438;3290;0;ITC;ITC4;3;Lombardia;45.46679409;9.190347404;320;43;363;11938;12301;55;200;819181;33880;865362;13253673;5076404
2021-08-23;CAM;23725;12363;11362;9501;13352;872;0;ITF;ITF3;15;Campania;40.83956555;14.25084984;361;23;384;8986;9370;-164;190;424701;7682;441753;5981881;3411908
2021-08-23;VEN;24540;13042;11498;10600;13238;702;0;ITH;ITH3;5;Veneto;45.43490485;12.33845213;186;48;234;12605;12839;176;331;425289;11666;449794;10326391;2002227
2021-08-23;SIC;24079;11903;12176;10796;12932;351;0;ITG;ITG1;19;Sicilia;38.11569725;13.3623567;729;88;817;23329;24146;686;1121;235288;6239;265673;5618207;2133932
2021-08-23;LIG;10592;5528;5064;3534;6937;121;0;ITC;ITC3;7;Liguria;44.41149315;8.9326992;84;11;95;1931;2026;35;57;102195;4378;108599;2058400;786575
2021-08-23;SAR;10524;5565;4959;5634;4712;178;0;ITG;ITG2;20;Sardegna;39.21531192;9.110616306;197;22;219;7674;7893;48;311;60221;1560;69674;1639568;942534
2021-08-23;TOS;22759;11820;10939;11483;10544;732;0;ITI;ITI1;9;Toscana;43.76923077;11.25588885;366;41;407;11790;12197;-68;434;247610;6978;266785;5775547;2638370
2021-08-23;FVG;4794;2487;2307;2659;1786;349;0;ITH;ITH4;6;Friuli-Venezia Giulia;45.6494354;13.76813649;34;11;45;866;911;-29;25;105206;3796;109913;2429978;744368
2021-08-23;PAT;4346;2293;2053;1438;2740;168;0;ITH;ITH2;4;Provincia Autonoma Trento;46.06893511;11.12123097;21;2;23;448;471;-14;33;45211;1364;47046;961846;270238
2021-08-24;BAS;3269;1768;1501;1479;1713;77;0;ITF;ITF5;17;Basilicata;40.63947052;15.80514834;42;0;42;1262;1304;26;71;26614;597;28515;430095;225626
2021-08-24;CAM;22610;11705;10905;8652;13188;770;0;ITF;ITF3;15;Campania;40.83956555;14.25084984;366;20;386;8634;9020;-350;531;425569;7695;442284;6000894;3414599
2021-08-24;VEN;19915;10616;9299;8924;10462;529;0;ITH;ITH3;5;Veneto;45.43490485;12.33845213;188;51;239;12199;12438;-401;470;426158;11668;450264;10372091;2004830
2021-08-24;UMB;4440;2248;2192;1876;2476;88;0;ITI;ITI2;10;Umbria;43.10675841;12.38824698;53;4;57;1952;2009;-58;100;57317;1427;60753;1696117;419929
2021-08-24;PIE;15256;8142;7114;7882;6731;643;0;ITC;ITC1;1;Piemonte;45.0732745;7.680687483;142;9;151;3358;3509;-73;240;355680;11711;370900;5873423;2207036
2021-08-24;TOS;21910;11491;10419;12736;8308;866;0;ITI;ITI1;9;Toscana;43.76923077;11.25588885;385;41;426;11685;12111;-86;537;248225;6986;267322;5790304;2644322
2021-08-24;CAL;6509;3229;3280;2321;4103;85;0;ITF;ITF6;18;Calabria;38.90597598;16.59440194;125;10;135;3992;4127;71;234;70355;1301;75783;1059821;961841
2021-08-24;LIG;8754;4543;4211;2897;5755;102;0;ITC;ITC3;7;Liguria;44.41149315;8.9326992;85;10;95;1899;1994;-32;188;102413;4380;108787;2067075;789125
2021-08-24;PUG;25251;12958;12293;9418;15010;823;0;ITF;ITF4;16;Puglia;41.12559576;16.86736689;207;25;232;4340;4572;-59;173;250547;6695;261814;3192523;1348237
2021-08-24;MAR;6439;3401;3038;3297;2759;383;0;ITI;ITI3;11;Marche;43.61675973;13.5188753;55;11;66;2927;2993;47;120;103197;3045;109235;1430341;832448
2021-08-24;PAT;4615;2473;2142;1311;3208;96;0;ITH;ITH2;4;Provincia Autonoma Trento;46.06893511;11.12123097;23;2;25;460;485;14;48;45245;1364;47094;965045;271518
2021-08-24;EMR;23411;12713;10698;10527;11773;1111;0;ITH;ITH5;8;Emilia-Romagna;44.49436681;11.3417208;411;54;465;14377;14842;110;472;379745;13327;407914;7809660;2006685
2021-08-24;FVG;6660;3599;3061;765;5765;130;0;ITH;ITH4;6;Friuli-Venezia Giulia;45.6494354;13.76813649;31;11;42;901;943;32;99;105273;3796;110012;2437829;746033
2021-08-24;VDA;672;370;302;144;518;10;0;ITC;ITC2;2;Valle d'Aosta / Vallée d'Aoste;45.73750286;7.320149366;4;0;4;149;153;-9;7;11349;473;11975;161722;77742
2021-08-24;MOL;1717;928;789;264;1428;25;0;ITF;ITF2;14;Molise;41.55774754;14.65916051;7;1;8;182;190;26;28;13443;492;14125;258370;224908
2021-08-24;PAB;1973;1030;943;538;1399;36;0;ITH;ITH1;4;Provincia Autonoma Bolzano / Bozen;46.49933453;11.35662422;17;1;18;607;625;35;58;72681;1184;74490;1818006;448880
2021-08-24;SAR;10106;5403;4703;4812;5139;155;0;ITG;ITG2;20;Sardegna;39.21531192;9.110616306;224;22;246;7543;7789;-104;179;60503;1561;69853;1650412;945578
2021-08-24;LOM;47543;25870;21673;24445;19460;3638;0;ITC;ITC4;3;Lombardia;45.46679409;9.190347404;329;45;374;11962;12336;35;518;819657;33887;865880;13295296;5086331
2021-08-24;SIC;23728;11758;11970;10957;12401;370;0;ITG;ITG1;19;Sicilia;38.11569725;13.3623567;740;102;842;24105;24947;801;1491;235967;6250;267164;5638134;2142993
2021-08-24;LAZ;19009;10197;8812;11845;6438;726;0;ITI;ITI4;12;Lazio;41.89277044;12.48366722;524;68;592;16173;16765;-312;425;346427;8490;371682;8388310;4564368
2021-08-24;ABR;6360;3411;2949;1875;4332;153;0;ITF;ITF1;13;Abruzzo;42.35122196;13.39843823;61;12;73;2275;2348;117;117;73445;2519;78312;1972792;778667
2021-08-25;VEN;20105;10904;9201;8055;11478;572;0;ITH;ITH3;5;Veneto;45.43490485;12.33845213;179;45;224;12313;12537;99;847;426901;11673;451111;10413961;2007835
2021-08-25;PAT;4402;2350;2052;1102;3225;75;0;ITH;ITH2;4;Provincia Autonoma Trento;46.06893511;11.12123097;23;1;24;476;500;15;29;45259;1364;47123;968824;273029
2021-08-25;TOS;20323;10619;9704;10614;8980;729;0;ITI;ITI1;9;Toscana;43.76923077;11.25588885;379;40;419;11413;11832;-279;654;249151;6993;267976;5806068;2651389
2021-08-25;LIG;9369;5047;4322;3214;6029;126;0;ITC;ITC3;7;Liguria;44.41149315;8.9326992;75;11;86;1943;2029;35;212;102589;4381;108999;2074539;791186
2021-08-25;LOM;44522;24045;20477;21660;19756;3106;0;ITC;ITC4;3;Lombardia;45.46679409;9.190347404;340;43;383;11606;11989;-347;605;820604;33892;866485;13334324;5094911
2021-08-25;PAB;2747;1460;1287;778;1917;52;0;ITH;ITH1;4;Provincia Autonoma Bolzano / Bozen;46.49933453;11.35662422;17;1;18;651;669;44;65;72702;1184;74555;1827150;450166
2021-08-25;PUG;25817;13568;12249;10401;14479;937;0;ITF;ITF4;16;Puglia;41.12559576;16.86736689;217;25;242;4308;4550;-22;327;250894;6697;262141;3207447;1351682
2021-08-25;MAR;5585;2992;2593;2725;2539;321;0;ITI;ITI3;11;Marche;43.61675973;13.5188753;67;11;78;3094;3172;179;259;103277;3045;109494;1433634;834170
2021-08-25;EMR;25162;13559;11603;9577;14615;970;0;ITH;ITH5;8;Emilia-Romagna;44.49436681;11.3417208;410;55;465;14422;14887;45;412;380099;13334;408320;7836495;2009023
2021-08-25;ABR;7128;3796;3332;2375;4584;169;0;ITF;ITF1;13;Abruzzo;42.35122196;13.39843823;65;13;78;2175;2253;-95;11;73550;2520;78323;1974620;779303
2021-08-25;BAS;2682;1407;1275;1259;1339;84;0;ITF;ITF5;17;Basilicata;40.63947052;15.80514834;41;0;41;1296;1337;33;84;26665;597;28599;431658;226237
2021-08-25;VDA;682;348;334;128;528;26;0;ITC;ITC2;2;Valle d'Aosta / Vallée d'Aoste;45.73750286;7.320149366;5;0;5;142;147;-6;7;11362;473;11982;162424;78105
2021-08-25;CAL;8847;4331;4516;3324;5386;137;0;ITF;ITF6;18;Calabria;38.90597598;16.59440194;127;12;139;4189;4328;201;349;70503;1301;76132;1063626;964947
2021-08-25;SAR;10065;5292;4773;4241;5711;113;0;ITG;ITG2;20;Sardegna;39.21531192;9.110616306;225;24;249;7683;7932;143;487;60844;1564;70340;1658833;949767
2021-08-25;LAZ;31841;16729;15112;9872;21352;617;0;ITI;ITI4;12;Lazio;41.89277044;12.48366722;516;66;582;15919;16501;-264;442;347129;8494;372124;8388310;4564368
2021-08-25;UMB;4296;2237;2059;1546;2669;81;0;ITI;ITI2;10;Umbria;43.10675841;12.38824698;52;6;58;1900;1958;-51;116;57484;1427;60869;1702292;420426
2021-08-25;SIC;21844;10846;10998;9981;11498;365;0;ITG;ITG1;19;Sicilia;38.11569725;13.3623567;751;102;853;24653;25506;559;1409;236808;6259;268573;5659653;2151225
2021-08-25;FVG;7907;4232;3675;3086;4467;354;0;ITH;ITH4;6;Friuli-Venezia Giulia;45.6494354;13.76813649;28;11;39;1037;1076;133;222;105358;3797;110231;2445861;747750
2021-08-25;PIE;16467;8879;7588;8290;7447;730;0;ITC;ITC1;1;Piemonte;45.0732745;7.680687483;137;11;148;3311;3459;-50;262;355992;11711;371162;5887436;2211086
2021-08-25;CAM;22837;12020;10817;8686;13422;729;0;ITF;ITF3;15;Campania;40.83956555;14.25084984;346;18;364;8645;9009;-11;569;426135;7709;442853;6016881;3417648
2021-08-25;MOL;1506;810;696;344;1152;10;0;ITF;ITF2;14;Molise;41.55774754;14.65916051;6;1;7;175;182;-8;2;13453;492;14127;258649;225184
2021-08-26;BAS;2524;1278;1246;1121;1339;64;0;ITF;ITF5;17;Basilicata;40.63947052;15.80514834;39;0;39;1316;1355;18;48;26695;597;28647;432504;226586
2021-08-26;ABR;5805;3039;2766;2016;3637;152;0;ITF;ITF1;13;Abruzzo;42.35122196;13.39843823;68;13;81;2151;2232;-21;92;73670;2522;78424;1982115;781682
2021-08-26;VDA;343;168;175;82;254;7;0;ITC;ITC2;2;Valle d'Aosta / Vallée d'Aoste;45.73750286;7.320149366;5;0;5;142;147;0;0;11362;473;11982;162688;78204
2021-08-26;CAM;24538;12759;11779;8162;15531;845;0;ITF;ITF3;15;Campania;40.83956555;14.25084984;361;21;382;8795;9177;168;696;426661;7711;443549;6033096;3421020
2021-08-26;EMR;27641;14751;12890;9364;17313;964;0;ITH;ITH5;8;Emilia-Romagna;44.49436681;11.3417208;405;53;458;14565;15023;136;561;380517;13337;408877;7861639;2011378
2021-08-26;FVG;7542;4084;3458;1471;5836;235;0;ITH;ITH4;6;Friuli-Venezia Giulia;45.6494354;13.76813649;30;10;40;1013;1053;-23;36;105416;3797;110266;2449465;748737
2021-08-26;PIE;16937;9170;7767;8138;8037;762;0;ITC;ITC1;1;Piemonte;45.0732745;7.680687483;142;10;152;3435;3587;128;305;356167;11713;371467;5903628;2215687
2021-08-26;PAT;4139;2172;1967;1085;2950;104;0;ITH;ITH2;4;Provincia Autonoma Trento;46.06893511;11.12123097;26;0;26;480;506;6;48;45300;1365;47171;971999;274299
2021-08-26;LOM;38708;20785;17923;20357;15558;2793;0;ITC;ITC4;3;Lombardia;45.46679409;9.190347404;339;42;381;11662;12043;54;758;821302;33898;867243;13372497;5103485
2021-08-26;CAL;7211;3604;3607;3179;3909;123;0;ITF;ITF6;18;Calabria;38.90597598;16.59440194;133;13;146;4270;4416;88;281;70692;1305;76413;1066878;967640
2021-08-26;LIG;9065;4743;4322;2614;6368;83;0;ITC;ITC3;7;Liguria;44.41149315;8.9326992;72;10;82;1986;2068;39;139;102689;4381;109138;2081748;793385
2021-08-26;SAR;9428;4997;4431;5352;3949;127;0;ITG;ITG2;20;Sardegna;39.21531192;9.110616306;228;25;253;7762;8015;83;424;61183;1566;70764;1666877;953022
2021-08-26;UMB;4059;2150;1909;1789;2159;111;0;ITI;ITI2;10;Umbria;43.10675841;12.38824698;53;7;60;1827;1887;-71;7;57562;1427;60876;1703747;420584
2021-08-26;SIC;20017;10108;9909;9095;10610;312;0;ITG;ITG1;19;Sicilia;38.11569725;13.3623567;752;103;855;25255;26110;604;1097;237286;6274;269670;5676735;2158445
2021-08-26;LAZ;32294;16771;15523;8265;23464;565;0;ITI;ITI4;12;Lazio;41.89277044;12.48366722;508;67;575;15790;16365;-136;582;347842;8499;372706;8388310;4564368
2021-08-26;TOS;18596;9744;8852;9504;8370;722;0;ITI;ITI1;9;Toscana;43.76923077;11.25588885;397;43;440;11312;11752;-80;677;249906;6995;268653;5819712;2657817
2021-08-26;MAR;5682;3028;2654;2776;2546;360;0;ITI;ITI3;11;Marche;43.61675973;13.5188753;65;12;77;3274;3351;179;251;103349;3045;109745;1436543;835713
2021-08-26;VEN;22357;11913;10444;8348;13405;604;0;ITH;ITH3;5;Veneto;45.43490485;12.33845213;177;43;220;12399;12619;82;719;427537;11674;451830;10448581;2010425
2021-08-26;PUG;20353;10514;9839;8736;10742;875;0;ITF;ITF4;16;Puglia;41.12559576;16.86736689;228;24;252;4295;4547;-3;284;251180;6698;262425;3220912;1354413
2021-08-26;MOL;1727;936;791;309;1411;7;0;ITF;ITF2;14;Molise;41.55774754;14.65916051;5;1;6;183;189;7;9;13455;492;14136;259077;225597
2021-08-26;PAB;2242;1135;1107;831;1360;51;0;ITH;ITH1;4;Provincia Autonoma Bolzano / Bozen;46.49933453;11.35662422;18;2;20;624;644;-25;38;72765;1184;74593;1832670;450987
2021-08-27;LOM;35761;19232;16529;18546;14629;2586;0;ITC;ITC4;3;Lombardia;45.46679409;9.190347404;333;44;377;11552;11929;-114;601;822014;33901;867844;13408386;5111525
2021-08-27;PIE;17466;9328;8138;7528;9282;656;0;ITC;ITC1;1;Piemonte;45.0732745;7.680687483;144;12;156;3519;3675;88;302;356381;11713;371769;5925501;2220843
2021-08-27;UMB;4601;2418;2183;1499;3000;102;0;ITI;ITI2;10;Umbria;43.10675841;12.38824698;54;8;62;1857;1919;32;105;57634;1428;60981;1712314;421207
2021-08-27;SAR;8386;4496;3890;4909;3334;143;0;ITG;ITG2;20;Sardegna;39.21531192;9.110616306;233;24;257;7866;8123;108;343;61415;1569;71107;1673121;955968
2021-08-27;PAT;3812;2071;1741;943;2778;91;0;ITH;ITH2;4;Provincia Autonoma Trento;46.06893511;11.12123097;27;0;27;441;468;-38;17;45355;1365;47188;973106;274742
2021-08-27;TOS;16296;8714;7582;7751;8015;530;0;ITI;ITI1;9;Toscana;43.76923077;11.25588885;401;46;447;11139;11586;-166;752;250820;6999;269405;5834044;2664605
2021-08-27;VEN;26715;14294;12421;8252;17886;577;0;ITH;ITH3;5;Veneto;45.43490485;12.33845213;184;43;227;12453;12680;61;694;428168;11676;452524;10486994;2012957
2021-08-27;SIC;23374;11887;11487;9857;13189;328;0;ITG;ITG1;19;Sicilia;38.11569725;13.3623567;778;103;881;25644;26525;415;1681;238541;6285;271351;5699324;2167385
2021-08-27;LAZ;30744;16146;14598;7614;22558;572;0;ITI;ITI4;12;Lazio;41.89277044;12.48366722;488;70;558;15727;16285;-80;547;348467;8501;373253;8416565;4567568
2021-08-27;FVG;6190;3335;2855;1412;4569;209;0;ITH;ITH4;6;Friuli-Venezia Giulia;45.6494354;13.76813649;40;11;51;1108;1159;106;204;105512;3798;110469;2458942;750457
2021-08-27;EMR;27926;15027;12899;6955;20228;743;0;ITH;ITH5;8;Emilia-Romagna;44.49436681;11.3417208;420;51;471;14992;15463;440;732;380800;13344;409607;7887745;2013669
2021-08-27;CAM;24407;13016;11391;7823;15887;697;0;ITF;ITF3;15;Campania;40.83956555;14.25084984;350;21;371;8950;9321;144;576;427088;7716;444125;6047400;3422862
2021-08-27;PUG;23971;12582;11389;10052;12989;930;0;ITF;ITF4;16;Puglia;41.12559576;16.86736689;235;22;257;4339;4596;49;302;251430;6701;262727;3234160;1356639
2021-08-27;BAS;2480;1314;1166;999;1410;71;0;ITF;ITF5;17;Basilicata;40.63947052;15.80514834;42;0;42;1308;1350;-5;65;26765;597;28712;433761;227110
2021-08-27;ABR;7975;4204;3771;2470;5345;160;0;ITF;ITF1;13;Abruzzo;42.35122196;13.39843823;73;13;86;2144;2230;-2;120;73791;2523;78544;1988583;783646
2021-08-27;VDA;498;259;239;122;366;10;0;ITC;ITC2;2;Valle d'Aosta / Vallée d'Aoste;45.73750286;7.320149366;4;0;4;130;134;-13;4;11379;473;11986;163390;78536
2021-08-27;PAB;2733;1419;1314;910;1729;94;0;ITH;ITH1;4;Provincia Autonoma Bolzano / Bozen;46.49933453;11.35662422;20;3;23;604;627;-17;10;72792;1184;74603;1833755;451203
2021-08-27;MOL;2121;1091;1030;417;1682;22;0;ITF;ITF2;14;Molise;41.55774754;14.65916051;6;1;7;181;188;-1;3;13458;493;14139;259223;225742
2021-08-27;CAL;9165;4773;4392;3611;5392;162;0;ITF;ITF6;18;Calabria;38.90597598;16.59440194;143;14;157;4357;4514;98;313;70907;1305;76726;1070460;970663
2021-08-27;LIG;9220;4919;4301;2823;6307;90;0;ITC;ITC3;7;Liguria;44.41149315;8.9326992;75;11;86;1921;2007;-61;156;102906;4381;109294;2088030;795312
2021-08-27;MAR;5715;3050;2665;2800;2514;401;0;ITI;ITI3;11;Marche;43.61675973;13.5188753;69;12;81;3295;3376;25;222;103545;3046;109967;1438967;837024
2021-08-28;MOL;1743;972;771;658;1069;16;0;ITF;ITF2;14;Molise;41.55774754;14.65916051;8;1;9;174;183;-5;0;13462;494;14139;259501;226015
2021-08-28;PAB;3278;1841;1437;1025;2215;38;0;ITH;ITH1;4;Provincia Autonoma Bolzano / Bozen;46.49933453;11.35662422;18;3;21;647;668;41;83;72834;1184;74686;1840791;452163
2021-08-28;PUG;5733;3138;2595;2015;3530;188;0;ITF;ITF4;16;Puglia;41.12559576;16.86736689;238;22;260;4386;4646;50;304;251683;6702;263031;3249481;1359001
2021-08-28;ABR;2303;1332;971;698;1556;49;0;ITF;ITF1;13;Abruzzo;42.35122196;13.39843823;78;13;91;2112;2203;-27;98;73915;2523;78641;1994902;785531
2021-08-28;LAZ;32661;17051;15610;10990;20921;750;0;ITI;ITI4;12;Lazio;41.89277044;12.48366722;457;71;528;15591;16119;-166;447;349078;8503;373700;8432202;4569195
2021-08-28;SIC;20873;11179;9694;7257;13394;222;0;ITG;ITG1;19;Sicilia;38.11569725;13.3623567;798;104;902;26027;26929;404;1139;239257;6304;272490;5719440;2174622
2021-08-28;CAL;5312;2783;2529;1903;3316;93;0;ITF;ITF6;18;Calabria;38.90597598;16.59440194;150;15;165;4592;4757;243;358;71018;1309;77084;1073989;973104
2021-08-28;BAS;2276;1288;988;1111;1105;60;0;ITF;ITF5;17;Basilicata;40.63947052;15.80514834;45;0;45;1313;1358;8;55;26812;597;28767;434926;227687
2021-08-28;PAT;1348;829;519;555;756;37;0;ITH;ITH2;4;Provincia Autonoma Trento;46.06893511;11.12123097;30;0;30;469;499;31;44;45368;1365;47232;976632;276152
2021-08-28;EMR;26326;14569;11757;8638;16859;829;0;ITH;ITH5;8;Emilia-Romagna;44.49436681;11.3417208;403;46;449;15298;15747;284;686;381199;13347;410293;7920665;2015888
2021-08-28;VEN;20879;11595;9284;8658;11489;732;0;ITH;ITH3;5;Veneto;45.43490485;12.33845213;178;47;225;12584;12809;129;864;428898;11681;453388;10532660;2015263
2021-08-28;CAM;17710;9616;8094;5360;11842;508;0;ITF;ITF3;15;Campania;40.83956555;14.25084984;352;20;372;9263;9635;314;564;427335;7719;444689;6064405;3426171
2021-08-28;MAR;3145;1696;1449;1202;1799;144;0;ITI;ITI3;11;Marche;43.61675973;13.5188753;69;16;85;3439;3524;148;255;103652;3046;110222;1442031;838775
2021-08-28;SAR;4163;2396;1767;2853;1251;59;0;ITG;ITG2;20;Sardegna;39.21531192;9.110616306;240;20;260;7728;7988;-135;187;61734;1572;71294;1679823;958962
2021-08-28;LOM;35009;19241;15768;17760;15044;2205;0;ITC;ITC4;3;Lombardia;45.46679409;9.190347404;331;42;373;11575;11948;19;540;822527;33909;868384;13451984;5121923
2021-08-28;TOS;15804;8514;7290;6381;8969;454;0;ITI;ITI1;9;Toscana;43.76923077;11.25588885;413;47;460;11026;11486;-100;601;251517;7003;270006;5848555;2670792
2021-08-28;LIG;4136;2341;1795;1006;3100;30;0;ITC;ITC3;7;Liguria;44.41149315;8.9326992;77;12;89;1990;2079;72;172;103006;4381;109466;2095521;797903
2021-08-28;FVG;2901;1577;1324;1783;963;155;0;ITH;ITH4;6;Friuli-Venezia Giulia;45.6494354;13.76813649;40;11;51;1112;1163;4;114;105619;3799;110581;2467443;752737
2021-08-28;PIE;17537;9239;8298;7325;9568;644;0;ITC;ITC1;1;Piemonte;45.0732745;7.680687483;146;13;159;3542;3701;26;240;356595;11713;372009;5952144;2227870
2021-08-28;VDA;536;285;251;90;424;22;0;ITC;ITC2;2;Valle d'Aosta / Vallée d'Aoste;45.73750286;7.320149366;3;0;3;135;138;4;11;11386;473;11997;163983;78805
2021-08-28;UMB;2771;1429;1342;1358;1342;71;0;ITI;ITI2;10;Umbria;43.10675841;12.38824698;54;8;62;1772;1834;-85;129;57848;1428;61110;1718199;421892
2021-08-29;FVG;3160;1781;1379;1801;1260;99;0;ITH;ITH4;6;Friuli-Venezia Giulia;45.6494354;13.76813649;46;11;57;1111;1168;5;80;105694;3799;110661;2472781;754244
2021-08-29;CAM;10263;5576;4687;3710;6278;275;0;ITF;ITF3;15;Campania;40.83956555;14.25084984;358;19;377;9247;9624;-11;431;427776;7720;445120;6080057;3428819
2021-08-29;SIC;14524;7926;6598;4754;9624;146;0;ITG;ITG1;19;Sicilia;38.11569725;13.3623567;806;108;914;26510;27424;495;1369;240121;6314;273859;5732946;2181456
2021-08-29;UMB;1947;1004;943;684;1254;9;0;ITI;ITI2;10;Umbria;43.10675841;12.38824698;54;8;62;1788;1850;16;164;57996;1428;61274;1723258;422462
2021-08-29;EMR;20644;11428;9216;8527;11266;851;0;ITH;ITH5;8;Emilia-Romagna;44.49436681;11.3417208;411;48;459;15558;16017;270;605;381523;13353;410893;7943179;2017768
2021-08-29;CAL;1684;888;796;720;933;31;0;ITF;ITF6;18;Calabria;38.90597598;16.59440194;153;16;169;4782;4951;194;240;71064;1309;77324;1076812;975186
2021-08-29;LOM;25186;13531;11655;12725;11159;1302;0;ITC;ITC4;3;Lombardia;45.46679409;9.190347404;332;45;377;11770;12147;199;447;822770;33914;868831;13486574;5131575
2021-08-29;MOL;1432;781;651;111;1312;9;0;ITF;ITF2;14;Molise;41.55774754;14.65916051;8;1;9;176;185;2;21;13481;494;14160;260236;226735
2021-08-29;LAZ;27458;13974;13484;8968;17887;603;0;ITI;ITI4;12;Lazio;41.89277044;12.48366722;441;72;513;15409;15922;-197;349;349619;8508;374049;8449810;4571716
2021-08-29;PIE;15161;8124;7037;5049;9675;437;0;ITC;ITC1;1;Piemonte;45.0732745;7.680687483;145;14;159;3628;3787;86;175;356683;11714;372184;5964345;2232200
2021-08-29;PAT;617;347;270;313;279;25;0;ITH;ITH2;4;Provincia Autonoma Trento;46.06893511;11.12123097;28;0;28;443;471;-28;46;45442;1365;47278;979691;277376
2021-08-29;SAR;467;250;217;355;98;14;0;ITG;ITG2;20;Sardegna;39.21531192;9.110616306;237;21;258;7782;8040;52;283;61964;1573;71577;1683093;961570
2021-08-29;LIG;738;420;318;172;562;4;0;ITC;ITC3;7;Liguria;44.41149315;8.9326992;76;10;86;1998;2084;5;167;103167;4382;109633;2101879;800240
2021-08-29;TOS;17006;8991;8015;7585;8838;583;0;ITI;ITI1;9;Toscana;43.76923077;11.25588885;419;53;472;11108;11580;94;528;251949;7005;270534;5862851;2677808
2021-08-29;PAB;872;481;391;356;499;17;0;ITH;ITH1;4;Provincia Autonoma Bolzano / Bozen;46.49933453;11.35662422;19;3;22;700;722;54;81;72861;1184;74767;1845953;452892
2021-08-29;PUG;1289;665;624;421;840;28;0;ITF;ITF4;16;Puglia;41.12559576;16.86736689;241;25;266;4417;4683;37;198;251843;6703;263229;3259637;1361185
2021-08-29;VDA;209;120;89;6;202;1;0;ITC;ITC2;2;Valle d'Aosta / Vallée d'Aoste;45.73750286;7.320149366;3;0;3;137;140;2;7;11391;473;12004;164494;79052
2021-08-29;MAR;453;255;198;245;182;26;0;ITI;ITI3;11;Marche;43.61675973;13.5188753;66;16;82;3526;3608;84;147;103715;3046;110369;1444852;840323
2021-08-29;BAS;2337;1254;1083;1258;979;100;0;ITF;ITF5;17;Basilicata;40.63947052;15.80514834;47;0;47;1326;1373;15;72;26869;597;28839;436160;228142
2021-08-29;ABR;1467;876;591;522;931;14;0;ITF;ITF1;13;Abruzzo;42.35122196;13.39843823;73;14;87;2081;2168;-35;87;74035;2525;78728;2000877;787452
2021-08-29;VEN;13414;7361;6053;4512;8582;320;0;ITH;ITH3;5;Veneto;45.43490485;12.33845213;173;48;221;12718;12939;130;513;429279;11683;453901;10566252;2017486
2021-08-30;LIG;9794;5233;4561;2458;7244;92;0;ITC;ITC3;7;Liguria;44.41149315;8.9326992;76;11;87;2011;2098;14;52;103203;4384;109685;2104187;800995
2021-08-30;MAR;5677;2841;2836;2358;3049;270;0;ITI;ITI3;11;Marche;43.61675973;13.5188753;64;17;81;3503;3584;-24;46;103785;3046;110415;1445576;840623
2021-08-30;PUG;28610;14905;13705;11597;15987;1026;0;ITF;ITF4;16;Puglia;41.12559576;16.86736689;251;24;275;4426;4701;18;105;251927;6706;263334;3266269;1362885
2021-08-30;PAB;2149;1132;1017;818;1297;34;0;ITH;ITH1;4;Provincia Autonoma Bolzano / Bozen;46.49933453;11.35662422;16;5;21;687;708;-14;46;72921;1184;74813;1851216;453733
2021-08-30;VDA;549;278;271;115;396;38;0;ITC;ITC2;2;Valle d'Aosta / Vallée d'Aoste;45.73750286;7.320149366;2;0;2;126;128;-12;1;11404;473;12005;165008;79327
2021-08-30;MOL;1701;915;786;230;1452;19;0;ITF;ITF2;14;Molise;41.55774754;14.65916051;7;1;8;170;178;-7;4;13492;494;14164;260630;227127
2021-08-30;CAL;9371;4707;4664;3141;6104;126;0;ITF;ITF6;18;Calabria;38.90597598;16.59440194;158;16;174;4672;4846;-105;190;71356;1312;77514;1079286;977324
2021-08-30;BAS;3201;1713;1488;1551;1546;104;0;ITF;ITF5;17;Basilicata;40.63947052;15.80514834;47;1;48;1317;1365;-8;2;26877;599;28841;436507;228288
2021-08-30;ABR;7420;4057;3363;1942;5346;132;0;ITF;ITF1;13;Abruzzo;42.35122196;13.39843823;76;13;89;2107;2196;28;111;74118;2525;78839;2010157;790303
2021-08-30;SAR;8752;4669;4083;4835;3759;158;0;ITG;ITG2;20;Sardegna;39.21531192;9.110616306;227;27;254;7655;7909;-131;187;62279;1576;71764;1685726;963050
2021-08-30;VEN;26953;14290;12663;7997;18341;615;0;ITH;ITH3;5;Veneto;45.43490485;12.33845213;182;52;234;12852;13086;147;319;429451;11683;454220;10576977;2018606
2021-08-30;TOS;24824;12561;12263;13145;10550;1129;0;ITI;ITI1;9;Toscana;43.76923077;11.25588885;424;54;478;10938;11416;-164;348;252458;7008;270882;5869537;2680644
2021-08-30;UMB;1953;953;1000;1499;372;82;0;ITI;ITI2;10;Umbria;43.10675841;12.38824698;51;8;59;1739;1798;-52;86;58134;1428;61360;1728716;423005
2021-08-30;EMR;27050;14203;12847;7649;18372;1029;0;ITH;ITH5;8;Emilia-Romagna;44.49436681;11.3417208;420;49;469;15640;16109;92;546;381967;13360;411436;7955346;2018915
2021-08-30;CAM;29112;15016;14096;9721;18550;841;0;ITF;ITF3;15;Campania;40.83956555;14.25084984;366;18;384;9015;9399;-225;186;428178;7729;445306;6085253;3429721
2021-08-30;LAZ;30627;15486;15141;9946;19970;711;0;ITI;ITI4;12;Lazio;41.89277044;12.48366722;478;70;548;15290;15838;-84;321;350020;8512;374370;8469138;4574896
2021-08-30;LOM;71243;37849;33394;43169;22415;5659;0;ITC;ITC4;3;Lombardia;45.46679409;9.190347404;341;48;389;11780;12169;22;140;822887;33915;868971;13496096;5134075
2021-08-30;SIC;28227;14393;13834;10214;17667;346;0;ITG;ITG1;19;Sicilia;38.11569725;13.3623567;831;116;947;27542;28489;1065;1600;240647;6323;275459;5744189;2188272
2021-08-30;PAT;3907;1989;1918;1190;2600;117;0;ITH;ITH2;4;Provincia Autonoma Trento;46.06893511;11.12123097;25;0;25;472;497;26;44;45460;1365;47322;982618;278547
2021-08-30;FVG;7357;3919;3438;2488;4640;229;0;ITH;ITH4;6;Friuli-Venezia Giulia;45.6494354;13.76813649;49;13;62;1099;1161;-7;38;105737;3801;110699;2474268;754537
2021-08-30;PIE;20960;10956;10004;7242;13036;682;0;ITC;ITC1;1;Piemonte;45.0732745;7.680687483;155;14;169;3509;3678;-109;103;356893;11716;372287;5977305;2234790
2021-08-31;VDA;672;344;328;135;531;6;0;ITC;ITC2;2;Valle d'Aosta / Vallée d'Aoste;45.73750286;7.320149366;2;0;2;120;122;-6;4;11414;473;12009;165690;79639
2021-08-31;PIE;19069;10058;9011;6842;11659;568;0;ITC;ITC1;1;Piemonte;45.0732745;7.680687483;153;14;167;3443;3610;-68;220;357180;11717;372507;5997362;2240361
2021-08-31;CAL;6831;3379;3452;2673;4031;127;0;ITF;ITF6;18;Calabria;38.90597598;16.59440194;161;15;176;4636;4812;-34;195;71582;1315;77709;1083310;980581
2021-08-31;UMB;4137;2139;1998;1223;2844;70;0;ITI;ITI2;10;Umbria;43.10675841;12.38824698;45;7;52;1732;1784;-14;109;58256;1429;61469;1735691;423563
2021-08-31;EMR;28082;14972;13110;8336;18685;1061;0;ITH;ITH5;8;Emilia-Romagna;44.49436681;11.3417208;403;50;453;15448;15901;-208;455;382618;13369;411888;7987696;2021251
2021-08-31;CAM;27779;13966;13813;10808;15976;995;0;ITF;ITF3;15;Campania;40.83956555;14.25084984;379;23;402;8673;9075;-324;471;428961;7741;445777;6106249;3432682
2021-08-31;SIC;27981;14182;13799;10312;17370;299;0;ITG;ITG1;19;Sicilia;38.11569725;13.3623567;824;117;941;27502;28443;-46;1091;241765;6342;276550;5765302;2196652
2021-08-31;FVG;7571;4051;3520;1356;6024;191;0;ITH;ITH4;6;Friuli-Venezia Giulia;45.6494354;13.76813649;49;13;62;1146;1208;47;112;105799;3801;110808;2481874;756238
2021-08-31;MAR;4830;2563;2267;2014;2587;229;0;ITI;ITI3;11;Marche;43.61675973;13.5188753;59;20;79;3417;3496;-88;102;103975;3046;110517;1448561;842149
2021-08-31;LIG;9558;5056;4502;2634;6850;74;0;ITC;ITC3;7;Liguria;44.41149315;8.9326992;76;11;87;1846;1933;-165;120;103487;4385;109805;2112944;803248
2021-08-31;PAT;4418;2300;2118;1261;3054;103;0;ITH;ITH2;4;Provincia Autonoma Trento;46.06893511;11.12123097;28;0;28;445;473;-24;37;45521;1365;47359;985880;279852
2021-08-31;PUG;24927;12849;12078;8350;15726;851;0;ITF;ITF4;16;Puglia;41.12559576;16.86736689;236;17;253;4348;4601;-100;220;252241;6712;263554;3279777;1364933
2021-08-31;VEN;19815;10471;9344;7004;12217;594;0;ITH;ITH3;5;Veneto;45.43490485;12.33845213;199;49;248;12656;12904;-182;583;430213;11686;454803;10623011;2021143
2021-08-31;TOS;20937;10906;10031;11390;8797;750;0;ITI;ITI1;9;Toscana;43.76923077;11.25588885;419;54;473;10656;11129;-287;383;253123;7013;271265;5885973;2687475
2021-08-31;PAB;2033;1096;937;745;1260;28;0;ITH;ITH1;4;Provincia Autonoma Bolzano / Bozen;46.49933453;11.35662422;17;5;22;717;739;31;74;72964;1184;74887;1856727;454451
2021-08-31;MOL;1747;955;792;313;1424;10;0;ITF;ITF2;14;Molise;41.55774754;14.65916051;8;0;8;215;223;45;51;13497;495;14215;261115;227601
2021-08-31;BAS;3100;1594;1506;1679;1276;145;0;ITF;ITF5;17;Basilicata;40.63947052;15.80514834;48;1;49;1367;1416;51;98;26924;599;28939;437879;228754
2021-08-31;LAZ;31191;15439;15752;11623;18609;959;0;ITI;ITI4;12;Lazio;41.89277044;12.48366722;462;72;534;14757;15291;-547;283;350845;8517;374653;8493297;4577580
2021-08-31;SAR;9302;4961;4341;4750;4392;160;0;ITG;ITG2;20;Sardegna;39.21531192;9.110616306;240;27;267;7403;7670;-239;220;62734;1580;71984;1696609;966326
2021-08-31;LOM;62836;33495;29341;36691;21591;4554;0;ITC;ITC4;3;Lombardia;45.46679409;9.190347404;353;45;398;10615;11013;-1156;723;824764;33917;869694;13548489;5146203
2021-08-31;ABR;6380;3467;2913;1675;4595;110;0;ITF;ITF1;13;Abruzzo;42.35122196;13.39843823;80;7;87;2246;2333;137;140;74119;2527;78979;2019331;793088
2021-09-01;PIE;18716;9677;9039;6739;11266;711;0;ITC;ITC1;1;Piemonte;45.0732745;7.680687483;163;17;180;3393;3573;-37;259;357476;11717;372766;6018771;2247226
2021-09-01;LOM;60240;32367;27873;30540;25968;3732;0;ITC;ITC4;3;Lombardia;45.46679409;9.190347404;359;46;405;10675;11080;67;688;825379;33923;870382;13598733;5158671
2021-09-01;SAR;8248;4308;3940;3117;5041;90;0;ITG;ITG2;20;Sardegna;39.21531192;9.110616306;230;24;254;7281;7535;-135;389;63255;1583;72373;1704886;970168
2021-09-01;PAT;3929;2092;1837;837;3014;78;0;ITH;ITH2;4;Provincia Autonoma Trento;46.06893511;11.12123097;24;0;24;441;465;-8;47;45576;1365;47406;990232;281592
2021-09-01;TOS;23621;12431;11190;13386;9190;1043;2;ITI;ITI1;9;Toscana;43.76923077;11.25588885;415;51;466;10515;10981;-148;538;253802;7020;271803;5901964;2694162
2021-09-01;VEN;21058;10774;10284;7645;12663;750;0;ITH;ITH3;5;Veneto;45.43490485;12.33845213;200;50;250;12545;12795;-109;691;431010;11689;455494;10669042;2024245
2021-09-01;LIG;8509;4483;4026;2700;5724;85;0;ITC;ITC3;7;Liguria;44.41149315;8.9326992;75;9;84;1828;1912;-21;137;103644;4386;109942;2121307;805456
2021-09-01;MOL;1849;977;872;395;1434;20;0;ITF;ITF2;14;Molise;41.55774754;14.65916051;8;0;8;223;231;8;10;13499;495;14225;261437;227921
2021-09-01;MAR;6206;3281;2925;2021;3952;233;0;ITI;ITI3;11;Marche;43.61675973;13.5188753;68;19;87;3332;3419;-77;169;104221;3046;110686;1451838;843760
2021-09-01;PUG;24869;12899;11970;9886;13916;1067;0;ITF;ITF4;16;Puglia;41.12559576;16.86736689;234;20;254;4246;4500;-101;298;252639;6713;263852;3296650;1368418
2021-09-01;VDA;800;428;372;187;586;27;0;ITC;ITC2;2;Valle d'Aosta / Vallée d'Aoste;45.73750286;7.320149366;0;0;0;120;120;-2;3;11419;473;12012;166375;79990
2021-09-01;UMB;4600;2371;2229;1136;3405;59;0;ITI;ITI2;10;Umbria;43.10675841;12.38824698;51;7;58;1713;1771;-13;115;58384;1429;61584;1743002;424125
2021-09-01;ABR;6847;3641;3206;1560;5182;105;0;ITF;ITF1;13;Abruzzo;42.35122196;13.39843823;88;7;95;2192;2287;-46;20;74182;2529;78998;2021045;793604
2021-09-01;BAS;3248;1683;1565;1045;2104;99;0;ITF;ITF5;17;Basilicata;40.63947052;15.80514834;44;2;46;1384;1430;14;79;26989;599;29018;438952;229142
2021-09-01;EMR;22632;12064;10568;7199;14679;754;0;ITH;ITH5;8;Emilia-Romagna;44.49436681;11.3417208;387;51;438;15295;15733;-168;383;383164;13372;412269;8018420;2023694
2021-09-01;FVG;8612;4718;3894;2159;6244;209;0;ITH;ITH4;6;Friuli-Venezia Giulia;45.6494354;13.76813649;53;12;65;1124;1189;-19;141;105952;3803;110944;2491806;758234
2021-09-01;SIC;24949;12719;12230;10579;14013;357;0;ITG;ITG1;19;Sicilia;38.11569725;13.3623567;836;114;950;27350;28300;-143;1155;243036;6369;277705;5786261;2205304
2021-09-01;LAZ;26541;13613;12928;8174;17836;531;0;ITI;ITI4;12;Lazio;41.89277044;12.48366722;448;71;519;14281;14800;-491;350;351683;8520;375003;8514631;4579363
2021-09-01;CAM;27217;13716;13501;10221;16120;876;0;ITF;ITF3;15;Campania;40.83956555;14.25084984;373;22;395;8616;9011;-64;491;429505;7752;446268;6125635;3436365
2021-09-01;CAL;9142;4694;4448;3498;5497;147;0;ITF;ITF6;18;Calabria;38.90597598;16.59440194;162;16;178;4702;4880;68;339;71852;1316;78048;1087041;983614
2021-09-01;PAB;1062;507;555;587;454;21;0;ITH;ITH1;4;Provincia Autonoma Bolzano / Bozen;46.49933453;11.35662422;19;5;24;717;741;2;53;73015;1184;74940;1866711;455812
2021-09-02;BAS;3032;1624;1408;881;2073;78;0;ITF;ITF5;17;Basilicata;40.63947052;15.80514834;42;2;44;1356;1400;-30;39;27058;599;29057;440032;229541
2021-09-02;VDA;520;271;249;88;416;16;0;ITC;ITC2;2;Valle d'Aosta / Vallée d'Aoste;45.73750286;7.320149366;0;0;0;119;119;-1;0;11420;473;12012;166505;80059
2021-09-02;UMB;4362;2269;2093;959;3362;41;0;ITI;ITI2;10;Umbria;43.10675841;12.38824698;51;6;57;1671;1728;-43;28;58454;1430;61612;1744472;424267
2021-09-02;VEN;22817;12191;10626;6140;15867;810;0;ITH;ITH3;5;Veneto;45.43490485;12.33845213;198;52;250;12806;13056;261;844;431591;11691;456338;10711967;2027033
2021-09-02;ABR;6106;3194;2912;1864;4112;130;0;ITF;ITF1;13;Abruzzo;42.35122196;13.39843823;89;7;96;2105;2201;-86;57;74325;2529;79055;2027980;795590
2021-09-02;PAT;3359;1757;1602;955;2354;50;0;ITH;ITH2;4;Provincia Autonoma Trento;46.06893511;11.12123097;25;0;25;477;502;37;45;45584;1365;47451;994012;283104
2021-09-02;TOS;18128;9455;8673;11085;6125;917;1;ITI;ITI1;9;Toscana;43.76923077;11.25588885;405;56;461;10460;10921;-60;615;254472;7025;272418;5920388;2701365
2021-09-02;FVG;7003;3812;3191;1953;4807;243;0;ITH;ITH4;6;Friuli-Venezia Giulia;45.6494354;13.76813649;53;12;65;1217;1282;93;186;106044;3804;111130;2499426;760074
2021-09-02;EMR;25055;13346;11709;6480;17863;712;0;ITH;ITH5;8;Emilia-Romagna;44.49436681;11.3417208;388;48;436;15521;15957;224;529;383462;13372;412791;8046529;2026128
2021-09-02;PIE;16907;8805;8102;6168;10092;647;0;ITC;ITC1;1;Piemonte;45.0732745;7.680687483;158;20;178;3459;3637;64;255;357664;11720;373021;6038669;2253396
2021-09-02;SAR;10329;5548;4781;3973;6244;112;0;ITG;ITG2;20;Sardegna;39.21531192;9.110616306;228;23;251;7036;7287;-248;268;63767;1587;72641;1713245;973370
2021-09-02;CAL;7549;3921;3628;3165;4262;122;0;ITF;ITF6;18;Calabria;38.90597598;16.59440194;171;15;186;4837;5023;143;324;72029;1320;78372;1090797;986454
2021-09-02;MOL;1532;794;738;306;1200;26;0;ITF;ITF2;14;Molise;41.55774754;14.65916051;8;0;8;241;249;18;20;13501;495;14245;261837;228307
2021-09-02;MAR;6388;3401;2987;2129;4045;214;0;ITI;ITI3;11;Marche;43.61675973;13.5188753;68;19;87;3350;3437;18;224;104426;3047;110910;1454796;845380
2021-09-02;CAM;25523;13190;12333;10136;14456;931;0;ITF;ITF3;15;Campania;40.83956555;14.25084984;363;26;389;8519;8908;-103;461;430060;7761;446729;6144518;3440548
2021-09-02;LOM;56496;30568;25928;25789;27709;2998;0;ITC;ITC4;3;Lombardia;45.46679409;9.190347404;348;50;398;10720;11118;38;656;825993;33927;871038;13646663;5170681
2021-09-02;LIG;8458;4510;3948;2835;5522;101;0;ITC;ITC3;7;Liguria;44.41149315;8.9326992;72;10;82;1868;1950;38;168;103774;4386;110110;2128778;807646
2021-09-02;PUG;23228;12079;11149;7454;14903;871;0;ITF;ITF4;16;Puglia;41.12559576;16.86736689;232;24;256;4163;4419;-81;209;252928;6714;264061;3312305;1371570
2021-09-02;LAZ;26316;13513;12803;7997;17865;454;0;ITI;ITI4;12;Lazio;41.89277044;12.48366722;450;66;516;14311;14827;27;404;352056;8524;375407;8533787;4581977
2021-09-02;SIC;23148;11848;11300;10014;12744;390;0;ITG;ITG1;19;Sicilia;38.11569725;13.3623567;849;118;967;27158;28125;-175;1182;244370;6392;278887;5808957;2213756
2021-09-02;PAB;1212;630;582;708;467;37;0;ITH;ITH1;4;Provincia Autonoma Bolzano / Bozen;46.49933453;11.35662422;18;5;23;702;725;-16;32;73063;1184;74972;1872488;456512
2021-09-03;EMR;23781;12798;10983;6336;16853;592;0;ITH;ITH5;8;Emilia-Romagna;44.49436681;11.3417208;395;49;444;16045;16489;532;721;383644;13375;413508;8080019;2028298
2021-09-03;FVG;4062;2110;1952;2047;1749;266;0;ITH;ITH4;6;Friuli-Venezia Giulia;45.6494354;13.76813649;53;13;66;1259;1325;43;138;106138;3804;111267;2507215;761669
2021-09-03;LAZ;26036;13588;12448;7323;18223;490;0;ITI;ITI4;12;Lazio;41.89277044;12.48366722;446;67;513;14147;14660;-167;430;352645;8532;375837;8553405;4584574
2021-09-03;PIE;18439;9736;8703;6457;11319;663;0;ITC;ITC1;1;Piemonte;45.0732745;7.680687483;159;20;179;3538;3717;80;286;357870;11720;373307;6067269;2259618
2021-09-03;PAT;3495;1913;1582;789;2655;51;0;ITH;ITH2;4;Provincia Autonoma Trento;46.06893511;11.12123097;26;0;26;460;486;-16;13;45613;1365;47464;995082;283532
2021-09-03;SAR;8712;4696;4016;3080;5538;94;0;ITG;ITG2;20;Sardegna;39.21531192;9.110616306;227;24;251;6835;7086;-201;269;64236;1588;72910;1721567;976477
2021-09-03;LOM;52949;28460;24489;22736;27562;2651;0;ITC;ITC4;3;Lombardia;45.46679409;9.190347404;352;51;403;10611;11014;-104;647;826742;33929;871685;13691933;5181406
2021-09-03;CAL;9070;4633;4437;3575;5303;192;0;ITF;ITF6;18;Calabria;38.90597598;16.59440194;171;14;185;4886;5071;48;298;72272;1327;78670;1094643;989611
2021-09-03;SIC;21896;11060;10836;9917;11605;374;0;ITG;ITG1;19;Sicilia;38.11569725;13.3623567;842;115;957;27173;28130;5;1348;245692;6413;280235;5830935;2223120
2021-09-03;UMB;4234;2193;2041;1320;2854;60;0;ITI;ITI2;10;Umbria;43.10675841;12.38824698;48;6;54;1630;1684;-44;74;58569;1433;61686;1751605;424921
2021-09-03;CAM;26494;13637;12857;10795;14774;925;0;ITF;ITF3;15;Campania;40.83956555;14.25084984;347;25;372;8465;8837;-71;369;430495;7766;447098;6162109;3443939
2021-09-03;VEN;32114;17191;14923;7569;23747;798;0;ITH;ITH3;5;Veneto;45.43490485;12.33845213;193;50;243;12836;13079;23;637;432203;11693;456975;10753397;2029589
2021-09-03;PUG;21460;11089;10371;8482;11785;1193;0;ITF;ITF4;16;Puglia;41.12559576;16.86736689;228;20;248;4135;4383;-36;338;253299;6717;264399;3327048;1374596
2021-09-03;PAB;3233;1711;1522;1056;2114;63;0;ITH;ITH1;4;Provincia Autonoma Bolzano / Bozen;46.49933453;11.35662422;21;5;26;665;691;-34;9;73106;1184;74981;1873312;456670
2021-09-03;ABR;5937;3186;2751;1826;3980;131;0;ITF;ITF1;13;Abruzzo;42.35122196;13.39843823;87;6;93;2138;2231;30;110;74404;2530;79165;2035624;797502
2021-09-03;TOS;14194;7414;6780;7561;5925;707;1;ITI;ITI1;9;Toscana;43.76923077;11.25588885;397;59;456;10390;10846;-75;525;255070;7027;272943;5938624;2707661
2021-09-03;BAS;2863;1522;1341;762;2038;63;0;ITF;ITF5;17;Basilicata;40.63947052;15.80514834;44;3;47;1372;1419;19;61;27099;600;29118;441092;229913
2021-09-03;VDA;534;283;251;139;369;26;0;ITC;ITC2;2;Valle d'Aosta / Vallée d'Aoste;45.73750286;7.320149366;0;0;0;110;110;-9;7;11436;473;12019;167154;80339
2021-09-03;MOL;1692;880;812;358;1311;23;0;ITF;ITF2;14;Molise;41.55774754;14.65916051;9;0;9;225;234;-15;4;13520;495;14249;262000;228467
2021-09-03;MAR;6437;3384;3053;2190;3967;280;0;ITI;ITI3;11;Marche;43.61675973;13.5188753;59;20;79;3381;3460;23;172;104574;3048;111082;1457542;846903
2021-09-03;LIG;7378;4068;3310;2180;5096;102;0;ITC;ITC3;7;Liguria;44.41149315;8.9326992;70;10;80;1925;2005;55;159;103877;4387;110269;2136038;809610
2021-09-04;MOL;1639;904;735;686;931;22;0;ITF;ITF2;14;Molise;41.55774754;14.65916051;8;0;8;225;233;-1;0;13521;495;14249;262250;228716
2021-09-04;MAR;5447;2974;2473;1638;3623;186;0;ITI;ITI3;11;Marche;43.61675973;13.5188753;58;22;80;3406;3486;26;171;104718;3049;111253;1460443;848402
2021-09-04;PAB;1359;715;644;572;748;39;0;ITH;ITH1;4;Provincia Autonoma Bolzano / Bozen;46.49933453;11.35662422;21;3;24;676;700;9;59;73155;1185;75040;1880383;457759
2021-09-04;PUG;5537;2997;2540;1648;3709;180;0;ITF;ITF4;16;Puglia;41.12559576;16.86736689;230;20;250;4073;4323;-60;228;253582;6722;264627;3343272;1376898
2021-09-04;VDA;513;271;242;130;368;15;0;ITC;ITC2;2;Valle d'Aosta / Vallée d'Aoste;45.73750286;7.320149366;0;0;0;106;106;-4;3;11443;473;12022;167725;80552
2021-09-04;ABR;2140;1137;1003;740;1339;61;0;ITF;ITF1;13;Abruzzo;42.35122196;13.39843823;86;5;91;2173;2264;33;152;74522;2531;79317;2046623;800104
2021-09-04;BAS;2605;1396;1209;772;1764;69;0;ITF;ITF5;17;Basilicata;40.63947052;15.80514834;40;3;43;1380;1423;4;48;27143;600;29166;442296;230331
2021-09-04;SAR;5114;2804;2310;1553;3513;48;0;ITG;ITG2;20;Sardegna;39.21531192;9.110616306;233;25;258;6554;6812;-274;173;64681;1590;73083;1729955;979161
2021-09-04;CAM;18064;9829;8235;8628;8444;992;0;ITF;ITF3;15;Campania;40.83956555;14.25084984;373;26;399;8546;8945;108;455;430840;7768;447553;6182887;3448123
2021-09-04;EMR;23744;12922;10822;8373;14462;909;0;ITH;ITH5;8;Emilia-Romagna;44.49436681;11.3417208;396;49;445;16194;16639;150;545;384037;13376;414052;8114876;2030201
2021-09-04;FVG;2948;1590;1358;1679;1068;201;0;ITH;ITH4;6;Friuli-Venezia Giulia;45.6494354;13.76813649;48;15;63;1320;1383;58;162;106241;3804;111428;2516759;764346
2021-09-04;LOM;45606;24704;20902;20523;22549;2534;0;ITC;ITC4;3;Lombardia;45.46679409;9.190347404;352;57;409;10820;11229;215;577;827102;33931;872262;13740343;5196012
2021-09-04;CAL;5566;2962;2604;2331;3129;106;0;ITF;ITF6;18;Calabria;38.90597598;16.59440194;175;15;190;4946;5136;65;294;72498;1330;78964;1098388;992404
2021-09-04;LAZ;14301;7278;7023;9631;3931;739;0;ITI;ITI4;12;Lazio;41.89277044;12.48366722;448;65;513;13622;14135;-525;404;353566;8540;376241;8576849;4587207
2021-09-04;PAT;937;547;390;485;412;40;0;ITH;ITH2;4;Provincia Autonoma Trento;46.06893511;11.12123097;25;0;25;470;495;9;25;45628;1366;47489;998014;284705
2021-09-04;LIG;3020;1685;1335;877;2115;28;0;ITC;ITC3;7;Liguria;44.41149315;8.9326992;70;8;78;1984;2062;57;143;103963;4387;110412;2144741;812246
2021-09-04;VEN;23592;12888;10704;6051;16886;655;0;ITH;ITH3;5;Veneto;45.43490485;12.33845213;191;47;238;12728;12966;-113;645;432956;11698;457620;10802469;2032045
2021-09-04;TOS;16690;8923;7767;7546;8378;766;0;ITI;ITI1;9;Toscana;43.76923077;11.25588885;400;59;459;10416;10875;29;491;255531;7028;273434;5958066;2713260
2021-09-04;PIE;19354;10122;9232;7020;11536;798;0;ITC;ITC1;1;Piemonte;45.0732745;7.680687483;159;23;182;3673;3855;138;302;358031;11723;373609;6100371;2268299
2021-09-04;UMB;3437;1777;1660;1099;2276;62;0;ITI;ITI2;10;Umbria;43.10675841;12.38824698;45;6;51;1584;1635;-49;134;58752;1433;61820;1758361;425592
2021-09-04;SIC;18296;9849;8447;8347;9605;344;0;ITG;ITG1;19;Sicilia;38.11569725;13.3623567;848;117;965;27320;28285;155;1200;246715;6435;281435;5849195;2231379
2021-09-05;UMB;3390;1798;1592;258;3117;15;0;ITI;ITI2;10;Umbria;43.10675841;12.38824698;46;5;51;1641;1692;57;131;58826;1433;61951;1764406;426137
2021-09-05;CAL;1496;812;684;697;782;17;0;ITF;ITF6;18;Calabria;38.90597598;16.59440194;176;13;189;5053;5242;106;264;72653;1333;79228;1101860;995333
2021-09-05;EMR;17156;9245;7911;6420;10003;733;0;ITH;ITH5;8;Emilia-Romagna;44.49436681;11.3417208;391;51;442;15147;15589;-1050;497;385576;13383;414548;8139110;2032090
2021-09-05;LAZ;10105;5170;4935;6570;3090;445;0;ITI;ITI4;12;Lazio;41.89277044;12.48366722;449;63;512;13477;13989;-146;417;354127;8542;376658;8593816;4589295
2021-09-05;SIC;12743;6905;5838;5499;7049;195;0;ITG;ITG1;19;Sicilia;38.11569725;13.3623567;845;120;965;27497;28462;177;1024;247552;6445;282459;5863437;2237410
2021-09-05;PAT;1;0;1;1;0;0;0;ITH;ITH2;4;Provincia Autonoma Trento;46.06893511;11.12123097;20;0;20;474;494;-1;32;45661;1366;47521;1001367;286046
2021-09-05;PAB;1083;574;509;626;424;33;0;ITH;ITH1;4;Provincia Autonoma Bolzano / Bozen;46.49933453;11.35662422;23;4;27;719;746;46;90;73199;1185;75130;1887508;458772
2021-09-05;CAM;8208;4272;3936;5162;2583;463;0;ITF;ITF3;15;Campania;40.83956555;14.25084984;369;31;400;8488;8888;-57;394;431280;7779;447947;6190658;3452421
2021-09-05;FVG;2728;1478;1250;1316;1318;94;0;ITH;ITH4;6;Friuli-Venezia Giulia;45.6494354;13.76813649;43;15;58;1315;1373;-10;95;106345;3805;111523;2523676;766243
2021-09-05;PIE;13048;6912;6136;4468;8103;477;0;ITC;ITC1;1;Piemonte;45.0732745;7.680687483;164;22;186;3680;3866;11;173;358192;11724;373782;6116540;2273697
2021-09-05;LOM;33253;18026;15227;12428;19468;1357;0;ITC;ITC4;3;Lombardia;45.46679409;9.190347404;365;58;423;11009;11432;203;404;827301;33933;872666;13795578;5208240
2021-09-05;LIG;1017;569;448;271;741;5;0;ITC;ITC3;7;Liguria;44.41149315;8.9326992;72;8;80;1992;2072;10;109;104062;4387;110521;2150765;814499
2021-09-05;PUG;3203;1749;1454;963;2117;123;0;ITF;ITF4;16;Puglia;41.12559576;16.86736689;226;20;246;4072;4318;-5;156;253743;6722;264783;3356534;1378845
2021-09-05;SAR;664;370;294;133;525;6;0;ITG;ITG2;20;Sardegna;39.21531192;9.110616306;231;27;258;6455;6713;-99;144;64921;1593;73227;1732498;981339
2021-09-05;VDA;143;75;68;4;136;3;0;ITC;ITC2;2;Valle d'Aosta / Vallée d'Aoste;45.73750286;7.320149366;0;0;0;106;106;0;3;11446;473;12025;168317;80786
2021-09-05;BAS;2282;1205;1077;466;1783;33;0;ITF;ITF5;17;Basilicata;40.63947052;15.80514834;45;3;48;1388;1436;13;34;27164;600;29200;443138;230599
2021-09-05;MAR;194;99;95;131;37;26;0;ITI;ITI3;11;Marche;43.61675973;13.5188753;60;22;82;3425;3507;21;139;104834;3051;111392;1465676;852337
2021-09-05;ABR;1428;781;647;437;963;28;0;ITF;ITF1;13;Abruzzo;42.35122196;13.39843823;87;5;92;2117;2209;-55;87;74663;2532;79404;2053625;802185
2021-09-05;VEN;15220;8407;6813;3482;11445;293;0;ITH;ITH3;5;Veneto;45.43490485;12.33845213;198;44;242;12968;13210;244;573;433283;11700;458193;10841638;2034156
2021-09-05;TOS;15181;8058;7123;6366;8286;529;0;ITI;ITI1;9;Toscana;43.76923077;11.25588885;392;58;450;10502;10952;77;557;256008;7031;273991;5976155;2719105
2021-09-05;MOL;7;6;1;7;0;0;0;ITF;ITF2;14;Molise;41.55774754;14.65916051;9;0;9;219;228;-5;27;13553;495;14276;262914;229371
2021-09-06;MAR;6374;3388;2986;1770;4391;213;0;ITI;ITI3;11;Marche;43.61675973;13.5188753;57;21;78;3403;3481;-26;49;104908;3052;111441;1466840;852968
2021-09-06;PUG;21732;11400;10332;7190;13617;925;0;ITF;ITF4;16;Puglia;41.12559576;16.86736689;228;22;250;4047;4297;-21;122;253884;6724;264905;3364480;1380677
2021-09-06;LIG;8048;4160;3888;2705;5217;126;0;ITC;ITC3;7;Liguria;44.41149315;8.9326992;74;9;83;1925;2008;-64;52;104178;4387;110573;2152966;815162
2021-09-06;TOS;22841;11840;11001;9470;12342;1027;2;ITI;ITI1;9;Toscana;43.76923077;11.25588885;396;56;452;10336;10788;-164;313;256481;7035;274304;5983161;2721736
2021-09-06;MOL;1197;633;564;357;834;6;0;ITF;ITF2;14;Molise;41.55774754;14.65916051;9;0;9;216;225;-3;10;13566;495;14286;263298;229751
2021-09-06;ABR;6219;3245;2974;2202;3869;148;0;ITF;ITF1;13;Abruzzo;42.35122196;13.39843823;83;6;89;2104;2193;-16;85;74765;2532;79490;2063238;805014
2021-09-06;PAB;1130;582;548;567;534;29;0;ITH;ITH1;4;Provincia Autonoma Bolzano / Bozen;46.49933453;11.35662422;21;4;25;726;751;5;64;73258;1185;75194;1894166;459952
2021-09-06;BAS;3019;1571;1448;746;2195;78;0;ITF;ITF5;17;Basilicata;40.63947052;15.80514834;47;3;50;1358;1408;-28;4;27196;600;29204;443463;230745
2021-09-06;LAZ;14437;7371;7066;7890;5937;610;0;ITI;ITI4;12;Lazio;41.89277044;12.48366722;469;64;533;13434;13967;-22;295;354437;8549;376953;8608346;4591886
2021-09-06;EMR;25326;13433;11893;7035;17468;823;0;ITH;ITH5;8;Emilia-Romagna;44.49436681;11.3417208;410;49;459;15199;15658;69;513;386013;13386;415057;8153122;2033470
2021-09-06;LOM;56287;30329;25958;16515;37741;2031;0;ITC;ITC4;3;Lombardia;45.46679409;9.190347404;375;56;431;10936;11367;-65;177;827540;33936;872843;13808261;5211350
2021-09-06;CAL;7999;4114;3885;3438;4422;139;0;ITF;ITF6;18;Calabria;38.90597598;16.59440194;178;13;191;4985;5176;-66;121;72832;1337;79345;1103686;996481
2021-09-06;VEN;28372;15245;13127;5869;21818;685;0;ITH;ITH3;5;Veneto;45.43490485;12.33845213;205;47;252;12990;13242;32;274;433524;11701;458467;10854662;2035431
2021-09-06;CAM;22770;11629;11141;10651;11058;1061;0;ITF;ITF3;15;Campania;40.83956555;14.25084984;351;28;379;8182;8561;-327;192;431788;7790;448139;6212403;3453153
2021-09-06;SAR;9286;4875;4411;2548;6624;114;0;ITG;ITG2;20;Sardegna;39.21531192;9.110616306;235;28;263;6305;6568;-145;123;65186;1596;73350;1734360;982665
2021-09-06;VDA;495;245;250;145;319;31;0;ITC;ITC2;2;Valle d'Aosta / Vallée d'Aoste;45.73750286;7.320149366;0;0;0;102;102;-4;3;11453;473;12028;168963;81051
2021-09-06;SIC;23279;11835;11444;9959;12906;414;0;ITG;ITG1;19;Sicilia;38.11569725;13.3623567;855;120;975;27976;28951;489;943;247996;6455;283402;5876241;2244083
2021-09-06;UMB;4578;2386;2192;894;3646;38;0;ITI;ITI2;10;Umbria;43.10675841;12.38824698;45;6;51;1639;1690;-2;120;58948;1433;62071;1770413;426655
2021-09-06;FVG;3971;2251;1720;741;3105;125;0;ITH;ITH4;6;Friuli-Venezia Giulia;45.6494354;13.76813649;48;15;63;1275;1338;-35;35;106415;3805;111558;2525516;766675
2021-09-06;PIE;18254;9553;8701;6126;11426;702;0;ITC;ITC1;1;Piemonte;45.0732745;7.680687483;186;21;207;3628;3835;-31;99;358322;11724;373881;6131397;2276427
2021-09-06;PAT;3148;1653;1495;974;2070;104;0;ITH;ITH2;4;Provincia Autonoma Trento;46.06893511;11.12123097;18;0;18;495;513;19;37;45679;1366;47558;1004836;287434
2021-09-07;VDA;692;365;327;111;578;3;0;ITC;ITC2;2;Valle d'Aosta / Vallée d'Aoste;45.73750286;7.320149366;0;0;0;100;100;-2;3;11458;473;12031;169665;81325
2021-09-07;ABR;5352;2814;2538;1471;3772;109;0;ITF;ITF1;13;Abruzzo;42.35122196;13.39843823;83;5;88;2205;2293;100;101;74765;2533;79591;2073529;807748
2021-09-07;BAS;2658;1372;1286;679;1907;72;0;ITF;ITF5;17;Basilicata;40.63947052;15.80514834;50;3;53;1372;1425;17;94;27272;601;29298;444765;231116
2021-09-07;UMB;4820;2494;2326;1026;3717;77;0;ITI;ITI2;10;Umbria;43.10675841;12.38824698;45;8;53;1622;1675;-15;100;59062;1434;62171;1777369;427165
2021-09-07;SIC;22721;11305;11416;9479;12820;422;0;ITG;ITG1;19;Sicilia;38.11569725;13.3623567;850;116;966;27581;28547;-404;875;249246;6484;284277;5900706;2253348
2021-09-07;LAZ;13266;6735;6531;6952;5844;470;0;ITI;ITI4;12;Lazio;41.89277044;12.48366722;481;63;544;13217;13761;-206;354;354992;8554;377307;8626185;4594783
2021-09-07;PIE;18475;9717;8758;6149;11633;693;0;ITC;ITC1;1;Piemonte;45.0732745;7.680687483;178;23;201;3535;3736;-99;242;358660;11727;374123;6154919;2283096
2021-09-07;EMR;26094;14101;11993;5853;19644;597;0;ITH;ITH5;8;Emilia-Romagna;44.49436681;11.3417208;410;45;455;15138;15593;-65;396;386467;13388;415448;8186750;2035750
2021-09-07;FVG;3162;1704;1458;1222;1746;194;0;ITH;ITH4;6;Friuli-Venezia Giulia;45.6494354;13.76813649;49;13;62;1308;1370;32;77;106458;3807;111635;2534271;768360
2021-09-07;CAL;5890;2978;2912;2766;2980;144;0;ITF;ITF6;18;Calabria;38.90597598;16.59440194;181;13;194;4889;5083;-93;245;73169;1338;79590;1108589;999560
2021-09-07;LIG;7805;4130;3675;2623;5068;114;0;ITC;ITC3;7;Liguria;44.41149315;8.9326992;73;8;81;1776;1857;-151;107;104435;4388;110680;2161525;817388
2021-09-07;PAT;2909;1497;1412;846;1990;73;0;ITH;ITH2;4;Provincia Autonoma Trento;46.06893511;11.12123097;19;0;19;478;497;-16;30;45725;1366;47588;1008283;288813
2021-09-07;MAR;6132;3219;2913;1738;4191;203;0;ITI;ITI3;11;Marche;43.61675973;13.5188753;59;20;79;3334;3413;-68;110;105086;3052;111551;1471653;856187
2021-09-07;TOS;18937;9802;9135;6728;11575;633;1;ITI;ITI1;9;Toscana;43.76923077;11.25588885;394;53;447;10000;10447;-341;303;257117;7043;274607;6002461;2727437
2021-09-07;PUG;22604;11860;10744;6912;14873;819;0;ITF;ITF4;16;Puglia;41.12559576;16.86736689;213;31;244;3851;4095;-202;119;254200;6729;265024;3377904;1382821
2021-09-07;PAB;1280;698;582;229;1042;9;0;ITH;ITH1;4;Provincia Autonoma Bolzano / Bozen;46.49933453;11.35662422;19;5;24;756;780;29;71;73300;1185;75265;1901126;460815
2021-09-07;VEN;26593;14168;12425;5563;20298;732;0;ITH;ITH3;5;Veneto;45.43490485;12.33845213;209;46;255;12812;13067;-175;583;434279;11704;459050;10903143;2037460
2021-09-07;MOL;921;498;423;346;563;12;0;ITF;ITF2;14;Molise;41.55774754;14.65916051;11;0;11;215;226;1;26;13590;495;14311;263651;230090
2021-09-07;SAR;9563;5084;4479;2541;6903;119;0;ITG;ITG2;20;Sardegna;39.21531192;9.110616306;232;30;262;6029;6291;-277;99;65559;1599;73449;1742485;984963
2021-09-07;CAM;20543;10390;10153;9485;10187;871;0;ITF;ITF3;15;Campania;40.83956555;14.25084984;354;26;380;7868;8248;-313;311;432405;7797;448450;6226755;3457047
2021-09-07;LOM;60966;33288;27678;15572;43333;2061;0;ITC;ITC4;3;Lombardia;45.46679409;9.190347404;384;54;438;11022;11460;93;510;827956;33937;873353;13866499;5224012
2021-09-08;VEN;27941;14746;13195;5307;21829;805;0;ITH;ITH3;5;Veneto;45.43490485;12.33845213;206;48;254;12908;13162;95;705;434887;11706;459755;10948356;2040814
2021-09-08;PAT;1554;784;770;486;1039;29;0;ITH;ITH2;4;Provincia Autonoma Trento;46.06893511;11.12123097;18;0;18;458;476;-21;39;45785;1366;47627;1012823;290629
2021-09-08;SIC;20322;10121;10201;9207;10705;410;0;ITG;ITG1;19;Sicilia;38.11569725;13.3623567;823;116;939;27077;28016;-531;877;250625;6513;285154;5920063;2262154
2021-09-08;LOM;58169;31761;26408;13530;42902;1737;0;ITC;ITC4;3;Lombardia;45.46679409;9.190347404;386;55;441;10802;11243;-217;655;828822;33943;874008;13916899;5235001
2021-09-08;CAM;19134;9653;9481;8687;9623;824;0;ITF;ITF3;15;Campania;40.83956555;14.25084984;353;23;376;8021;8397;149;634;432883;7804;449084;6249131;3461798
2021-09-08;TOS;21350;11091;10259;7204;13402;743;1;ITI;ITI1;9;Toscana;43.76923077;11.25588885;392;56;448;9731;10179;-268;408;257791;7045;275015;6020247;2733322
2021-09-08;FVG;3321;1887;1434;1573;1564;184;0;ITH;ITH4;6;Friuli-Venezia Giulia;45.6494354;13.76813649;51;12;63;1388;1451;81;240;106615;3808;111874;2543780;769882
2021-09-08;PIE;15672;8097;7575;6147;8749;776;0;ITC;ITC1;1;Piemonte;45.0732745;7.680687483;176;23;199;3528;3727;-9;264;358932;11728;374387;6172630;2287846
2021-09-08;LIG;7488;3913;3575;2100;5254;134;0;ITC;ITC3;7;Liguria;44.41149315;8.9326992;69;8;77;1762;1839;-18;134;104586;4389;110814;2169386;819263
2021-09-08;MOL;976;517;459;252;720;4;0;ITF;ITF2;14;Molise;41.55774754;14.65916051;12;0;12;221;233;7;11;13594;495;14322;264142;230576
2021-09-08;SAR;12252;6564;5688;3187;8923;142;0;ITG;ITG2;20;Sardegna;39.21531192;9.110616306;226;28;254;5736;5990;-301;218;66076;1601;73667;1755215;988774
2021-09-08;BAS;2819;1492;1327;766;2004;49;0;ITF;ITF5;17;Basilicata;40.63947052;15.80514834;45;4;49;1362;1411;-14;44;27328;603;29342;445615;231386
2021-09-08;ABR;4423;2349;2074;1587;2733;103;0;ITF;ITF1;13;Abruzzo;42.35122196;13.39843823;83;4;87;2096;2183;-110;4;74874;2534;79591;2075329;808266
2021-09-08;MAR;7229;3781;3448;2062;4909;258;0;ITI;ITI3;11;Marche;43.61675973;13.5188753;60;20;80;3325;3405;-8;207;105301;3052;111758;1475809;858640
2021-09-08;CAL;7720;3984;3736;3299;4266;155;0;ITF;ITF6;18;Calabria;38.90597598;16.59440194;179;16;195;4825;5020;-63;215;73446;1339;79805;1112423;1001284
2021-09-08;LAZ;12269;6313;5956;6794;4888;586;1;ITI;ITI4;12;Lazio;41.89277044;12.48366722;466;64;530;12773;13303;-458;372;355820;8556;377679;8648733;4598610
2021-09-08;UMB;4618;2472;2146;988;3558;72;0;ITI;ITI2;10;Umbria;43.10675841;12.38824698;48;7;55;1619;1674;-1;101;59164;1434;62272;1784672;427614
2021-09-08;EMR;23534;12705;10829;5822;17078;634;0;ITH;ITH5;8;Emilia-Romagna;44.49436681;11.3417208;403;45;448;14666;15114;-479;337;387273;13396;415783;8215807;2038470
2021-09-08;PAB;517;274;243;248;261;8;0;ITH;ITH1;4;Provincia Autonoma Bolzano / Bozen;46.49933453;11.35662422;25;4;29;779;808;28;81;73353;1185;75346;1912100;462265
2021-09-08;PUG;18726;9822;8904;5962;12004;760;0;ITF;ITF4;16;Puglia;41.12559576;16.86736689;213;26;239;3739;3978;-117;243;254555;6734;265267;3393145;1386311
2021-09-08;VDA;607;307;300;207;346;54;0;ITC;ITC2;2;Valle d'Aosta / Vallée d'Aoste;45.73750286;7.320149366;0;0;0;97;97;-3;3;11464;473;12034;170361;81561
2021-09-09;PAB;1686;852;834;685;964;37;0;ITH;ITH1;4;Provincia Autonoma Bolzano / Bozen;46.49933453;11.35662422;28;5;33;832;865;57;74;73369;1186;75420;1919162;463076
2021-09-09;ABR;6997;3668;3329;1341;5527;129;0;ITF;ITF1;13;Abruzzo;42.35122196;13.39843823;83;6;89;2075;2164;-19;70;74963;2534;79661;2082164;810059
2021-09-09;MOL;1204;625;579;419;769;16;0;ITF;ITF2;14;Molise;41.55774754;14.65916051;13;0;13;244;257;24;31;13601;495;14353;264699;231109
2021-09-09;BAS;3182;1702;1480;684;2418;80;0;ITF;ITF5;17;Basilicata;40.63947052;15.80514834;50;3;53;1327;1380;-31;28;27386;604;29370;446611;231697
2021-09-09;FVG;3958;2089;1869;2000;1722;236;0;ITH;ITH4;6;Friuli-Venezia Giulia;45.6494354;13.76813649;47;12;59;1407;1466;15;118;106718;3808;111992;2551257;771260
2021-09-09;PIE;15970;8292;7678;6080;9118;772;0;ITC;ITC1;1;Piemonte;45.0732745;7.680687483;181;21;202;3559;3761;34;234;359130;11730;374621;6192966;2292886
2021-09-09;TOS;20056;10286;9770;6908;12213;932;3;ITI;ITI1;9;Toscana;43.76923077;11.25588885;390;58;448;9519;9967;-212;495;258492;7051;275510;6038445;2739699
2021-09-09;PAT;1714;850;864;597;1061;56;0;ITH;ITH2;4;Provincia Autonoma Trento;46.06893511;11.12123097;18;0;18;449;467;-9;25;45819;1366;47652;1016501;292100
2021-09-09;UMB;5456;2838;2618;1037;4367;52;0;ITI;ITI2;10;Umbria;43.10675841;12.38824698;50;7;57;1536;1593;-81;7;59252;1434;62279;1786269;427763
2021-09-09;VEN;30094;16635;13459;4338;25324;432;0;ITH;ITH3;5;Veneto;45.43490485;12.33845213;213;52;265;12836;13101;-61;530;435471;11713;460285;10986510;2043027
2021-09-09;VDA;326;176;150;99;216;11;0;ITC;ITC2;2;Valle d'Aosta / Vallée d'Aoste;45.73750286;7.320149366;1;0;1;94;95;-2;0;11466;473;12034;170431;81596
2021-09-09;CAM;18413;9420;8993;8216;9381;816;0;ITF;ITF3;15;Campania;40.83956555;14.25084984;351;21;372;7938;8310;-87;410;433371;7813;449494;6266160;3464745
2021-09-09;LAZ;12272;6256;6016;6253;5462;557;0;ITI;ITI4;12;Lazio;41.89277044;12.48366722;463;58;521;12571;13092;-211;310;356336;8561;377989;8675252;4602117
2021-09-09;CAL;6297;3152;3145;2395;3786;116;0;ITF;ITF6;18;Calabria;38.90597598;16.59440194;171;13;184;4908;5092;72;296;73665;1344;80101;1116569;1004252
2021-09-09;PUG;18473;9604;8869;5136;12553;784;0;ITF;ITF4;16;Puglia;41.12559576;16.86736689;205;25;230;3624;3854;-124;178;254857;6734;265445;3407378;1389097
2021-09-09;LIG;7744;4140;3604;2519;5093;132;0;ITC;ITC3;7;Liguria;44.41149315;8.9326992;85;8;93;1751;1844;5;165;104746;4389;110979;2176372;821053
2021-09-09;MAR;6465;3467;2998;1913;4313;239;0;ITI;ITI3;11;Marche;43.61675973;13.5188753;58;23;81;3325;3406;1;209;105507;3054;111967;1479639;861140
2021-09-09;LOM;56641;31093;25548;11926;43096;1619;0;ITC;ITC4;3;Lombardia;45.46679409;9.190347404;395;58;453;10885;11338;95;663;829388;33945;874671;13968214;5245504
2021-09-09;SAR;11712;6262;5450;2229;9344;139;0;ITG;ITG2;20;Sardegna;39.21531192;9.110616306;227;25;252;5444;5696;-294;147;66514;1604;73814;1762538;991809
2021-09-09;SIC;23621;11820;11801;8331;14849;441;0;ITG;ITG1;19;Sicilia;38.11569725;13.3623567;809;117;926;26263;27189;-827;929;252369;6525;286083;5939355;2270021
2021-09-09;EMR;24791;13177;11614;5209;18940;642;0;ITH;ITH5;8;Emilia-Romagna;44.49436681;11.3417208;402;45;447;14575;15022;-92;449;387807;13399;416228;8245982;2040676
2021-09-10;UMB;4545;2486;2059;722;3778;45;0;ITI;ITI2;10;Umbria;43.10675841;12.38824698;51;6;57;1520;1577;-16;104;59372;1434;62383;1794319;428423
2021-09-10;CAM;18474;9434;9040;8306;9269;899;0;ITF;ITF3;15;Campania;40.83956555;14.25084984;346;21;367;7856;8223;-87;359;433810;7820;449853;6282118;3466588
2021-09-10;PIE;17279;9031;8248;5120;11449;710;0;ITC;ITC1;1;Piemonte;45.0732745;7.680687483;189;23;212;3575;3787;26;238;359341;11731;374859;6216990;2298050
2021-09-10;SAR;10291;5473;4818;2648;7473;170;0;ITG;ITG2;20;Sardegna;39.21531192;9.110616306;220;25;245;5287;5532;-164;156;66833;1605;73970;1767546;994494
2021-09-10;SIC;25225;12582;12643;8820;15968;437;0;ITG;ITG1;19;Sicilia;38.11569725;13.3623567;793;108;901;25452;26353;-836;973;254160;6543;287056;5960165;2278140
2021-09-10;LAZ;11483;5898;5585;6125;4725;633;0;ITI;ITI4;12;Lazio;41.89277044;12.48366722;457;57;514;12505;13019;-73;346;356753;8563;378335;8697663;4604894
2021-09-10;EMR;26180;14175;12005;5279;20222;679;0;ITH;ITH5;8;Emilia-Romagna;44.49436681;11.3417208;400;43;443;14578;15021;-1;617;388419;13404;416844;8275759;2042616
2021-09-10;CAL;8982;4553;4429;3611;5167;204;0;ITF;ITF6;18;Calabria;38.90597598;16.59440194;167;14;181;4909;5090;-2;304;73967;1348;80405;1121246;1007381
2021-09-10;LIG;6932;3698;3234;1942;4871;119;0;ITC;ITC3;7;Liguria;44.41149315;8.9326992;83;9;92;1730;1822;-22;131;104899;4389;111110;2183221;822859
2021-09-10;LOM;52670;28289;24381;11434;39458;1778;0;ITC;ITC4;3;Lombardia;45.46679409;9.190347404;391;59;450;10795;11245;-93;594;830073;33947;875265;14017872;5255563
2021-09-10;FVG;3988;2209;1779;661;3216;111;0;ITH;ITH4;6;Friuli-Venezia Giulia;45.6494354;13.76813649;47;12;59;1466;1525;59;164;106823;3808;112156;2559858;772871
2021-09-10;PAT;2464;1277;1187;746;1638;80;0;ITH;ITH2;4;Provincia Autonoma Trento;46.06893511;11.12123097;17;0;17;412;429;-38;17;45873;1367;47669;1017903;292661
2021-09-10;VEN;28247;15578;12669;4352;23460;435;0;ITH;ITH3;5;Veneto;45.43490485;12.33845213;208;52;260;12913;13173;72;618;436011;11719;460903;11029810;2046131
2021-09-10;TOS;18113;9503;8610;5514;11971;628;0;ITI;ITI1;9;Toscana;43.76923077;11.25588885;385;57;442;9330;9772;-195;423;259107;7054;275933;6055492;2745821
2021-09-10;MAR;7565;4074;3491;2069;5195;301;0;ITI;ITI3;11;Marche;43.61675973;13.5188753;60;23;83;3252;3335;-71;114;105692;3054;112081;1483008;863154
2021-09-10;MOL;1006;528;478;384;608;14;0;ITF;ITF2;14;Molise;41.55774754;14.65916051;13;0;13;239;252;-5;4;13608;495;14355;264801;231211
2021-09-10;PUG;19418;10146;9272;6142;12214;1062;0;ITF;ITF4;16;Puglia;41.12559576;16.86736689;186;23;209;3544;3753;-101;200;255147;6745;265645;3418754;1391200
2021-09-10;ABR;4941;2642;2299;1515;3323;103;0;ITF;ITF1;13;Abruzzo;42.35122196;13.39843823;80;6;86;2104;2190;26;123;75061;2534;79785;2088511;811722
2021-09-10;VDA;616;301;315;209;364;43;0;ITC;ITC2;2;Valle d'Aosta / Vallée d'Aoste;45.73750286;7.320149366;1;0;1;96;97;2;10;11474;473;12044;171190;81849
2021-09-10;BAS;2610;1317;1293;538;2012;60;0;ITF;ITF5;17;Basilicata;40.63947052;15.80514834;46;4;50;1317;1367;-13;34;27431;606;29404;447408;231960
2021-09-10;PAB;1641;871;770;731;857;53;0;ITH;ITH1;4;Provincia Autonoma Bolzano / Bozen;46.49933453;11.35662422;24;7;31;792;823;-42;17;73427;1187;75437;1920759;463307
2021-09-11;PUG;4601;2509;2092;1157;3246;198;0;ITF;ITF4;16;Puglia;41.12559576;16.86736689;182;20;202;3523;3725;-28;222;255395;6747;265867;3435097;1393629
2021-09-11;PAB;965;530;435;347;589;29;0;ITH;ITH1;4;Provincia Autonoma Bolzano / Bozen;46.49933453;11.35662422;24;7;31;846;877;54;70;73443;1187;75507;1929645;464206
2021-09-11;MOL;1228;690;538;179;1037;12;0;ITF;ITF2;14;Molise;41.55774754;14.65916051;13;0;13;231;244;-8;0;13616;495;14355;265068;231476
2021-09-11;ABR;2385;1331;1054;1047;1231;107;0;ITF;ITF1;13;Abruzzo;42.35122196;13.39843823;77;6;83;2113;2196;6;131;75186;2534;79916;2095828;813323
2021-09-11;MAR;3661;1897;1764;1369;2123;169;0;ITI;ITI3;11;Marche;43.61675973;13.5188753;59;23;82;3241;3323;-12;124;105826;3056;112205;1485802;865948
2021-09-11;VDA;390;238;152;2;385;3;0;ITC;ITC2;2;Valle d'Aosta / Vallée d'Aoste;45.73750286;7.320149366;1;0;1;99;100;3;5;11476;473;12049;171623;82036
2021-09-11;BAS;2869;1521;1348;763;2041;65;0;ITF;ITF5;17;Basilicata;40.63947052;15.80514834;49;4;53;1311;1364;-3;39;27473;606;29443;448266;232208
2021-09-11;VEN;20872;11710;9162;3032;17499;341;0;ITH;ITH3;5;Veneto;45.43490485;12.33845213;199;52;251;12651;12902;-271;596;436878;11719;461499;11078863;2048577
2021-09-11;CAL;4842;2580;2262;1912;2809;121;0;ITF;ITF6;18;Calabria;38.90597598;16.59440194;161;17;178;4890;5068;-22;278;74264;1351;80683;1125148;1010018
2021-09-11;TOS;19101;10014;9087;5441;13034;624;2;ITI;ITI1;9;Toscana;43.76923077;11.25588885;379;55;434;9081;9515;-257;429;259790;7057;276362;6075416;2751955
2021-09-11;SAR;6499;3466;3033;1210;5253;36;0;ITG;ITG2;20;Sardegna;39.21531192;9.110616306;220;24;244;5191;5435;-97;114;67043;1606;74084;1771061;997306
2021-09-11;EMR;24915;14140;10775;4551;19796;568;0;ITH;ITH5;8;Emilia-Romagna;44.49436681;11.3417208;390;43;433;14678;15111;90;499;388823;13408;417342;8312116;2044900
2021-09-11;CAM;11884;6428;5456;6210;4954;720;0;ITF;ITF3;15;Campania;40.83956555;14.25084984;342;21;363;7890;8253;30;449;434223;7826;450302;6302167;3469462
2021-09-11;LIG;2181;1198;983;854;1292;35;0;ITC;ITC3;7;Liguria;44.41149315;8.9326992;82;9;91;1748;1839;17;98;104979;4390;111208;2190999;825170
2021-09-11;PAT;699;399;300;467;193;39;0;ITH;ITH2;4;Provincia Autonoma Trento;46.06893511;11.12123097;18;0;18;417;435;6;41;45908;1367;47710;1022265;294406
2021-09-11;FVG;1195;676;519;609;538;48;0;ITH;ITH4;6;Friuli-Venezia Giulia;45.6494354;13.76813649;44;11;55;1437;1492;-33;128;106982;3809;112283;2570160;775230
2021-09-11;PIE;18004;9455;8549;5875;11343;786;0;ITC;ITC1;1;Piemonte;45.0732745;7.680687483;181;24;205;3586;3791;4;232;359567;11733;375091;6250974;2306263
2021-09-11;LOM;41127;22335;18792;13292;25976;1859;0;ITC;ITC4;3;Lombardia;45.46679409;9.190347404;402;59;461;10926;11387;142;596;830524;33950;875861;14077032;5269446
2021-09-11;LAZ;12393;6133;6260;8301;3198;894;0;ITI;ITI4;12;Lazio;41.89277044;12.48366722;445;59;504;12257;12761;-258;362;357370;8566;378697;8718286;4607575
2021-09-11;UMB;3387;1870;1517;641;2703;43;0;ITI;ITI2;10;Umbria;43.10675841;12.38824698;53;6;59;1449;1508;-69;77;59518;1434;62460;1800894;429135
2021-09-11;SIC;21341;11067;10274;7694;13267;380;0;ITG;ITG1;19;Sicilia;38.11569725;13.3623567;801;106;907;25348;26255;-98;770;255003;6568;287826;5978606;2285341
2021-09-12;BAS;1754;929;825;303;1423;28;0;ITF;ITF5;17;Basilicata;40.63947052;15.80514834;48;4;52;1290;1342;-22;46;27541;606;29489;448933;232391
2021-09-12;CAM;7821;4064;3757;4681;2678;462;0;ITF;ITF3;15;Campania;40.83956555;14.25084984;341;22;363;7941;8304;51;371;434538;7831;450673;6320478;3473756
2021-09-12;LOM;26943;14515;12428;8980;16760;1203;0;ITC;ITC4;3;Lombardia;45.46679409;9.190347404;412;60;472;11030;11502;115;449;830855;33953;876310;14125914;5281561
2021-09-12;EMR;14787;8101;6686;3949;10380;458;0;ITH;ITH5;8;Emilia-Romagna;44.49436681;11.3417208;398;45;443;14590;15033;-78;453;389354;13408;417795;8336880;2046628
2021-09-12;SIC;14015;7470;6545;4974;8809;232;0;ITG;ITG1;19;Sicilia;38.11569725;13.3623567;786;106;892;25298;26190;-65;885;255944;6577;288711;5994498;2291847
2021-09-12;SAR;3234;1794;1440;622;2586;26;0;ITG;ITG2;20;Sardegna;39.21531192;9.110616306;208;25;233;5007;5240;-195;76;67311;1609;74160;1773203;999020
2021-09-12;PAB;262;145;117;128;124;10;0;ITH;ITH1;4;Provincia Autonoma Bolzano / Bozen;46.49933453;11.35662422;21;8;29;843;872;-5;105;73553;1187;75612;1935305;464921
2021-09-12;FVG;2375;1270;1105;1443;848;84;0;ITH;ITH4;6;Friuli-Venezia Giulia;45.6494354;13.76813649;44;10;54;1390;1444;-48;61;107091;3809;112344;2576936;776851
2021-09-12;PUG;1227;652;575;403;773;51;0;ITF;ITF4;16;Puglia;41.12559576;16.86736689;182;21;203;3538;3741;16;127;255506;6747;265994;3447671;1395789
2021-09-12;CAL;2138;1122;1016;825;1276;37;0;ITF;ITF6;18;Calabria;38.90597598;16.59440194;159;18;177;4910;5087;19;229;74472;1353;80912;1128392;1012140
2021-09-12;UMB;3057;1655;1402;463;2579;15;0;ITI;ITI2;10;Umbria;43.10675841;12.38824698;50;6;56;1465;1521;13;111;59615;1435;62571;1806463;429633
2021-09-12;PIE;10482;5556;4926;3531;6472;479;0;ITC;ITC1;1;Piemonte;45.0732745;7.680687483;190;25;215;3648;3863;72;228;359723;11733;375319;6268727;2311559
2021-09-12;LAZ;7478;3748;3730;4778;2157;543;0;ITI;ITI4;12;Lazio;41.89277044;12.48366722;442;62;504;12261;12765;4;323;357684;8571;379020;8738132;4609886
2021-09-12;PAT;7;4;3;3;4;0;0;ITH;ITH2;4;Provincia Autonoma Trento;46.06893511;11.12123097;19;0;19;416;435;0;41;45949;1367;47751;1025908;295863
2021-09-12;ABR;1610;866;744;759;785;66;0;ITF;ITF1;13;Abruzzo;42.35122196;13.39843823;78;5;83;2154;2237;41;105;75247;2534;80018;2102531;814854
2021-09-12;MAR;250;127;123;171;47;32;0;ITI;ITI3;11;Marche;43.61675973;13.5188753;59;24;83;3244;3327;4;130;105952;3056;112335;1491419;868927
2021-09-12;LIG;116;68;48;66;48;2;0;ITC;ITC3;7;Liguria;44.41149315;8.9326992;85;9;94;1741;1835;-4;97;105080;4390;111305;2196915;827178
2021-09-12;TOS;18297;9478;8819;4322;13422;552;1;ITI;ITI1;9;Toscana;43.76923077;11.25588885;374;55;429;8960;9389;-126;431;260344;7060;276793;6093023;2757666
2021-09-12;VEN;15343;8644;6699;2370;12812;161;0;ITH;ITH3;5;Veneto;45.43490485;12.33845213;216;52;268;12542;12810;-92;465;437435;11719;461964;11118262;2050591
2021-09-12;MOL;390;212;178;343;34;13;0;ITF;ITF2;14;Molise;41.55774754;14.65916051;13;0;13;228;241;-3;19;13638;495;14374;265761;232149
2021-09-13;LOM;36407;19697;16710;6362;29021;1024;0;ITC;ITC4;3;Lombardia;45.46679409;9.190347404;416;62;478;11067;11545;43;220;831029;33956;876530;14140922;5285058
2021-09-13;VEN;25547;14197;11350;3131;22108;308;0;ITH;ITH3;5;Veneto;45.43490485;12.33845213;222;53;275;12609;12884;74;291;437650;11721;462255;11132482;2051862
2021-09-13;LIG;7030;3617;3413;2325;4561;144;0;ITC;ITC3;7;Liguria;44.41149315;8.9326992;90;9;99;1721;1820;-15;65;105159;4391;111370;2199496;827887
2021-09-13;TOS;18467;9820;8647;3529;14556;381;1;ITI;ITI1;9;Toscana;43.76923077;11.25588885;380;56;436;8942;9378;-11;207;260559;7063;277000;6098942;2759816
2021-09-13;MAR;8068;4277;3791;2046;5779;243;0;ITI;ITI3;11;Marche;43.61675973;13.5188753;58;26;84;3119;3203;-124;16;106092;3056;112351;1492405;869485
2021-09-13;ABR;4590;2483;2107;1054;3457;79;0;ITF;ITF1;13;Abruzzo;42.35122196;13.39843823;72;6;78;2108;2186;-51;85;75383;2534;80103;2111253;817110
2021-09-13;BAS;2383;1260;1123;490;1847;46;0;ITF;ITF5;17;Basilicata;40.63947052;15.80514834;49;4;53;1264;1317;-25;6;27572;606;29495;449109;232458
2021-09-13;PAT;2431;1303;1128;820;1550;61;0;ITH;ITH2;4;Provincia Autonoma Trento;46.06893511;11.12123097;22;0;22;426;448;13;44;45980;1367;47795;1030128;297551
2021-09-13;PUG;19755;10354;9401;5405;13606;744;0;ITF;ITF4;16;Puglia;41.12559576;16.86736689;193;20;213;3468;3681;-60;88;255651;6750;266082;3454109;1397268
2021-09-13;MOL;409;229;180;123;280;6;0;ITF;ITF2;14;Molise;41.55774754;14.65916051;13;0;13;227;240;-1;4;13643;495;14378;266214;232601
2021-09-13;PAB;1173;645;528;670;454;49;0;ITH;ITH1;4;Provincia Autonoma Bolzano / Bozen;46.49933453;11.35662422;20;7;27;875;902;30;70;73592;1188;75682;1942474;465640
2021-09-13;EMR;24219;13105;11114;4775;18726;718;0;ITH;ITH5;8;Emilia-Romagna;44.49436681;11.3417208;420;45;465;14483;14948;-85;470;389900;13409;418257;8352278;2047871
2021-09-13;SAR;10458;5638;4820;2473;7873;112;0;ITG;ITG2;20;Sardegna;39.21531192;9.110616306;213;24;237;4835;5072;-168;96;67574;1610;74256;1775004;1000461
2021-09-13;CAM;18285;9031;9254;8252;9248;785;0;ITF;ITF3;15;Campania;40.83956555;14.25084984;336;21;357;7678;8035;-269;151;434952;7837;450824;6326242;3474792
2021-09-13;CAL;8488;4295;4193;3217;5119;152;0;ITF;ITF6;18;Calabria;38.90597598;16.59440194;163;18;181;4831;5012;-75;125;74668;1357;81037;1131040;1013718
2021-09-13;SIC;27248;13544;13704;9553;17198;497;0;ITG;ITG1;19;Sicilia;38.11569725;13.3623567;792;103;895;25119;26014;-176;618;256730;6585;289329;6006805;2297466
2021-09-13;LAZ;18650;9514;9136;5423;12512;715;0;ITI;ITI4;12;Lazio;41.89277044;12.48366722;452;64;516;12091;12607;-158;271;358110;8574;379291;8749592;4612076
2021-09-13;VDA;291;149;142;14;276;1;0;ITC;ITC2;2;Valle d'Aosta / Vallée d'Aoste;45.73750286;7.320149366;1;0;1;92;93;-7;1;11484;473;12050;172354;82185
2021-09-13;UMB;2455;1235;1220;316;2116;23;0;ITI;ITI2;10;Umbria;43.10675841;12.38824698;52;6;58;1434;1492;-29;83;59727;1435;62654;1811901;430133
2021-09-13;PIE;16620;8598;8022;5475;10359;786;0;ITC;ITC1;1;Piemonte;45.0732745;7.680687483;195;24;219;3537;3756;-107;87;359917;11733;375406;6284235;2314309
2021-09-13;FVG;2614;1374;1240;570;1950;94;0;ITH;ITH4;6;Friuli-Venezia Giulia;45.6494354;13.76813649;44;11;55;1353;1408;-36;37;107164;3809;112381;2579066;777258
2021-09-14;ABR;3908;2102;1806;799;3037;72;0;ITF;ITF1;13;Abruzzo;42.35122196;13.39843823;70;7;77;2160;2237;51;74;75405;2535;80177;2120379;819459
2021-09-14;VDA;546;274;272;9;536;1;0;ITC;ITC2;2;Valle d'Aosta / Vallée d'Aoste;45.73750286;7.320149366;2;0;2;80;82;-11;2;11497;473;12052;172975;82362
2021-09-14;BAS;2329;1284;1045;458;1822;49;0;ITF;ITF5;17;Basilicata;40.63947052;15.80514834;46;4;50;1272;1322;5;57;27623;607;29552;450148;232741
2021-09-14;LAZ;18401;9130;9271;7369;10108;904;20;ITI;ITI4;12;Lazio;41.89277044;12.48366722;448;62;510;11738;12248;-359;326;358790;8579;379617;8770067;4614747
2021-09-14;EMR;20414;11032;9382;4526;15338;550;0;ITH;ITH5;8;Emilia-Romagna;44.49436681;11.3417208;428;43;471;13737;14208;-740;314;390946;13411;418565;8387832;2049947
2021-09-14;SIC;24465;11891;12574;8722;15260;483;0;ITG;ITG1;19;Sicilia;38.11569725;13.3623567;772;99;871;24633;25504;-510;684;257900;6609;290013;6028605;2305682
2021-09-14;UMB;2817;1442;1375;415;2374;28;0;ITI;ITI2;10;Umbria;43.10675841;12.38824698;51;7;58;1445;1503;11;87;59802;1436;62741;1819521;430588
2021-09-14;LOM;36894;19798;17096;7496;28252;1146;0;ITC;ITC4;3;Lombardia;45.46679409;9.190347404;436;60;496;10944;11440;-105;435;831563;33962;876965;14199606;5296856
2021-09-14;VEN;21635;11801;9834;3155;18192;288;0;ITH;ITH3;5;Veneto;45.43490485;12.33845213;216;56;272;12317;12589;-295;427;438365;11728;462682;11179416;2054238
2021-09-14;PAT;1976;987;989;587;1341;48;0;ITH;ITH2;4;Provincia Autonoma Trento;46.06893511;11.12123097;20;0;20;418;438;-10;23;46013;1367;47818;1033422;298868
2021-09-14;FVG;3903;2066;1837;932;2861;110;0;ITH;ITH4;6;Friuli-Venezia Giulia;45.6494354;13.76813649;45;9;54;1368;1422;14;91;107241;3809;112472;2589391;778899
2021-09-14;PIE;15841;8269;7572;5169;9948;724;0;ITC;ITC1;1;Piemonte;45.0732745;7.680687483;201;23;224;3416;3640;-116;204;360232;11738;375610;6307086;2320187
2021-09-14;SAR;10551;5675;4876;1936;8480;135;0;ITG;ITG2;20;Sardegna;39.21531192;9.110616306;201;23;224;4447;4671;-401;68;68039;1614;74324;1778412;1003187
2021-09-14;PUG;21703;11344;10359;4349;16645;709;0;ITF;ITF4;16;Puglia;41.12559576;16.86736689;183;20;203;3386;3589;-92;187;255926;6754;266269;3469208;1399685
2021-09-14;PAB;696;367;329;358;317;21;0;ITH;ITH1;4;Provincia Autonoma Bolzano / Bozen;46.49933453;11.35662422;25;7;32;958;990;88;127;73631;1188;75809;1948281;466371
2021-09-14;TOS;16134;8736;7398;3187;12601;344;2;ITI;ITI1;9;Toscana;43.76923077;11.25588885;363;57;420;8664;9084;-294;279;261126;7069;277279;6116458;2764989
2021-09-14;MOL;548;297;251;172;370;6;0;ITF;ITF2;14;Molise;41.55774754;14.65916051;9;0;9;224;233;-7;10;13660;495;14388;266717;233091
2021-09-14;CAL;6531;3217;3314;2514;3887;130;0;ITF;ITF6;18;Calabria;38.90597598;16.59440194;168;18;186;4690;4876;-136;155;74959;1357;81192;1135341;1016653
2021-09-14;CAM;15835;7794;8041;6763;8371;701;0;ITF;ITF3;15;Campania;40.83956555;14.25084984;339;21;360;7425;7785;-250;301;435499;7841;451125;6345697;3478926
2021-09-14;LIG;6362;3301;3061;2278;3971;113;0;ITC;ITC3;7;Liguria;44.41149315;8.9326992;93;8;101;1596;1697;-123;98;105379;4392;111468;2208175;833589
2021-09-14;MAR;6378;3432;2946;1469;4738;171;0;ITI;ITI3;11;Marche;43.61675973;13.5188753;55;27;82;3021;3103;-100;119;106309;3058;112470;1495601;870955
2021-09-15;EMR;19999;10647;9352;4636;14770;593;0;ITH;ITH5;8;Emilia-Romagna;44.49436681;11.3417208;450;44;494;13291;13785;-423;324;391686;13414;418885;8417516;2052465
2021-09-15;SIC;21365;10710;10655;7457;13521;387;0;ITG;ITG1;19;Sicilia;38.11569725;13.3623567;732;98;830;22786;23616;-1888;471;260231;6637;290484;6047680;2313216
2021-09-15;FVG;4891;2535;2356;2422;2140;329;0;ITH;ITH4;6;Friuli-Venezia Giulia;45.6494354;13.76813649;47;9;56;1347;1403;-19;135;107393;3811;112607;2598259;780376
2021-09-15;PIE;15831;8172;7659;5606;9430;795;0;ITC;ITC1;1;Piemonte;45.0732745;7.680687483;196;24;220;3457;3677;37;306;360499;11740;375916;6327297;2325682
2021-09-15;CAM;15303;7569;7734;6102;8539;662;0;ITF;ITF3;15;Campania;40.83956555;14.25084984;332;22;354;7389;7743;-42;394;435934;7842;451519;6365972;3482467
2021-09-15;LOM;35013;18473;16540;8173;25594;1246;0;ITC;ITC4;3;Lombardia;45.46679409;9.190347404;435;59;494;10815;11309;-131;628;832316;33968;877593;14250296;5307344
2021-09-15;SAR;10221;5545;4676;2044;8066;111;0;ITG;ITG2;20;Sardegna;39.21531192;9.110616306;194;24;218;4146;4364;-307;104;68447;1617;74428;1806288;1006132
2021-09-15;VEN;18705;10030;8675;3530;14815;360;0;ITH;ITH3;5;Veneto;45.43490485;12.33845213;228;50;278;12141;12419;-170;525;439057;11731;463207;11223256;2057624
2021-09-15;LAZ;12447;6296;6151;2943;9152;351;1;ITI;ITI4;12;Lazio;41.89277044;12.48366722;439;59;498;11344;11842;-406;371;359561;8585;379988;8795774;4617544
2021-09-15;UMB;3690;1911;1779;891;2729;70;0;ITI;ITI2;10;Umbria;43.10675841;12.38824698;46;7;53;1392;1445;-58;86;59944;1438;62827;1827502;431036
2021-09-15;PAT;1662;884;778;462;1142;58;0;ITH;ITH2;4;Provincia Autonoma Trento;46.06893511;11.12123097;20;0;20;420;440;2;41;46052;1367;47859;1037868;300647
2021-09-15;CAL;7783;3850;3933;3292;4291;200;0;ITF;ITF6;18;Calabria;38.90597598;16.59440194;177;16;193;4731;4924;48;299;75208;1359;81491;1139808;1019584
2021-09-15;TOS;16725;8783;7942;3724;12466;533;2;ITI;ITI1;9;Toscana;43.76923077;11.25588885;354;52;406;8427;8833;-251;373;261742;7077;277652;6135560;2771653
2021-09-15;MAR;7099;3805;3294;1384;5541;174;0;ITI;ITI3;11;Marche;43.61675973;13.5188753;56;27;83;2995;3078;-25;173;106504;3061;112643;1499404;873206
2021-09-15;MOL;387;199;188;158;220;9;0;ITF;ITF2;14;Molise;41.55774754;14.65916051;11;0;11;227;238;5;5;13660;495;14393;267113;233483
2021-09-15;LIG;6138;3220;2918;2115;3900;123;0;ITC;ITC3;7;Liguria;44.41149315;8.9326992;87;8;95;1572;1667;-30;117;105526;4392;111585;2216438;831448
2021-09-15;BAS;2381;1255;1126;566;1765;50;0;ITF;ITF5;17;Basilicata;40.63947052;15.80514834;46;4;50;1271;1321;-1;87;27711;607;29639;451064;233012
2021-09-15;ABR;6100;3218;2882;1471;4505;124;0;ITF;ITF1;13;Abruzzo;42.35122196;13.39843823;75;7;82;2090;2172;-65;26;75496;2535;80203;2123062;819951
2021-09-15;PUG;15616;8204;7412;3966;11005;645;0;ITF;ITF4;16;Puglia;41.12559576;16.86736689;186;19;205;3148;3353;-236;189;256347;6758;266458;3483072;1402699
2021-09-15;PAB;622;331;291;212;400;10;0;ITH;ITH1;4;Provincia Autonoma Bolzano / Bozen;46.49933453;11.35662422;25;7;32;927;959;-31;38;73700;1188;75847;1957072;467345
2021-09-15;VDA;373;197;176;23;349;1;0;ITC;ITC2;2;Valle d'Aosta / Vallée d'Aoste;45.73750286;7.320149366;2;0;2;77;79;-3;1;11501;473;12053;173658;82618
2021-09-16;ABR;3175;1685;1490;963;2114;98;0;ITF;ITF1;13;Abruzzo;42.35122196;13.39843823;73;7;80;2013;2093;-79;87;75656;2535;80284;2130670;821717
2021-09-16;PAB;1478;753;725;834;625;19;0;ITH;ITH1;4;Provincia Autonoma Bolzano / Bozen;46.49933453;11.35662422;23;7;30;983;1013;54;94;73740;1188;75941;1962732;468036
2021-09-16;VDA;472;220;252;234;150;88;0;ITC;ITC2;2;Valle d'Aosta / Vallée d'Aoste;45.73750286;7.320149366;2;0;2;76;78;-1;1;11503;473;12054;174599;82955
2021-09-16;MOL;387;194;193;157;224;6;0;ITF;ITF2;14;Molise;41.55774754;14.65916051;11;0;11;239;250;12;19;13667;495;14412;267604;233941
2021-09-16;VEN;21924;11911;10013;3808;17748;368;0;ITH;ITH3;5;Veneto;45.43490485;12.33845213;214;53;267;12189;12456;37;613;439632;11732;463820;11276475;2060472
2021-09-16;BAS;2441;1266;1175;407;1981;53;0;ITF;ITF5;17;Basilicata;40.63947052;15.80514834;46;4;50;1267;1317;-4;35;27750;607;29674;451851;233372
2021-09-16;PIE;14212;7549;6663;3820;9922;470;0;ITC;ITC1;1;Piemonte;45.0732745;7.680687483;194;24;218;3546;3764;87;263;360674;11741;376179;6349668;2330290
2021-09-16;SAR;10575;5631;4944;1990;8480;105;0;ITG;ITG2;20;Sardegna;39.21531192;9.110616306;186;21;207;3981;4188;-176;107;68725;1622;74535;1813613;1008613
2021-09-16;PAT;1822;921;901;561;1208;53;0;ITH;ITH2;4;Provincia Autonoma Trento;46.06893511;11.12123097;17;0;17;422;439;-1;19;46071;1368;47878;1041637;302154
2021-09-16;FVG;3034;1614;1420;497;2450;83;4;ITH;ITH4;6;Friuli-Venezia Giulia;45.6494354;13.76813649;48;9;57;1342;1399;-4;111;107506;3812;112717;2608805;781876
2021-09-16;TOS;17507;9147;8360;4270;12765;471;1;ITI;ITI1;9;Toscana;43.76923077;11.25588885;348;50;398;8334;8732;-101;435;262269;7086;278087;6152058;2777602
2021-09-16;SIC;19497;9725;9772;6584;12534;379;0;ITG;ITG1;19;Sicilia;38.11569725;13.3623567;697;99;796;21924;22720;-896;878;261985;6657;291362;6066362;2321187
2021-09-16;UMB;4342;2270;2072;651;3638;53;0;ITI;ITI2;10;Umbria;43.10675841;12.38824698;49;7;56;1290;1346;-99;7;60050;1438;62834;1829678;431194
2021-09-16;MAR;6090;3273;2817;1292;4643;155;0;ITI;ITI3;11;Marche;43.61675973;13.5188753;54;27;81;2911;2992;-86;117;106707;3061;112760;1502543;875020
2021-09-16;PUG;17903;9317;8586;4050;13287;566;0;ITF;ITF4;16;Puglia;41.12559576;16.86736689;184;20;204;3164;3368;15;248;256579;6759;266706;3497003;1405382
2021-09-16;CAL;6895;3403;3492;2744;3991;160;0;ITF;ITF6;18;Calabria;38.90597598;16.59440194;177;14;191;4644;4835;-89;203;75494;1365;81694;1143627;1022214
2021-09-16;LIG;5140;2690;2450;2108;2913;119;0;ITC;ITC3;7;Liguria;44.41149315;8.9326992;82;7;89;1475;1564;-103;93;105721;4393;111678;2223660;832971
2021-09-16;CAM;14452;7225;7227;6141;7677;634;0;ITF;ITF3;15;Campania;40.83956555;14.25084984;330;24;354;7458;7812;69;475;436336;7846;451994;6383619;3486475
2021-09-16;LAZ;11167;5722;5445;3545;7126;339;157;ITI;ITI4;12;Lazio;41.89277044;12.48366722;433;56;489;11176;11665;-177;314;360049;8588;380302;8824169;4621118
2021-09-16;LOM;30124;16053;14071;7889;21005;1230;0;ITC;ITC4;3;Lombardia;45.46679409;9.190347404;437;57;494;10652;11146;-163;573;833043;33977;878166;14302592;5317337
2021-09-16;EMR;22176;12017;10159;3857;17855;464;0;ITH;ITH5;8;Emilia-Romagna;44.49436681;11.3417208;427;44;471;12901;13372;-413;364;392457;13420;419249;8446018;2054762
2021-09-17;EMR;18043;9925;8118;4488;13080;474;1;ITH;ITH5;8;Emilia-Romagna;44.49436681;11.3417208;411;41;452;12611;13063;-309;473;393227;13427;419717;8473926;2056490
2021-09-17;CAL;9009;4683;4326;3924;4863;222;0;ITF;ITF6;18;Calabria;38.90597598;16.59440194;169;15;184;4560;4744;-91;163;75744;1369;81857;1147397;1024673
2021-09-17;LAZ;11846;6231;5615;4281;6768;409;388;ITI;ITI4;12;Lazio;41.89277044;12.48366722;435;55;490;11114;11604;-61;368;360473;8593;380670;8844845;4623317
2021-09-17;CAM;15139;7779;7360;7053;7375;711;0;ITF;ITF3;15;Campania;40.83956555;14.25084984;323;26;349;7507;7856;44;477;436762;7853;452471;6400163;3489733
2021-09-17;SIC;21220;10770;10450;7991;12757;472;0;ITG;ITG1;19;Sicilia;38.11569725;13.3623567;696;99;795;20982;21777;-943;602;263514;6673;291964;6085120;2327567
2021-09-17;UMB;3293;1768;1525;817;2429;47;0;ITI;ITI2;10;Umbria;43.10675841;12.38824698;46;7;53;1300;1353;7;74;60116;1439;62908;1837485;431835
2021-09-17;FVG;3643;1976;1667;845;2691;107;0;ITH;ITH4;6;Friuli-Venezia Giulia;45.6494354;13.76813649;47;9;56;1317;1373;-26;102;107631;3813;112817;2618178;783227
2021-09-17;PIE;15300;8226;7074;5296;9431;573;0;ITC;ITC1;1;Piemonte;45.0732745;7.680687483;206;23;229;3616;3845;81;296;360888;11742;376475;6377317;2335325
2021-09-17;TOS;19502;10641;8861;4138;14874;487;3;ITI;ITI1;9;Toscana;43.76923077;11.25588885;354;48;402;8165;8567;-165;494;262919;7095;278581;6170299;2783993
2021-09-17;LIG;5683;3050;2633;2190;3390;103;0;ITC;ITC3;7;Liguria;44.41149315;8.9326992;81;7;88;1411;1499;-65;97;105881;4395;111775;2231393;834769
2021-09-17;MAR;8248;4569;3679;2054;5972;222;0;ITI;ITI3;11;Marche;43.61675973;13.5188753;58;26;84;2874;2958;-34;105;106845;3062;112865;1505661;876768
2021-09-17;LOM;30383;16363;14020;9656;19456;1271;0;ITC;ITC4;3;Lombardia;45.46679409;9.190347404;427;59;486;10590;11076;-70;360;833471;33979;878526;14342711;5325300
2021-09-17;SAR;9943;5451;4492;2169;7669;105;0;ITG;ITG2;20;Sardegna;39.21531192;9.110616306;188;18;206;3801;4007;-181;84;68988;1624;74619;1820391;1011107
2021-09-17;PAB;2022;1051;971;613;1409;0;0;ITH;ITH1;4;Provincia Autonoma Bolzano / Bozen;46.49933453;11.35662422;21;7;28;934;962;-51;4;73794;1189;75945;1963997;468207
2021-09-17;VEN;18146;10018;8128;5614;12077;455;0;ITH;ITH3;5;Veneto;45.43490485;12.33845213;218;53;271;12097;12368;-88;463;440179;11736;464283;11322891;2065374
2021-09-17;MOL;744;392;352;262;469;13;0;ITF;ITF2;14;Molise;41.55774754;14.65916051;10;1;11;217;228;-22;0;13689;495;14412;267737;234073
2021-09-17;ABR;5339;2958;2381;1530;3704;105;0;ITF;ITF1;13;Abruzzo;42.35122196;13.39843823;73;7;80;1987;2067;-26;93;75775;2535;80377;2137057;823137
2021-09-17;BAS;2483;1358;1125;496;1926;61;0;ITF;ITF5;17;Basilicata;40.63947052;15.80514834;45;4;49;1234;1283;-34;34;27818;607;29708;452920;233616
2021-09-17;VDA;193;104;89;21;170;2;0;ITC;ITC2;2;Valle d'Aosta / Vallée d'Aoste;45.73750286;7.320149366;2;0;2;73;75;-3;0;11506;473;12054;174822;83016
2021-09-17;PUG;15176;8096;7080;4318;10246;611;1;ITF;ITF4;16;Puglia;41.12559576;16.86736689;176;19;195;3051;3246;-122;175;256871;6764;266881;3510485;1407923
2021-09-17;PAT;1551;811;740;537;968;46;0;ITH;ITH2;4;Provincia Autonoma Trento;46.06893511;11.12123097;20;1;21;420;441;2;15;46084;1368;47893;1042858;302643
2021-09-18;MOL;1317;741;576;466;836;15;0;ITF;ITF2;14;Molise;41.55774754;14.65916051;9;2;11;204;215;-13;1;13703;495;14413;268052;234386
2021-09-18;MAR;4780;2655;2125;2118;2487;175;0;ITI;ITI3;11;Marche;43.61675973;13.5188753;59;22;81;2864;2945;-13;94;106951;3063;112959;1509210;878962
2021-09-18;PAB;1288;704;584;631;657;0;0;ITH;ITH1;4;Provincia Autonoma Bolzano / Bozen;46.49933453;11.35662422;22;7;29;959;988;26;71;73839;1189;76016;1972538;469094
2021-09-18;LIG;3008;1679;1329;1692;1235;81;0;ITC;ITC3;7;Liguria;44.41149315;8.9326992;84;7;91;1432;1523;24;75;105931;4396;111850;2239806;836896
2021-09-18;PUG;3199;1733;1466;915;2173;110;1;ITF;ITF4;16;Puglia;41.12559576;16.86736689;187;19;206;3025;3231;-15;156;257042;6764;267037;3525679;1410401
2021-09-18;VDA;245;123;122;176;17;52;0;ITC;ITC2;2;Valle d'Aosta / Vallée d'Aoste;45.73750286;7.320149366;2;0;2;78;80;5;10;11511;473;12064;175822;83284
2021-09-18;UMB;2883;1570;1313;1252;1580;51;0;ITI;ITI2;10;Umbria;43.10675841;12.38824698;41;7;48;1245;1293;-60;91;60265;1441;62999;1843058;432429
2021-09-18;CAM;13888;7783;6105;7204;5952;731;1;ITF;ITF3;15;Campania;40.83956555;14.25084984;319;24;343;7561;7904;48;337;437046;7858;452808;6417883;3493344
2021-09-18;CAL;5649;3044;2605;2879;2603;167;0;ITF;ITF6;18;Calabria;38.90597598;16.59440194;166;15;181;4480;4661;-83;201;76026;1371;82058;1151484;1027338
2021-09-18;FVG;2763;1521;1242;841;1877;45;0;ITH;ITH4;6;Friuli-Venezia Giulia;45.6494354;13.76813649;41;10;51;1300;1351;-22;97;107749;3814;112914;2628950;785543
2021-09-18;PIE;18844;10515;8329;7125;11059;658;2;ITC;ITC1;1;Piemonte;45.0732745;7.680687483;197;22;219;3646;3865;20;237;361101;11746;376712;6413511;2343991
2021-09-18;EMR;21817;12160;9657;8398;12555;863;1;ITH;ITH5;8;Emilia-Romagna;44.49436681;11.3417208;407;41;448;12826;13274;211;403;393412;13432;420118;8512672;2059462
2021-09-18;TOS;22225;12174;10051;5652;15886;685;2;ITI;ITI1;9;Toscana;43.76923077;11.25588885;348;47;395;8087;8482;-85;326;263325;7100;278907;6189350;2789330
2021-09-18;PAT;1612;945;667;874;686;52;0;ITH;ITH2;4;Provincia Autonoma Trento;46.06893511;11.12123097;19;1;20;413;433;-8;33;46125;1368;47926;1046864;304245
2021-09-18;VEN;16667;9205;7462;6497;9693;477;0;ITH;ITH3;5;Veneto;45.43490485;12.33845213;218;51;269;11942;12211;-157;536;440870;11738;464819;11375546;2066953
2021-09-18;BAS;3327;1866;1461;756;2475;96;0;ITF;ITF5;17;Basilicata;40.63947052;15.80514834;49;4;53;1219;1272;-11;28;27856;608;29736;453651;233861
2021-09-18;ABR;2433;1365;1068;958;1396;79;0;ITF;ITF1;13;Abruzzo;42.35122196;13.39843823;70;7;77;1965;2042;-25;100;75899;2535;80476;2143152;824468
2021-09-18;LOM;34258;18822;15436;12789;19996;1473;0;ITC;ITC4;3;Lombardia;45.46679409;9.190347404;438;57;495;10877;11372;296;765;833938;33981;879291;14417349;5341271
2021-09-18;SIC;20397;11090;9307;8456;11554;387;0;ITG;ITG1;19;Sicilia;38.11569725;13.3623567;666;100;766;19972;20738;-1039;643;265178;6691;292607;6103160;2334174
2021-09-18;SAR;6193;3456;2737;1668;4478;47;0;ITG;ITG2;20;Sardegna;39.21531192;9.110616306;186;20;206;3622;3828;-179;55;69222;1624;74674;1823213;1013365
2021-09-18;LAZ;19140;9815;9325;8211;9928;741;260;ITI;ITI4;12;Lazio;41.89277044;12.48366722;429;58;487;10884;11371;-233;376;361080;8595;381046;8868209;4626291
2021-09-19;BAS;2548;1363;1185;446;2063;39;0;ITF;ITF5;17;Basilicata;40.63947052;15.80514834;50;3;53;1226;1279;7;30;27879;608;29766;454232;234053
2021-09-19;PAT;480;307;173;297;167;16;0;ITH;ITH2;4;Provincia Autonoma Trento;46.06893511;11.12123097;20;1;21;447;468;35;58;46148;1368;47984;1049729;305391
2021-09-19;FVG;2057;1109;948;499;1497;61;0;ITH;ITH4;6;Friuli-Venezia Giulia;45.6494354;13.76813649;45;11;56;1267;1323;-28;84;107859;3814;112996;2636442;787225
2021-09-19;VEN;8194;4571;3623;3132;4858;204;0;ITH;ITH3;5;Veneto;45.43490485;12.33845213;217;52;269;11885;12154;-57;364;441290;11739;465183;11418237;2069405
2021-09-19;SAR;1895;1051;844;985;875;35;0;ITG;ITG2;20;Sardegna;39.21531192;9.110616306;190;19;209;3526;3735;-93;60;69374;1625;74734;1825016;1014913
2021-09-19;CAL;1559;848;711;858;668;33;0;ITF;ITF6;18;Calabria;38.90597598;16.59440194;167;16;183;4501;4684;23;198;76199;1373;82256;1154926;1029163
2021-09-19;PIE;11604;6326;5278;4932;6269;402;1;ITC;ITC1;1;Piemonte;45.0732745;7.680687483;201;23;224;3637;3861;-4;153;361258;11746;376865;6431511;2349093
2021-09-19;EMR;15604;8623;6981;5663;9386;555;0;ITH;ITH5;8;Emilia-Romagna;44.49436681;11.3417208;409;45;454;12975;13429;155;343;393598;13434;420461;8537819;2061419
2021-09-19;PUG;617;350;267;204;373;40;0;ITF;ITF4;16;Puglia;41.12559576;16.86736689;187;19;206;3092;3298;67;164;257139;6764;267201;3539070;1412695
2021-09-19;UMB;1002;542;460;479;496;27;0;ITI;ITI2;10;Umbria;43.10675841;12.38824698;43;6;49;1198;1247;-46;84;60395;1441;63083;1849182;433048
2021-09-19;SIC;12237;7011;5226;5031;7014;192;0;ITG;ITG1;19;Sicilia;38.11569725;13.3623567;657;101;758;20278;21036;298;538;265416;6693;293145;6117236;2339050
2021-09-19;LAZ;14766;7654;7112;6106;7935;506;219;ITI;ITI4;12;Lazio;41.89277044;12.48366722;426;58;484;10836;11320;-51;277;361406;8597;381323;8882021;4628882
2021-09-19;CAM;8625;4810;3815;4585;3611;426;3;ITF;ITF3;15;Campania;40.83956555;14.25084984;309;22;331;7674;8005;101;362;437301;7864;453170;6435767;3495795
2021-09-19;MAR;227;117;110;135;63;29;0;ITI;ITI3;11;Marche;43.61675973;13.5188753;57;22;79;2824;2903;-42;147;107138;3065;113106;1513341;881694
2021-09-19;LIG;154;66;88;46;107;1;0;ITC;ITC3;7;Liguria;44.41149315;8.9326992;83;6;89;1415;1504;-19;93;106042;4397;111943;2246358;838884
2021-09-19;LOM;25095;13701;11394;10275;13780;1040;0;ITC;ITC4;3;Lombardia;45.46679409;9.190347404;428;59;487;10952;11439;67;348;834218;33982;879639;14466507;5352977
2021-09-19;ABR;1496;814;682;561;891;44;0;ITF;ITF1;13;Abruzzo;42.35122196;13.39843823;72;7;79;1970;2049;7;81;75972;2535;80556;2149391;825728
2021-09-19;PAB;324;189;135;192;132;0;0;ITH;ITH1;4;Provincia Autonoma Bolzano / Bozen;46.49933453;11.35662422;25;8;33;999;1032;44;80;73875;1189;76096;1977644;469738
2021-09-19;TOS;21762;11769;9993;5469;15655;636;2;ITI;ITI1;9;Toscana;43.76923077;11.25588885;336;49;385;8097;8482;0;418;263738;7105;279325;6207226;2795035
2021-09-19;MOL;14;12;2;13;1;0;0;ITF;ITF2;14;Molise;41.55774754;14.65916051;7;2;9;213;222;7;9;13705;495;14422;268563;234873
2021-09-20;PIE;18551;10107;8444;5592;11307;519;1133;ITC;ITC1;1;Piemonte;45.0732745;7.680687483;205;24;229;3592;3821;-40;135;361431;11748;377000;6447671;2352038
2021-09-20;TOS;22887;12200;10687;3436;18309;343;799;ITI;ITI1;9;Toscana;43.76923077;11.25588885;336;51;387;7907;8294;-188;231;264152;7110;279556;6213750;2797482
2021-09-20;LIG;6377;3500;2877;2731;3554;92;0;ITC;ITC3;7;Liguria;44.41149315;8.9326992;77;5;82;1347;1429;-75;43;106160;4397;111986;2248949;839406
2021-09-20;SAR;9831;5376;4455;2735;6963;132;1;ITG;ITG2;20;Sardegna;39.21531192;9.110616306;188;18;206;3371;3577;-158;42;69572;1627;74776;1826277;1015923
2021-09-20;PAT;2798;1474;1324;1419;1286;88;5;ITH;ITH2;4;Provincia Autonoma Trento;46.06893511;11.12123097;19;1;20;455;475;7;26;46167;1368;48010;1051774;306209
2021-09-20;PAB;1228;636;592;852;376;0;0;ITH;ITH1;4;Provincia Autonoma Bolzano / Bozen;46.49933453;11.35662422;20;6;26;951;977;-55;69;73999;1189;76165;1984038;470445
2021-09-20;VEN;21242;11693;9549;6079;13522;353;1288;ITH;ITH3;5;Veneto;45.43490485;12.33845213;221;54;275;11919;12194;40;229;441479;11739;465412;11431690;2070915
2021-09-20;MAR;6443;3477;2966;2128;4024;193;98;ITI;ITI3;11;Marche;43.61675973;13.5188753;56;21;77;2653;2730;-173;25;107336;3065;113131;1514265;882150
2021-09-20;LOM;53549;29342;24207;11087;39600;1097;1765;ITC;ITC4;3;Lombardia;45.46679409;9.190347404;435;63;498;10968;11466;27;150;834340;33983;879789;14481808;5356030
2021-09-20;MOL;654;403;251;323;321;10;0;ITF;ITF2;14;Molise;41.55774754;14.65916051;7;2;9;196;205;-17;7;13729;495;14429;268913;235223
2021-09-20;PUG;16605;9019;7586;5864;9412;844;485;ITF;ITF4;16;Puglia;41.12559576;16.86736689;194;20;214;3037;3251;-47;60;257246;6764;267261;3546252;1414341
2021-09-20;EMR;19929;10731;9198;5381;13772;483;293;ITH;ITH5;8;Emilia-Romagna;44.49436681;11.3417208;416;43;459;13127;13586;157;333;393770;13438;420794;8552513;2062648
2021-09-20;LAZ;18838;9943;8895;6802;10871;539;626;ITI;ITI4;12;Lazio;41.89277044;12.48366722;442;56;498;10698;11196;-124;243;361767;8603;381566;8894918;4631105
2021-09-20;CAL;7672;4126;3546;3380;4092;166;34;ITF;ITF6;18;Calabria;38.90597598;16.59440194;174;15;189;4444;4633;-51;127;76374;1376;82383;1157600;1030927
2021-09-20;ABR;4487;2468;2019;1609;2689;130;59;ITF;ITF1;13;Abruzzo;42.35122196;13.39843823;76;6;82;1979;2061;12;60;76020;2535;80616;2157220;827661
2021-09-20;VDA;560;281;279;248;228;84;0;ITC;ITC2;2;Valle d'Aosta / Vallée d'Aoste;45.73750286;7.320149366;3;0;3;68;71;-9;3;11523;473;12067;176405;83462
2021-09-20;FVG;3693;1918;1775;1825;1643;205;20;ITH;ITH4;6;Friuli-Venezia Giulia;45.6494354;13.76813649;48;11;59;1258;1317;-6;32;107895;3815;113027;2638632;787656
2021-09-20;BAS;3197;1726;1471;664;2425;79;29;ITF;ITF5;17;Basilicata;40.63947052;15.80514834;52;3;55;1208;1263;-16;8;27903;608;29774;454461;234133
2021-09-20;CAM;17963;9449;8514;7358;9478;719;408;ITF;ITF3;15;Campania;40.83956555;14.25084984;304;20;324;7501;7825;-180;198;437667;7876;453368;6442309;3497660
2021-09-20;SIC;24916;13047;11869;8195;16188;392;141;ITG;ITG1;19;Sicilia;38.11569725;13.3623567;660;96;756;20286;21042;6;514;265917;6700;293659;6129743;2343767
2021-09-20;UMB;2563;1359;1204;767;1672;39;85;ITI;ITI2;10;Umbria;43.10675841;12.38824698;44;6;50;1173;1223;-24;84;60503;1441;63167;1855157;433554
2021-09-21;VDA;384;212;172;107;264;13;0;ITC;ITC2;2;Valle d'Aosta / Vallée d'Aoste;45.73750286;7.320149366;2;0;2;64;66;-5;2;11530;473;12069;177285;83620
2021-09-21;ABR;3846;2109;1737;1667;2017;90;72;ITF;ITF1;13;Abruzzo;42.35122196;13.39843823;78;6;84;2037;2121;60;61;76020;2536;80677;2165810;829625
2021-09-21;BAS;3111;1704;1407;643;2385;53;30;ITF;ITF5;17;Basilicata;40.63947052;15.80514834;56;3;59;1207;1266;3;39;27936;611;29813;455467;234437
2021-09-21;EMR;19564;10750;8814;7017;11773;488;286;ITH;ITH5;8;Emilia-Romagna;44.49436681;11.3417208;411;48;459;13034;13493;-93;280;394138;13440;421071;8587580;2065098
2021-09-21;UMB;3091;1676;1415;1080;1827;63;121;ITI;ITI2;10;Umbria;43.10675841;12.38824698;45;6;51;1151;1202;-21;68;60592;1441;63235;1862572;434095
2021-09-21;SAR;9478;5221;4257;2424;6913;112;29;ITG;ITG2;20;Sardegna;39.21531192;9.110616306;178;17;195;3126;3321;-256;41;69869;1627;74817;1835380;1018285
2021-09-21;LOM;48355;26322;22033;12454;32791;1166;1944;ITC;ITC4;3;Lombardia;45.46679409;9.190347404;437;62;499;10948;11447;-19;472;834822;33992;880261;14542980;5367684
2021-09-21;FVG;3697;1956;1741;2096;1400;179;22;ITH;ITH4;6;Friuli-Venezia Giulia;45.6494354;13.76813649;50;12;62;1189;1251;-66;36;107997;3815;113063;2649524;789155
2021-09-21;PIE;17874;9673;8201;5861;10130;484;1399;ITC;ITC1;1;Piemonte;45.0732745;7.680687483;199;21;220;3536;3756;-65;225;361720;11749;377225;6469911;2357396
2021-09-21;PAT;2403;1260;1143;1109;1218;64;12;ITH;ITH2;4;Provincia Autonoma Trento;46.06893511;11.12123097;16;1;17;446;463;-12;29;46208;1368;48039;1055879;307851
2021-09-21;SIC;24043;12435;11608;7954;15632;413;44;ITG;ITG1;19;Sicilia;38.11569725;13.3623567;646;90;736;19703;20439;-603;492;266989;6723;294151;6147557;2351449
2021-09-21;LAZ;17775;9118;8657;6694;10094;485;502;ITI;ITI4;12;Lazio;41.89277044;12.48366722;434;53;487;10069;10556;-640;301;362703;8608;381867;8916779;4633570
2021-09-21;PAB;1346;762;584;895;451;0;0;ITH;ITH1;4;Provincia Autonoma Bolzano / Bozen;46.49933453;11.35662422;15;7;22;988;1010;33;55;74021;1189;76220;1989606;471107
2021-09-21;VEN;17053;9394;7659;6621;9453;372;607;ITH;ITH3;5;Veneto;45.43490485;12.33845213;225;57;282;11666;11948;-246;457;442179;11742;465869;11485626;2074050
2021-09-21;TOS;20319;10954;9365;2758;16472;253;836;ITI;ITI1;9;Toscana;43.76923077;11.25588885;336;53;389;7691;8080;-214;215;264578;7113;279771;6232051;2802790
2021-09-21;MOL;577;300;277;136;292;4;145;ITF;ITF2;14;Molise;41.55774754;14.65916051;6;2;8;191;199;-6;8;13743;495;14437;269270;235578
2021-09-21;PUG;21400;11568;9832;5466;14920;619;395;ITF;ITF4;16;Puglia;41.12559576;16.86736689;196;22;218;2907;3125;-126;110;257481;6765;267371;3560688;1416947
2021-09-21;CAM;19075;9804;9271;8975;8972;881;247;ITF;ITF3;15;Campania;40.83956555;14.25084984;289;16;305;7236;7541;-284;236;438181;7882;453604;6461006;3500601
2021-09-21;LIG;6257;3318;2939;2732;3403;122;0;ITC;ITC3;7;Liguria;44.41149315;8.9326992;76;5;81;1239;1320;-109;59;106324;4401;112045;2257819;841289
2021-09-21;CAL;6513;3442;3071;2698;3653;137;25;ITF;ITF6;18;Calabria;38.90597598;16.59440194;178;13;191;4276;4467;-166;128;76665;1379;82511;1161406;1033323
2021-09-21;MAR;6496;3584;2912;2162;3987;196;151;ITI;ITI3;11;Marche;43.61675973;13.5188753;58;20;78;2608;2686;-44;83;107462;3066;113214;1518971;884242
2021-09-22;VEN;16060;8659;7401;7048;8132;400;480;ITH;ITH3;5;Veneto;45.43490485;12.33845213;221;54;275;11474;11749;-199;509;442884;11745;466378;11529361;2077219
2021-09-22;LAZ;15124;7969;7155;6678;7477;477;492;ITI;ITI4;12;Lazio;41.89277044;12.48366722;421;51;472;9838;10310;-246;291;363236;8612;382158;8936935;4636522
2021-09-22;SAR;10504;5716;4788;2413;7933;124;34;ITG;ITG2;20;Sardegna;39.21531192;9.110616306;171;19;190;2922;3112;-209;67;70143;1629;74884;1844827;1021043
2021-09-22;PAT;1938;1037;901;1123;772;43;0;ITH;ITH2;4;Provincia Autonoma Trento;46.06893511;11.12123097;14;1;15;475;490;27;49;46230;1368;48088;1060358;309643
2021-09-22;CAL;8054;4185;3869;3371;4467;198;18;ITF;ITF6;18;Calabria;38.90597598;16.59440194;172;14;186;4192;4378;-89;200;76950;1383;82711;1165281;1035704
2021-09-22;UMB;2720;1464;1256;1037;1473;37;173;ITI;ITI2;10;Umbria;43.10675841;12.38824698;46;6;52;1130;1182;-20;70;60682;1441;63305;1870343;434640
2021-09-22;SIC;24175;12491;11684;8133;15586;394;62;ITG;ITG1;19;Sicilia;38.11569725;13.3623567;604;92;696;18537;19233;-1206;414;268591;6741;294565;6165526;2357592
2021-09-22;LOM;44808;24537;20271;13223;28554;1284;1747;ITC;ITC4;3;Lombardia;45.46679409;9.190347404;417;63;480;10627;11107;-340;450;835608;33996;880711;14597794;5378397
2021-09-22;FVG;5255;2797;2458;2340;2670;240;5;ITH;ITH4;6;Friuli-Venezia Giulia;45.6494354;13.76813649;48;11;59;1140;1199;-52;159;108205;3817;113221;2660339;790646
2021-09-22;CAM;17069;8766;8303;7025;9181;638;225;ITF;ITF3;15;Campania;40.83956555;14.25084984;291;15;306;7109;7415;-126;365;438664;7890;453969;6478400;3502935
2021-09-22;EMR;19233;10573;8660;7240;11079;504;410;ITH;ITH5;8;Emilia-Romagna;44.49436681;11.3417208;414;49;463;12975;13438;-55;257;394441;13444;421323;8618483;2067873
2021-09-22;TOS;22868;12459;10409;4645;17112;413;698;ITI;ITI1;9;Toscana;43.76923077;11.25588885;322;50;372;7542;7914;-166;325;265062;7120;280096;6249265;2808997
2021-09-22;PIE;19425;10581;8844;6279;10775;492;1879;ITC;ITC1;1;Piemonte;45.0732745;7.680687483;185;23;208;3578;3786;30;278;361966;11751;377503;6489721;2362066
2021-09-22;ABR;4757;2571;2186;1952;2642;114;49;ITF;ITF1;13;Abruzzo;42.35122196;13.39843823;81;6;87;1959;2046;-75;11;76105;2536;80687;2168369;830108
2021-09-22;MAR;7420;4030;3390;2241;4745;212;222;ITI;ITI3;11;Marche;43.61675973;13.5188753;58;21;79;2572;2651;-35;102;107598;3067;113316;1522165;885953
2021-09-22;LIG;5796;3184;2612;2703;2962;131;0;ITC;ITC3;7;Liguria;44.41149315;8.9326992;74;4;78;1135;1213;-107;79;106510;4401;112124;2265618;842936
2021-09-22;PAB;1472;767;705;672;797;0;3;ITH;ITH1;4;Provincia Autonoma Bolzano / Bozen;46.49933453;11.35662422;22;7;29;982;1011;1;65;74084;1190;76285;1998516;472186
2021-09-22;MOL;562;262;300;161;218;11;172;ITF;ITF2;14;Molise;41.55774754;14.65916051;5;2;7;180;187;-12;4;13758;496;14441;269776;236075
2021-09-22;BAS;2936;1586;1350;591;2224;47;74;ITF;ITF5;17;Basilicata;40.63947052;15.80514834;54;3;57;1205;1262;-4;35;27975;611;29848;456448;234786
2021-09-22;PUG;16890;9089;7801;4523;10788;619;960;ITF;ITF4;16;Puglia;41.12559576;16.86736689;181;20;201;2847;3048;-77;196;257751;6768;267567;3573025;1419683
2021-09-22;VDA;647;341;306;305;309;33;0;ITC;ITC2;2;Valle d'Aosta / Vallée d'Aoste;45.73750286;7.320149366;2;0;2;59;61;-5;2;11537;473;12071;177986;83784
2021-09-23;PUG;17758;9500;8258;5092;11205;741;720;ITF;ITF4;16;Puglia;41.12559576;16.86736689;176;22;198;2826;3024;-24;138;257909;6772;267705;3585305;1422231
2021-09-23;MAR;6196;3311;2885;2403;3358;188;247;ITI;ITI3;11;Marche;43.61675973;13.5188753;59;21;80;2574;2654;3;87;107681;3068;113403;1525059;887615
2021-09-23;PAB;1788;931;857;1295;481;0;12;ITH;ITH1;4;Provincia Autonoma Bolzano / Bozen;46.49933453;11.35662422;21;9;30;1006;1036;25;81;74140;1190;76366;2004527;472932
2021-09-23;MOL;554;278;276;128;203;3;220;ITF;ITF2;14;Molise;41.55774754;14.65916051;5;2;7;179;186;-1;19;13778;496;14460;270155;236441
2021-09-23;ABR;3103;1674;1429;1373;1565;115;50;ITF;ITF1;13;Abruzzo;42.35122196;13.39843823;82;6;88;1870;1958;-88;65;76257;2537;80752;2175534;831689
2021-09-23;VDA;341;191;150;187;134;20;0;ITC;ITC2;2;Valle d'Aosta / Vallée d'Aoste;45.73750286;7.320149366;2;0;2;59;61;0;3;11540;473;12074;178804;84053
2021-09-23;FVG;2721;1484;1237;1128;1353;93;147;ITH;ITH4;6;Friuli-Venezia Giulia;45.6494354;13.76813649;46;11;57;1117;1174;-25;68;108295;3817;113286;2669688;791925
2021-09-23;LAZ;14661;7746;6915;7005;6637;490;529;ITI;ITI4;12;Lazio;41.89277044;12.48366722;403;53;456;9947;10403;93;372;363503;8624;382530;8961798;4639854
2021-09-23;BAS;2771;1514;1257;641;2008;82;40;ITF;ITF5;17;Basilicata;40.63947052;15.80514834;50;3;53;1200;1253;-9;38;28022;611;29886;457356;235069
2021-09-23;TOS;20281;10950;9331;4402;14401;438;1040;ITI;ITI1;9;Toscana;43.76923077;11.25588885;306;51;357;7425;7782;-132;304;265492;7126;280400;6267447;2815683
2021-09-23;PIE;19961;10783;9178;6719;10535;515;2192;ITC;ITC1;1;Piemonte;45.0732745;7.680687483;176;23;199;3605;3804;18;242;362190;11751;377745;6513579;2367255
2021-09-23;SIC;18388;9461;8927;7683;10178;416;111;ITG;ITG1;19;Sicilia;38.11569725;13.3623567;574;82;656;17760;18416;-817;647;270040;6756;295212;6187006;2364752
2021-09-23;UMB;2866;1535;1331;979;1622;54;211;ITI;ITI2;10;Umbria;43.10675841;12.38824698;46;5;51;1087;1138;-44;12;60737;1442;63317;1872059;434769
2021-09-23;PAT;2179;1202;977;1177;944;52;6;ITH;ITH2;4;Provincia Autonoma Trento;46.06893511;11.12123097;15;1;16;477;493;3;19;46246;1368;48107;1064064;311125
2021-09-23;CAL;5947;3090;2857;2868;2910;126;43;ITF;ITF6;18;Calabria;38.90597598;16.59440194;168;14;182;4161;4343;-35;178;77161;1385;82889;1168894;1038066
2021-09-23;SAR;10200;5559;4641;2758;7269;127;46;ITG;ITG2;20;Sardegna;39.21531192;9.110616306;169;19;188;2742;2930;-182;34;70357;1631;74918;1855645;1023158
2021-09-23;CAM;16974;8917;8057;6975;9080;662;257;ITF;ITF3;15;Campania;40.83956555;14.25084984;282;14;296;7138;7434;19;419;439061;7893;454388;6497277;3506617
2021-09-23;LIG;5193;2842;2351;2212;2892;83;6;ITC;ITC3;7;Liguria;44.41149315;8.9326992;73;5;78;1114;1192;-21;87;106618;4401;112211;2273183;844558
2021-09-23;LOM;39713;21539;18174;12870;24753;1202;888;ITC;ITC4;3;Lombardia;45.46679409;9.190347404;412;61;473;10466;10939;-168;443;836216;33999;881154;14651836;5388384
2021-09-23;EMR;16840;9147;7693;6999;9136;430;275;ITH;ITH5;8;Emilia-Romagna;44.49436681;11.3417208;387;49;436;13015;13451;13;332;394752;13451;421654;8649721;2070477
2021-09-23;VEN;16290;8964;7326;7743;7650;466;431;ITH;ITH3;5;Veneto;45.43490485;12.33845213;215;53;268;11393;11661;-88;445;443413;11749;466823;11576649;2080327
2021-09-24;UMB;2244;1194;1050;769;1184;39;252;ITI;ITI2;10;Umbria;43.10675841;12.38824698;45;5;50;1085;1135;-3;44;60784;1442;63361;1879746;435488
2021-09-24;EMR;10190;5597;4593;4446;5182;356;206;ITH;ITH5;8;Emilia-Romagna;44.49436681;11.3417208;392;45;437;13203;13640;189;327;394882;13453;421975;8679232;2073046
2021-09-24;CAL;5003;2568;2435;2219;2636;129;19;ITF;ITF6;18;Calabria;38.90597598;16.59440194;158;13;171;4014;4185;-158;143;77458;1389;83032;1172301;1040331
2021-09-24;LIG;1698;937;761;676;990;31;1;ITC;ITC3;7;Liguria;44.41149315;8.9326992;64;6;70;1038;1108;-84;69;106769;4403;112280;2280214;846096
2021-09-24;SIC;14168;7106;7062;5646;8118;293;111;ITG;ITG1;19;Sicilia;38.11569725;13.3623567;543;80;623;16945;17568;-848;464;271339;6769;295676;6200510;2370467
2021-09-24;SAR;6371;3429;2942;1739;4505;95;32;ITG;ITG2;20;Sardegna;39.21531192;9.110616306;157;19;176;2639;2815;-115;73;70545;1631;74991;1861474;1025196
2021-09-24;VEN;12664;6862;5802;5271;6637;336;420;ITH;ITH3;5;Veneto;45.43490485;12.33845213;211;51;262;11335;11597;-64;428;443899;11755;467251;11619908;2082830
2021-09-24;LAZ;12045;6418;5627;5588;5534;431;492;ITI;ITI4;12;Lazio;41.89277044;12.48366722;395;51;446;9947;10393;-10;361;363868;8630;382891;8985236;4643342
2021-09-24;MAR;5230;2796;2434;1826;3026;163;215;ITI;ITI3;11;Marche;43.61675973;13.5188753;61;20;81;2573;2654;0;73;107754;3068;113476;1528047;889398
2021-09-24;CAM;13999;7246;6753;5500;7716;521;262;ITF;ITF3;15;Campania;40.83956555;14.25084984;268;18;286;7207;7493;59;348;439346;7897;454736;6513432;3510333
2021-09-24;LOM;32692;17538;15154;9379;21638;945;730;ITC;ITC4;3;Lombardia;45.46679409;9.190347404;414;60;474;10261;10735;-204;488;836903;34004;881642;14705407;5399013
2021-09-24;MOL;344;184;160;113;190;10;31;ITF;ITF2;14;Molise;41.55774754;14.65916051;5;2;7;168;175;-11;1;13790;496;14461;270294;236577
2021-09-24;TOS;8031;4368;3663;1963;5381;182;505;ITI;ITI1;9;Toscana;43.76923077;11.25588885;299;49;348;7372;7720;-62;334;265886;7128;280734;6284201;2821772
2021-09-24;ABR;4170;2253;1917;1354;2611;127;78;ITF;ITF1;13;Abruzzo;42.35122196;13.39843823;78;4;82;1837;1919;-39;59;76352;2539;80810;2182123;833064
2021-09-24;BAS;1839;998;841;412;1370;48;9;ITF;ITF5;17;Basilicata;40.63947052;15.80514834;48;3;51;1199;1250;-3;32;28057;611;29918;458121;235340
2021-09-24;PAB;1704;890;814;617;1031;0;56;ITH;ITH1;4;Provincia Autonoma Bolzano / Bozen;46.49933453;11.35662422;23;8;31;953;984;-52;4;74196;1190;76370;2006080;473145
2021-09-24;PUG;10289;5558;4731;2558;7129;384;218;ITF;ITF4;16;Puglia;41.12559576;16.86736689;168;19;187;2791;2978;-46;157;258109;6775;267862;3598335;1424834
2021-09-24;VDA;4;3;1;4;0;0;0;ITC;ITC2;2;Valle d'Aosta / Vallée d'Aoste;45.73750286;7.320149366;2;1;3;63;66;5;9;11544;473;12083;179882;84349
2021-09-24;PIE;16922;9112;7810;5793;9023;438;1668;ITC;ITC1;1;Piemonte;45.0732745;7.680687483;181;23;204;3569;3773;-31;213;362431;11754;377958;6540076;2372352
2021-09-24;PAT;1362;738;624;683;623;32;24;ITH;ITH2;4;Provincia Autonoma Trento;46.06893511;11.12123097;17;1;18;465;483;-10;9;46265;1368;48116;1065212;311584
2021-09-24;FVG;1713;976;737;939;677;26;71;ITH;ITH4;6;Friuli-Venezia Giulia;45.6494354;13.76813649;46;10;56;1103;1159;-15;84;108393;3817;113369;2678328;793290
;;;;;;;;;;;;;;;66;5;71;1819;1890;-29;57;76433;2540;80863;2188967;834442
;;;;;;;;;;;;;;;64;4;68;1779;1847;-43;54;76529;2541;80917;2195497;835773
;MOL;;;;;;;;;;;;41.55774754;14.65916051;5;2;7;160;167;-8;1;13799;496;14462;270668;236945
;MOL;;;;;;;;;;;;41.55774754;14.65916051;4;2;6;154;160;-7;5;13811;496;14467;271145;237415
;MOL;;;;;;;;;;;;41.55774754;14.65916051;4;2;6;145;151;-9;5;13825;496;14472;271451;237719
;MOL;;;;;;;;;;;;41.55774754;14.65916051;3;2;5;142;147;-4;10;13839;496;14482;271893;238158
;PAB;;;;;;;;;;;;46.49933453;11.35662422;19;9;28;977;1005;21;58;74233;1190;76428;2014490;473936
;PAB;;;;;;;;;;;;46.49933453;11.35662422;21;9;30;1019;1049;44;77;74266;1190;76505;2019583;474633
;PAB;;;;;;;;;;;;46.49933453;11.35662422;21;9;30;908;938;-111;37;74414;1190;76542;2026135;475302
;PAB;;;;;;;;;;;;46.49933453;11.35662422;18;10;28;924;952;14;64;74464;1190;76606;2031730;475929
;PAT;;;;;;;;;;;;46.06893511;11.12123097;15;2;17;474;491;8;29;46285;1369;48145;1068868;313047
;PAT;;;;;;;;;;;;46.06893511;11.12123097;15;3;18;463;481;-10;38;46332;1370;48183;1071953;314281
;PAT;;;;;;;;;;;;46.06893511;11.12123097;18;3;21;485;506;25;36;46343;1370;48219;1075631;315752
;PAT;;;;;;;;;;;;46.06893511;11.12123097;19;3;22;405;427;-79;21;46443;1370;48240;1078806;317022
;UMB;;;;;;;;;;;;43.10675841;12.38824698;42;6;48;1028;1076;-59;62;60903;1444;63423;1886403;436117
;UMB;;;;;;;;;;;;43.10675841;12.38824698;43;5;48;1029;1077;1;86;60985;1447;63509;1892592;436722
;UMB;;;;;;;;;;;;43.10675841;12.38824698;42;3;45;1013;1058;-19;52;61055;1448;63561;1899035;437283
;VDA;;;;;;;;;;;;45.73750286;7.320149366;2;1;3;61;64;-2;0;11546;473;12083;180079;84430
;VDA;;;;;;;;;;;;45.73750286;7.320149366;2;0;2;59;61;-3;6;11554;474;12089;181155;84632
;VDA;;;;;;;;;;;;45.73750286;7.320149366;3;0;3;56;59;-2;2;11558;474;12091;181683;84761
;VDA;;;;;;;;;;;;45.73750286;7.320149366;2;0;2;59;61;2;6;11562;474;12097;182634;84898
;VDA;;;;;;;;;;;;45.73750286;7.320149366;2;0;2;55;57;-4;2;11568;474;12099;183357;85065